,address,id,total_received,total_sent,first_tx,last_tx,final_balance,direction,hash
0,bc1qz6lks9udfn78vx3cju9uyc6kqk6739hndak4ct,1,11607291250,11604653370,2023-04-05 13:14:32,2022-12-09 04:23:11,2637880,inbound,b49bf173ef46274d1e85c57b8bc2f4c3edb8dbc8890c891a94e025ee469c7b25
1,bc1qz6lks9udfn78vx3cju9uyc6kqk6739hndak4ct,2,11607291250,11604653370,2023-04-05 13:14:32,2022-12-09 04:23:11,2637880,inbound,b49bf173ef46274d1e85c57b8bc2f4c3edb8dbc8890c891a94e025ee469c7b25
2,bc1qz6lks9udfn78vx3cju9uyc6kqk6739hndak4ct,3,474228448659,474205830004,2023-04-10 03:02:38,2023-04-09 13:24:58,22618655,outbound,b49bf173ef46274d1e85c57b8bc2f4c3edb8dbc8890c891a94e025ee469c7b25
3,bc1qz6lks9udfn78vx3cju9uyc6kqk6739hndak4ct,151,7576930,0,2023-01-13 16:05:47,2023-01-13 16:05:47,7576930,inbound,b49bf173ef46274d1e85c57b8bc2f4c3edb8dbc8890c891a94e025ee469c7b25
4,bc1qz6lks9udfn78vx3cju9uyc6kqk6739hndak4ct,152,40509276,0,2023-01-10 05:13:51,2023-01-01 23:42:43,40509276,inbound,b49bf173ef46274d1e85c57b8bc2f4c3edb8dbc8890c891a94e025ee469c7b25
5,bc1qz6lks9udfn78vx3cju9uyc6kqk6739hndak4ct,223,284961,284961,2023-01-04 16:58:31,2023-01-03 16:39:09,0,inbound,b49bf173ef46274d1e85c57b8bc2f4c3edb8dbc8890c891a94e025ee469c7b25
6,bc1qz6lks9udfn78vx3cju9uyc6kqk6739hndak4ct,224,22420354,0,2023-04-03 15:38:10,2022-07-12 18:31:09,22420354,inbound,b49bf173ef46274d1e85c57b8bc2f4c3edb8dbc8890c891a94e025ee469c7b25
7,bc1qz6lks9udfn78vx3cju9uyc6kqk6739hndak4ct,246,110554716,110389444,2023-04-07 07:08:07,2023-01-18 07:38:37,165272,inbound,b49bf173ef46274d1e85c57b8bc2f4c3edb8dbc8890c891a94e025ee469c7b25
8,bc1qz6lks9udfn78vx3cju9uyc6kqk6739hndak4ct,247,12005918,12005918,2023-01-06 15:56:34,2023-01-03 16:39:11,0,inbound,b49bf173ef46274d1e85c57b8bc2f4c3edb8dbc8890c891a94e025ee469c7b25
9,bc1qz6lks9udfn78vx3cju9uyc6kqk6739hndak4ct,272,45173,45173,2023-01-01 14:38:23,2022-12-31 17:47:07,0,inbound,b49bf173ef46274d1e85c57b8bc2f4c3edb8dbc8890c891a94e025ee469c7b25
10,bc1qz6lks9udfn78vx3cju9uyc6kqk6739hndak4ct,273,482685,482685,2023-01-01 19:42:16,2022-12-31 17:47:07,0,inbound,b49bf173ef46274d1e85c57b8bc2f4c3edb8dbc8890c891a94e025ee469c7b25
11,bc1qz6lks9udfn78vx3cju9uyc6kqk6739hndak4ct,306,60342,0,2022-12-31 17:47:07,2022-12-31 17:47:07,60342,inbound,b49bf173ef46274d1e85c57b8bc2f4c3edb8dbc8890c891a94e025ee469c7b25
12,bc1qz6lks9udfn78vx3cju9uyc6kqk6739hndak4ct,307,261331296,260660430,2023-04-02 09:19:22,2023-03-17 04:47:09,670866,inbound,b49bf173ef46274d1e85c57b8bc2f4c3edb8dbc8890c891a94e025ee469c7b25
13,bc1qz6lks9udfn78vx3cju9uyc6kqk6739hndak4ct,424,1120832,1120832,2022-12-30 20:05:33,2022-12-28 21:55:38,0,inbound,b49bf173ef46274d1e85c57b8bc2f4c3edb8dbc8890c891a94e025ee469c7b25
14,bc1qz6lks9udfn78vx3cju9uyc6kqk6739hndak4ct,425,531318,531318,2022-12-29 00:13:13,2022-12-28 21:55:38,0,inbound,b49bf173ef46274d1e85c57b8bc2f4c3edb8dbc8890c891a94e025ee469c7b25
15,bc1qz6lks9udfn78vx3cju9uyc6kqk6739hndak4ct,435,1173768,1173768,2023-01-03 14:56:42,2022-12-28 21:55:38,0,inbound,b49bf173ef46274d1e85c57b8bc2f4c3edb8dbc8890c891a94e025ee469c7b25
16,bc1qz6lks9udfn78vx3cju9uyc6kqk6739hndak4ct,436,227017753,227017753,2022-12-29 01:51:13,2022-12-28 21:55:38,0,inbound,b49bf173ef46274d1e85c57b8bc2f4c3edb8dbc8890c891a94e025ee469c7b25
17,bc1qz6lks9udfn78vx3cju9uyc6kqk6739hndak4ct,464,1267350756,1267350756,2023-04-10 03:15:21,2023-02-17 06:43:40,0,inbound,b49bf173ef46274d1e85c57b8bc2f4c3edb8dbc8890c891a94e025ee469c7b25
18,bc1qz6lks9udfn78vx3cju9uyc6kqk6739hndak4ct,465,121171,121171,2022-12-29 16:56:41,2022-12-28 21:55:38,0,inbound,b49bf173ef46274d1e85c57b8bc2f4c3edb8dbc8890c891a94e025ee469c7b25
19,bc1qz6lks9udfn78vx3cju9uyc6kqk6739hndak4ct,469,363477,363477,2023-01-04 12:47:11,2022-12-28 21:55:38,0,inbound,b49bf173ef46274d1e85c57b8bc2f4c3edb8dbc8890c891a94e025ee469c7b25
20,bc1qz6lks9udfn78vx3cju9uyc6kqk6739hndak4ct,470,46552177,46552177,2023-03-09 16:42:13,2022-12-30 00:29:31,0,inbound,b49bf173ef46274d1e85c57b8bc2f4c3edb8dbc8890c891a94e025ee469c7b25
21,bc1qz6lks9udfn78vx3cju9uyc6kqk6739hndak4ct,700,398792308,398792308,2023-02-03 18:56:28,2023-01-08 21:02:13,0,outbound,b49bf173ef46274d1e85c57b8bc2f4c3edb8dbc8890c891a94e025ee469c7b25
22,bc1qz6lks9udfn78vx3cju9uyc6kqk6739hndak4ct,701,23187812,23187812,2023-02-20 18:01:33,2022-10-20 06:01:30,0,outbound,b49bf173ef46274d1e85c57b8bc2f4c3edb8dbc8890c891a94e025ee469c7b25
23,bc1qz6lks9udfn78vx3cju9uyc6kqk6739hndak4ct,860,5945000,5945000,2022-12-26 20:06:43,2022-12-26 19:27:29,0,inbound,b49bf173ef46274d1e85c57b8bc2f4c3edb8dbc8890c891a94e025ee469c7b25
24,bc1qz6lks9udfn78vx3cju9uyc6kqk6739hndak4ct,861,417777247,417777247,2023-04-03 16:11:22,2022-12-30 19:13:44,0,inbound,b49bf173ef46274d1e85c57b8bc2f4c3edb8dbc8890c891a94e025ee469c7b25
25,bc1qz6lks9udfn78vx3cju9uyc6kqk6739hndak4ct,864,92788063,92788063,2023-01-13 08:47:51,2022-11-30 10:53:20,0,inbound,b49bf173ef46274d1e85c57b8bc2f4c3edb8dbc8890c891a94e025ee469c7b25
26,bc1qz6lks9udfn78vx3cju9uyc6kqk6739hndak4ct,865,3215460,3208595,2023-03-31 21:59:12,2022-12-06 04:16:05,6865,inbound,b49bf173ef46274d1e85c57b8bc2f4c3edb8dbc8890c891a94e025ee469c7b25
27,bc1qz6lks9udfn78vx3cju9uyc6kqk6739hndak4ct,1166,85096209,85096209,2022-12-31 09:07:59,2022-12-21 23:39:37,0,inbound,b49bf173ef46274d1e85c57b8bc2f4c3edb8dbc8890c891a94e025ee469c7b25
28,bc1qz6lks9udfn78vx3cju9uyc6kqk6739hndak4ct,1167,145117511,144603494,2023-04-09 18:01:34,2023-03-12 00:36:18,514017,inbound,b49bf173ef46274d1e85c57b8bc2f4c3edb8dbc8890c891a94e025ee469c7b25
29,bc1qz6lks9udfn78vx3cju9uyc6kqk6739hndak4ct,1653,108600,108600,2022-12-12 12:34:06,2022-12-12 07:56:46,0,inbound,b49bf173ef46274d1e85c57b8bc2f4c3edb8dbc8890c891a94e025ee469c7b25
30,bc1qz6lks9udfn78vx3cju9uyc6kqk6739hndak4ct,1654,1494335,1494335,2022-12-13 14:20:55,2022-12-12 07:56:46,0,inbound,b49bf173ef46274d1e85c57b8bc2f4c3edb8dbc8890c891a94e025ee469c7b25
31,bc1qz6lks9udfn78vx3cju9uyc6kqk6739hndak4ct,4,855935786,855935786,2023-04-05 11:40:17,2022-08-02 16:31:23,0,inbound,0f29ee96114823ff226a01da3c5fdb0bba83179bc275a7f92e1f05963c6d49ef
32,bc1qz6lks9udfn78vx3cju9uyc6kqk6739hndak4ct,153,6024893,5114174,2023-03-29 09:03:58,2023-01-10 05:13:51,910719,inbound,0f29ee96114823ff226a01da3c5fdb0bba83179bc275a7f92e1f05963c6d49ef
33,bc1qz6lks9udfn78vx3cju9uyc6kqk6739hndak4ct,225,1866730354,1866730354,2023-03-23 06:00:59,2021-01-04 20:03:21,0,outbound,0f29ee96114823ff226a01da3c5fdb0bba83179bc275a7f92e1f05963c6d49ef
34,bc1qz6lks9udfn78vx3cju9uyc6kqk6739hndak4ct,248,472530195,472529550,2023-02-11 10:56:45,2021-12-22 22:04:14,645,inbound,0f29ee96114823ff226a01da3c5fdb0bba83179bc275a7f92e1f05963c6d49ef
35,bc1qz6lks9udfn78vx3cju9uyc6kqk6739hndak4ct,274,115528684,113873905,2023-04-09 14:44:58,2023-02-09 08:29:42,1654779,inbound,0f29ee96114823ff226a01da3c5fdb0bba83179bc275a7f92e1f05963c6d49ef
36,bc1qz6lks9udfn78vx3cju9uyc6kqk6739hndak4ct,308,804936,804936,2022-12-31 20:50:16,2022-12-23 16:15:05,0,inbound,0f29ee96114823ff226a01da3c5fdb0bba83179bc275a7f92e1f05963c6d49ef
37,bc1qz6lks9udfn78vx3cju9uyc6kqk6739hndak4ct,426,981687269,981687269,2023-04-07 02:03:24,2023-02-16 23:51:08,0,inbound,0f29ee96114823ff226a01da3c5fdb0bba83179bc275a7f92e1f05963c6d49ef
38,bc1qz6lks9udfn78vx3cju9uyc6kqk6739hndak4ct,437,200230148,200230148,2023-03-17 23:38:43,2022-12-23 01:33:15,0,inbound,0f29ee96114823ff226a01da3c5fdb0bba83179bc275a7f92e1f05963c6d49ef
39,bc1qz6lks9udfn78vx3cju9uyc6kqk6739hndak4ct,466,545052,0,2022-12-28 21:55:38,2022-12-28 21:55:38,545052,inbound,0f29ee96114823ff226a01da3c5fdb0bba83179bc275a7f92e1f05963c6d49ef
40,bc1qz6lks9udfn78vx3cju9uyc6kqk6739hndak4ct,471,240783869,240783869,2023-04-08 06:03:59,2023-03-23 01:53:03,0,inbound,0f29ee96114823ff226a01da3c5fdb0bba83179bc275a7f92e1f05963c6d49ef
41,bc1qz6lks9udfn78vx3cju9uyc6kqk6739hndak4ct,702,2494878,2494878,2022-12-26 19:59:11,2022-12-26 19:27:29,0,inbound,0f29ee96114823ff226a01da3c5fdb0bba83179bc275a7f92e1f05963c6d49ef
42,bc1qz6lks9udfn78vx3cju9uyc6kqk6739hndak4ct,862,131759338,131759338,2022-12-27 00:59:23,2022-06-15 17:10:41,0,inbound,0f29ee96114823ff226a01da3c5fdb0bba83179bc275a7f92e1f05963c6d49ef
43,bc1qz6lks9udfn78vx3cju9uyc6kqk6739hndak4ct,866,1455259,1455259,2022-12-25 05:01:41,2022-12-24 17:44:10,0,inbound,0f29ee96114823ff226a01da3c5fdb0bba83179bc275a7f92e1f05963c6d49ef
44,bc1qz6lks9udfn78vx3cju9uyc6kqk6739hndak4ct,1168,132115,132115,2022-12-27 20:03:01,2022-12-22 23:44:44,0,inbound,0f29ee96114823ff226a01da3c5fdb0bba83179bc275a7f92e1f05963c6d49ef
45,bc1qz6lks9udfn78vx3cju9uyc6kqk6739hndak4ct,1655,980000,0,2022-12-12 07:56:46,2022-12-12 07:56:46,980000,inbound,0f29ee96114823ff226a01da3c5fdb0bba83179bc275a7f92e1f05963c6d49ef
46,bc1qz6lks9udfn78vx3cju9uyc6kqk6739hndak4ct,5,135241591,133995812,2023-04-09 09:21:17,2022-10-13 05:55:34,1245779,inbound,311307dd00a85d0c2d6173d4a0d4dba77a760bd708a7446fb4699883860156d2
47,bc1qz6lks9udfn78vx3cju9uyc6kqk6739hndak4ct,6,35506615,33941442,2023-04-08 18:27:56,2023-04-02 14:40:22,1565173,inbound,311307dd00a85d0c2d6173d4a0d4dba77a760bd708a7446fb4699883860156d2
48,bc1qz6lks9udfn78vx3cju9uyc6kqk6739hndak4ct,7,6483019706,6477538307,2023-04-09 22:39:56,2023-03-31 02:26:00,5481399,outbound,311307dd00a85d0c2d6173d4a0d4dba77a760bd708a7446fb4699883860156d2
49,bc1qz6lks9udfn78vx3cju9uyc6kqk6739hndak4ct,8,4597670157,4531287656,2023-04-09 19:56:14,2023-02-19 19:14:28,66382501,inbound,311307dd00a85d0c2d6173d4a0d4dba77a760bd708a7446fb4699883860156d2
50,bc1qz6lks9udfn78vx3cju9uyc6kqk6739hndak4ct,154,2816851,0,2023-01-10 05:13:51,2023-01-10 05:13:51,2816851,inbound,311307dd00a85d0c2d6173d4a0d4dba77a760bd708a7446fb4699883860156d2
51,bc1qz6lks9udfn78vx3cju9uyc6kqk6739hndak4ct,155,443971955895071,443770356606890,2023-04-10 03:22:47,2023-04-09 20:24:42,201599288181,outbound,311307dd00a85d0c2d6173d4a0d4dba77a760bd708a7446fb4699883860156d2
52,bc1qz6lks9udfn78vx3cju9uyc6kqk6739hndak4ct,156,613242,613242,2023-01-09 06:00:39,2023-01-09 04:48:36,0,inbound,311307dd00a85d0c2d6173d4a0d4dba77a760bd708a7446fb4699883860156d2
53,bc1qz6lks9udfn78vx3cju9uyc6kqk6739hndak4ct,157,237170856808226,236984122336847,2023-04-10 03:27:03,2023-04-09 23:22:24,186734471379,outbound,311307dd00a85d0c2d6173d4a0d4dba77a760bd708a7446fb4699883860156d2
54,bc1qz6lks9udfn78vx3cju9uyc6kqk6739hndak4ct,226,1712541,0,2023-01-03 16:39:09,2023-01-03 16:39:09,1712541,inbound,311307dd00a85d0c2d6173d4a0d4dba77a760bd708a7446fb4699883860156d2
55,bc1qz6lks9udfn78vx3cju9uyc6kqk6739hndak4ct,227,165900,165900,2023-01-03 18:03:49,2023-01-03 16:39:09,0,inbound,311307dd00a85d0c2d6173d4a0d4dba77a760bd708a7446fb4699883860156d2
56,bc1qz6lks9udfn78vx3cju9uyc6kqk6739hndak4ct,228,4933011,4933011,2023-01-03 20:19:29,2022-09-11 18:25:10,0,inbound,311307dd00a85d0c2d6173d4a0d4dba77a760bd708a7446fb4699883860156d2
57,bc1qz6lks9udfn78vx3cju9uyc6kqk6739hndak4ct,229,6912708,6912708,2023-03-09 02:26:26,2021-10-09 17:30:11,0,inbound,311307dd00a85d0c2d6173d4a0d4dba77a760bd708a7446fb4699883860156d2
58,bc1qz6lks9udfn78vx3cju9uyc6kqk6739hndak4ct,249,6063768,5171609,2023-01-31 13:42:57,2023-01-02 22:45:46,892159,inbound,311307dd00a85d0c2d6173d4a0d4dba77a760bd708a7446fb4699883860156d2
59,bc1qz6lks9udfn78vx3cju9uyc6kqk6739hndak4ct,250,327673,327673,2023-01-03 17:07:17,2023-01-03 16:44:14,0,inbound,311307dd00a85d0c2d6173d4a0d4dba77a760bd708a7446fb4699883860156d2
60,bc1qz6lks9udfn78vx3cju9uyc6kqk6739hndak4ct,251,1803346,0,2023-01-03 16:39:11,2023-01-03 16:39:11,1803346,inbound,311307dd00a85d0c2d6173d4a0d4dba77a760bd708a7446fb4699883860156d2
61,bc1qz6lks9udfn78vx3cju9uyc6kqk6739hndak4ct,252,112000,112000,2023-02-06 11:54:19,2022-04-09 12:16:09,0,inbound,311307dd00a85d0c2d6173d4a0d4dba77a760bd708a7446fb4699883860156d2
62,bc1qz6lks9udfn78vx3cju9uyc6kqk6739hndak4ct,275,225088,225088,2023-01-02 16:40:15,2022-12-31 17:47:07,0,inbound,311307dd00a85d0c2d6173d4a0d4dba77a760bd708a7446fb4699883860156d2
63,bc1qz6lks9udfn78vx3cju9uyc6kqk6739hndak4ct,276,14810289,14807501,2023-02-17 11:20:45,2022-09-10 11:18:40,2788,inbound,311307dd00a85d0c2d6173d4a0d4dba77a760bd708a7446fb4699883860156d2
64,bc1qz6lks9udfn78vx3cju9uyc6kqk6739hndak4ct,277,1448286,1448286,2023-01-03 06:09:08,2022-12-31 17:47:07,0,inbound,311307dd00a85d0c2d6173d4a0d4dba77a760bd708a7446fb4699883860156d2
65,bc1qz6lks9udfn78vx3cju9uyc6kqk6739hndak4ct,278,25690504,25690504,2023-04-05 03:52:53,2023-01-18 20:49:20,0,outbound,311307dd00a85d0c2d6173d4a0d4dba77a760bd708a7446fb4699883860156d2
66,bc1qz6lks9udfn78vx3cju9uyc6kqk6739hndak4ct,309,819977,819977,2022-12-31 18:50:17,2022-12-31 17:47:07,0,inbound,311307dd00a85d0c2d6173d4a0d4dba77a760bd708a7446fb4699883860156d2
67,bc1qz6lks9udfn78vx3cju9uyc6kqk6739hndak4ct,310,386182,386182,2023-01-02 05:00:17,2022-12-31 17:47:07,0,inbound,311307dd00a85d0c2d6173d4a0d4dba77a760bd708a7446fb4699883860156d2
68,bc1qz6lks9udfn78vx3cju9uyc6kqk6739hndak4ct,311,187130388,187130388,2023-02-21 15:30:56,2023-01-26 23:35:06,0,inbound,311307dd00a85d0c2d6173d4a0d4dba77a760bd708a7446fb4699883860156d2
69,bc1qz6lks9udfn78vx3cju9uyc6kqk6739hndak4ct,312,1147465,1147465,2023-01-02 05:20:12,2022-12-31 17:47:07,0,inbound,311307dd00a85d0c2d6173d4a0d4dba77a760bd708a7446fb4699883860156d2
70,bc1qz6lks9udfn78vx3cju9uyc6kqk6739hndak4ct,427,945972,945972,2022-12-29 00:10:17,2022-12-28 21:55:38,0,inbound,311307dd00a85d0c2d6173d4a0d4dba77a760bd708a7446fb4699883860156d2
71,bc1qz6lks9udfn78vx3cju9uyc6kqk6739hndak4ct,428,587489,587489,2023-01-03 17:13:30,2022-12-28 21:55:38,0,inbound,311307dd00a85d0c2d6173d4a0d4dba77a760bd708a7446fb4699883860156d2
72,bc1qz6lks9udfn78vx3cju9uyc6kqk6739hndak4ct,429,28149461,28148782,2023-03-30 05:05:35,2022-06-29 18:54:47,679,inbound,311307dd00a85d0c2d6173d4a0d4dba77a760bd708a7446fb4699883860156d2
73,bc1qz6lks9udfn78vx3cju9uyc6kqk6739hndak4ct,430,20887528,20887528,2023-03-14 12:00:07,2021-12-13 18:24:42,0,inbound,311307dd00a85d0c2d6173d4a0d4dba77a760bd708a7446fb4699883860156d2
74,bc1qz6lks9udfn78vx3cju9uyc6kqk6739hndak4ct,438,164060,164060,2023-01-03 18:57:47,2022-12-28 21:55:38,0,inbound,311307dd00a85d0c2d6173d4a0d4dba77a760bd708a7446fb4699883860156d2
75,bc1qz6lks9udfn78vx3cju9uyc6kqk6739hndak4ct,439,282577,282577,2022-12-29 00:02:23,2022-12-28 21:55:38,0,inbound,311307dd00a85d0c2d6173d4a0d4dba77a760bd708a7446fb4699883860156d2
76,bc1qz6lks9udfn78vx3cju9uyc6kqk6739hndak4ct,440,54250670,54250670,2023-03-02 16:11:07,2023-02-23 19:33:37,0,inbound,311307dd00a85d0c2d6173d4a0d4dba77a760bd708a7446fb4699883860156d2
77,bc1qz6lks9udfn78vx3cju9uyc6kqk6739hndak4ct,441,333136,333136,2022-12-31 22:00:25,2022-12-28 21:55:38,0,inbound,311307dd00a85d0c2d6173d4a0d4dba77a760bd708a7446fb4699883860156d2
78,bc1qz6lks9udfn78vx3cju9uyc6kqk6739hndak4ct,467,397750,0,2022-12-28 21:55:38,2022-12-28 21:55:38,397750,inbound,311307dd00a85d0c2d6173d4a0d4dba77a760bd708a7446fb4699883860156d2
79,bc1qz6lks9udfn78vx3cju9uyc6kqk6739hndak4ct,468,98949,98949,2022-12-28 21:56:12,2022-12-28 21:55:38,0,inbound,311307dd00a85d0c2d6173d4a0d4dba77a760bd708a7446fb4699883860156d2
80,bc1qz6lks9udfn78vx3cju9uyc6kqk6739hndak4ct,472,104915,104915,2023-01-03 23:24:34,2022-12-28 21:55:38,0,inbound,311307dd00a85d0c2d6173d4a0d4dba77a760bd708a7446fb4699883860156d2
81,bc1qz6lks9udfn78vx3cju9uyc6kqk6739hndak4ct,473,211711,0,2022-12-28 21:55:38,2022-12-28 21:55:38,211711,inbound,311307dd00a85d0c2d6173d4a0d4dba77a760bd708a7446fb4699883860156d2
82,bc1qz6lks9udfn78vx3cju9uyc6kqk6739hndak4ct,474,1815031,1815031,2022-12-31 22:00:25,2022-12-28 21:55:38,0,inbound,311307dd00a85d0c2d6173d4a0d4dba77a760bd708a7446fb4699883860156d2
83,bc1qz6lks9udfn78vx3cju9uyc6kqk6739hndak4ct,475,30573166,30573166,2023-03-20 04:11:08,2022-11-30 11:47:49,0,inbound,311307dd00a85d0c2d6173d4a0d4dba77a760bd708a7446fb4699883860156d2
84,bc1qz6lks9udfn78vx3cju9uyc6kqk6739hndak4ct,703,277066,277066,2022-12-27 05:01:34,2022-12-26 19:27:29,0,inbound,311307dd00a85d0c2d6173d4a0d4dba77a760bd708a7446fb4699883860156d2
85,bc1qz6lks9udfn78vx3cju9uyc6kqk6739hndak4ct,704,16785713,16783498,2023-02-11 18:02:32,2022-11-29 19:46:19,2215,inbound,311307dd00a85d0c2d6173d4a0d4dba77a760bd708a7446fb4699883860156d2
86,bc1qz6lks9udfn78vx3cju9uyc6kqk6739hndak4ct,705,2374817,2374817,2022-12-27 01:35:52,2022-12-26 19:27:29,0,inbound,311307dd00a85d0c2d6173d4a0d4dba77a760bd708a7446fb4699883860156d2
87,bc1qz6lks9udfn78vx3cju9uyc6kqk6739hndak4ct,706,230637,230637,2022-12-27 18:26:28,2022-12-26 19:27:29,0,inbound,311307dd00a85d0c2d6173d4a0d4dba77a760bd708a7446fb4699883860156d2
88,bc1qz6lks9udfn78vx3cju9uyc6kqk6739hndak4ct,863,135435,135435,2022-12-27 05:01:37,2022-12-26 19:27:29,0,inbound,311307dd00a85d0c2d6173d4a0d4dba77a760bd708a7446fb4699883860156d2
89,bc1qz6lks9udfn78vx3cju9uyc6kqk6739hndak4ct,867,441351,441351,2022-12-24 18:02:01,2022-12-24 16:32:09,0,inbound,311307dd00a85d0c2d6173d4a0d4dba77a760bd708a7446fb4699883860156d2
90,bc1qz6lks9udfn78vx3cju9uyc6kqk6739hndak4ct,868,118814,118814,2022-12-25 00:02:54,2022-12-24 17:44:10,0,inbound,311307dd00a85d0c2d6173d4a0d4dba77a760bd708a7446fb4699883860156d2
91,bc1qz6lks9udfn78vx3cju9uyc6kqk6739hndak4ct,869,743004,743004,2022-12-25 15:30:11,2022-12-24 17:44:10,0,inbound,311307dd00a85d0c2d6173d4a0d4dba77a760bd708a7446fb4699883860156d2
92,bc1qz6lks9udfn78vx3cju9uyc6kqk6739hndak4ct,870,135395,135395,2022-12-29 16:45:20,2022-12-24 17:44:10,0,inbound,311307dd00a85d0c2d6173d4a0d4dba77a760bd708a7446fb4699883860156d2
93,bc1qz6lks9udfn78vx3cju9uyc6kqk6739hndak4ct,1169,872876,872876,2022-12-23 09:44:22,2022-12-22 23:44:44,0,inbound,311307dd00a85d0c2d6173d4a0d4dba77a760bd708a7446fb4699883860156d2
94,bc1qz6lks9udfn78vx3cju9uyc6kqk6739hndak4ct,1170,73210,73210,2022-12-29 02:30:26,2022-12-22 23:44:44,0,inbound,311307dd00a85d0c2d6173d4a0d4dba77a760bd708a7446fb4699883860156d2
95,bc1qz6lks9udfn78vx3cju9uyc6kqk6739hndak4ct,1171,556811,556811,2022-12-23 08:07:36,2022-12-22 23:44:44,0,inbound,311307dd00a85d0c2d6173d4a0d4dba77a760bd708a7446fb4699883860156d2
96,bc1qz6lks9udfn78vx3cju9uyc6kqk6739hndak4ct,1172,161607,161607,2022-12-24 07:18:15,2022-12-22 23:44:44,0,inbound,311307dd00a85d0c2d6173d4a0d4dba77a760bd708a7446fb4699883860156d2
97,bc1qz6lks9udfn78vx3cju9uyc6kqk6739hndak4ct,1656,1791102379,1791102379,2023-01-12 12:25:06,2022-11-18 07:00:48,0,inbound,311307dd00a85d0c2d6173d4a0d4dba77a760bd708a7446fb4699883860156d2
98,bc1qz6lks9udfn78vx3cju9uyc6kqk6739hndak4ct,1657,65393599806,55468471909,2023-04-09 16:04:50,2022-12-19 15:30:08,9925127897,inbound,311307dd00a85d0c2d6173d4a0d4dba77a760bd708a7446fb4699883860156d2
99,bc1qz6lks9udfn78vx3cju9uyc6kqk6739hndak4ct,1658,275235,0,2022-12-12 07:56:46,2022-12-12 07:56:46,275235,inbound,311307dd00a85d0c2d6173d4a0d4dba77a760bd708a7446fb4699883860156d2
100,bc1qz6lks9udfn78vx3cju9uyc6kqk6739hndak4ct,1659,16460222,16460222,2023-01-28 04:28:05,2022-04-26 13:30:12,0,inbound,311307dd00a85d0c2d6173d4a0d4dba77a760bd708a7446fb4699883860156d2
101,bc1qz6lks9udfn78vx3cju9uyc6kqk6739hndak4ct,9,4887081592075,4886907457229,2023-04-10 02:25:25,2023-04-08 15:22:34,174134846,outbound,c43f5817513f2acc547713ec34a97417a2eb2bfd34bc001d1847ac7789f99367
102,bc1qz6lks9udfn78vx3cju9uyc6kqk6739hndak4ct,158,2705078,2498607,2023-01-07 05:14:39,2023-01-05 06:34:33,206471,inbound,c43f5817513f2acc547713ec34a97417a2eb2bfd34bc001d1847ac7789f99367
103,bc1qz6lks9udfn78vx3cju9uyc6kqk6739hndak4ct,230,10000,10000,2023-01-03 18:26:23,2023-01-03 16:39:09,0,inbound,c43f5817513f2acc547713ec34a97417a2eb2bfd34bc001d1847ac7789f99367
104,bc1qz6lks9udfn78vx3cju9uyc6kqk6739hndak4ct,253,1682194604,1682194604,2023-03-27 09:39:57,2022-05-27 12:00:38,0,inbound,c43f5817513f2acc547713ec34a97417a2eb2bfd34bc001d1847ac7789f99367
105,bc1qz6lks9udfn78vx3cju9uyc6kqk6739hndak4ct,279,64909,0,2022-12-31 17:47:07,2022-12-31 17:47:07,64909,inbound,c43f5817513f2acc547713ec34a97417a2eb2bfd34bc001d1847ac7789f99367
106,bc1qz6lks9udfn78vx3cju9uyc6kqk6739hndak4ct,313,1146430,1146430,2022-12-31 18:35:27,2022-12-31 17:47:07,0,inbound,c43f5817513f2acc547713ec34a97417a2eb2bfd34bc001d1847ac7789f99367
107,bc1qz6lks9udfn78vx3cju9uyc6kqk6739hndak4ct,431,93747837,93747837,2023-02-25 00:16:25,2022-08-01 12:54:09,0,inbound,c43f5817513f2acc547713ec34a97417a2eb2bfd34bc001d1847ac7789f99367
108,bc1qz6lks9udfn78vx3cju9uyc6kqk6739hndak4ct,442,104928942,104928942,2023-03-21 07:06:15,2023-02-12 22:50:43,0,outbound,c43f5817513f2acc547713ec34a97417a2eb2bfd34bc001d1847ac7789f99367
109,bc1qz6lks9udfn78vx3cju9uyc6kqk6739hndak4ct,476,133253,133253,2022-12-29 05:46:36,2022-12-28 21:55:38,0,inbound,c43f5817513f2acc547713ec34a97417a2eb2bfd34bc001d1847ac7789f99367
110,bc1qz6lks9udfn78vx3cju9uyc6kqk6739hndak4ct,707,1190916,1190916,2023-02-24 14:10:51,2022-09-09 04:25:17,0,inbound,c43f5817513f2acc547713ec34a97417a2eb2bfd34bc001d1847ac7789f99367
111,bc1qz6lks9udfn78vx3cju9uyc6kqk6739hndak4ct,871,344182087,344182087,2023-02-13 10:11:04,2023-01-12 22:12:49,0,outbound,c43f5817513f2acc547713ec34a97417a2eb2bfd34bc001d1847ac7789f99367
112,bc1qz6lks9udfn78vx3cju9uyc6kqk6739hndak4ct,1173,10324,0,2022-12-22 23:44:44,2022-12-22 23:44:44,10324,inbound,c43f5817513f2acc547713ec34a97417a2eb2bfd34bc001d1847ac7789f99367
113,bc1qz6lks9udfn78vx3cju9uyc6kqk6739hndak4ct,1660,4171055305,4171055305,2023-01-14 09:57:15,2022-12-02 07:21:40,0,outbound,c43f5817513f2acc547713ec34a97417a2eb2bfd34bc001d1847ac7789f99367
114,bc1qz6lks9udfn78vx3cju9uyc6kqk6739hndak4ct,10,10228144,10228144,2023-04-02 20:17:50,2022-11-29 20:02:44,0,inbound,9ee3976a19f8b94748ea998bafeee3dfc3260153bdbdc3dc1466f8894c3f2cf4
115,bc1qz6lks9udfn78vx3cju9uyc6kqk6739hndak4ct,159,271990,271990,2023-01-07 06:04:01,2023-01-07 04:56:34,0,inbound,9ee3976a19f8b94748ea998bafeee3dfc3260153bdbdc3dc1466f8894c3f2cf4
116,bc1qz6lks9udfn78vx3cju9uyc6kqk6739hndak4ct,231,2866765,2866765,2023-01-08 01:03:50,2023-01-03 16:39:11,0,inbound,9ee3976a19f8b94748ea998bafeee3dfc3260153bdbdc3dc1466f8894c3f2cf4
117,bc1qz6lks9udfn78vx3cju9uyc6kqk6739hndak4ct,254,96220513,96220513,2023-03-22 09:50:58,2022-01-22 11:33:19,0,inbound,9ee3976a19f8b94748ea998bafeee3dfc3260153bdbdc3dc1466f8894c3f2cf4
118,bc1qz6lks9udfn78vx3cju9uyc6kqk6739hndak4ct,280,78437,78437,2022-12-31 18:39:32,2022-12-31 17:47:07,0,inbound,9ee3976a19f8b94748ea998bafeee3dfc3260153bdbdc3dc1466f8894c3f2cf4
119,bc1qz6lks9udfn78vx3cju9uyc6kqk6739hndak4ct,314,753561,753561,2022-12-31 17:57:03,2022-12-31 17:47:07,0,inbound,9ee3976a19f8b94748ea998bafeee3dfc3260153bdbdc3dc1466f8894c3f2cf4
120,bc1qz6lks9udfn78vx3cju9uyc6kqk6739hndak4ct,432,1713533443,1321134140,2023-03-20 16:20:46,2023-01-13 15:55:34,392399303,inbound,9ee3976a19f8b94748ea998bafeee3dfc3260153bdbdc3dc1466f8894c3f2cf4
121,bc1qz6lks9udfn78vx3cju9uyc6kqk6739hndak4ct,443,227017753,227017753,2022-12-29 01:51:14,2022-12-28 21:55:38,0,inbound,9ee3976a19f8b94748ea998bafeee3dfc3260153bdbdc3dc1466f8894c3f2cf4
122,bc1qz6lks9udfn78vx3cju9uyc6kqk6739hndak4ct,477,9071,9071,2023-01-03 23:24:34,2022-12-28 21:55:38,0,inbound,9ee3976a19f8b94748ea998bafeee3dfc3260153bdbdc3dc1466f8894c3f2cf4
123,bc1qz6lks9udfn78vx3cju9uyc6kqk6739hndak4ct,708,140449068,140449068,2023-03-12 11:58:07,2022-09-07 17:27:27,0,inbound,9ee3976a19f8b94748ea998bafeee3dfc3260153bdbdc3dc1466f8894c3f2cf4
124,bc1qz6lks9udfn78vx3cju9uyc6kqk6739hndak4ct,872,279563,279563,2022-12-25 00:03:01,2022-12-24 17:44:10,0,inbound,9ee3976a19f8b94748ea998bafeee3dfc3260153bdbdc3dc1466f8894c3f2cf4
125,bc1qz6lks9udfn78vx3cju9uyc6kqk6739hndak4ct,1174,48743,48743,2022-12-23 06:03:49,2022-12-22 23:44:44,0,inbound,9ee3976a19f8b94748ea998bafeee3dfc3260153bdbdc3dc1466f8894c3f2cf4
126,bc1qz6lks9udfn78vx3cju9uyc6kqk6739hndak4ct,1661,15833925740,14792291590,2023-04-04 13:06:46,2023-01-24 19:26:50,1041634150,outbound,9ee3976a19f8b94748ea998bafeee3dfc3260153bdbdc3dc1466f8894c3f2cf4
127,bc1qz6lks9udfn78vx3cju9uyc6kqk6739hndak4ct,11,2758238,2758238,2023-04-02 11:42:17,2021-05-22 14:03:01,0,inbound,cdbb3dea8ac0192d4edbb5a8dfc5eca5b83c7256879f225915a5c0bf3bdd1384
128,bc1qz6lks9udfn78vx3cju9uyc6kqk6739hndak4ct,12,1972447,0,2023-04-06 17:23:09,2023-03-01 14:46:10,1972447,inbound,cdbb3dea8ac0192d4edbb5a8dfc5eca5b83c7256879f225915a5c0bf3bdd1384
129,bc1qz6lks9udfn78vx3cju9uyc6kqk6739hndak4ct,160,26742,0,2023-01-05 14:58:14,2023-01-05 14:58:14,26742,inbound,cdbb3dea8ac0192d4edbb5a8dfc5eca5b83c7256879f225915a5c0bf3bdd1384
130,bc1qz6lks9udfn78vx3cju9uyc6kqk6739hndak4ct,161,29076731,29076731,2023-01-05 15:25:08,2023-01-05 14:58:14,0,inbound,cdbb3dea8ac0192d4edbb5a8dfc5eca5b83c7256879f225915a5c0bf3bdd1384
131,bc1qz6lks9udfn78vx3cju9uyc6kqk6739hndak4ct,232,225412615,225412615,2023-04-09 17:50:12,2022-08-26 14:15:53,0,inbound,cdbb3dea8ac0192d4edbb5a8dfc5eca5b83c7256879f225915a5c0bf3bdd1384
132,bc1qz6lks9udfn78vx3cju9uyc6kqk6739hndak4ct,233,23798607,0,2023-03-01 22:41:10,2021-06-10 04:13:24,23798607,inbound,cdbb3dea8ac0192d4edbb5a8dfc5eca5b83c7256879f225915a5c0bf3bdd1384
133,bc1qz6lks9udfn78vx3cju9uyc6kqk6739hndak4ct,255,66386967,66138306,2023-04-06 11:51:26,2022-12-10 21:59:07,248661,inbound,cdbb3dea8ac0192d4edbb5a8dfc5eca5b83c7256879f225915a5c0bf3bdd1384
134,bc1qz6lks9udfn78vx3cju9uyc6kqk6739hndak4ct,256,1209572,0,2023-01-03 17:10:33,2023-01-03 16:37:06,1209572,inbound,cdbb3dea8ac0192d4edbb5a8dfc5eca5b83c7256879f225915a5c0bf3bdd1384
135,bc1qz6lks9udfn78vx3cju9uyc6kqk6739hndak4ct,281,603456,603456,2023-01-01 22:49:15,2022-12-31 17:47:07,0,inbound,cdbb3dea8ac0192d4edbb5a8dfc5eca5b83c7256879f225915a5c0bf3bdd1384
136,bc1qz6lks9udfn78vx3cju9uyc6kqk6739hndak4ct,282,64202,64202,2023-01-01 00:04:21,2022-12-31 17:47:07,0,inbound,cdbb3dea8ac0192d4edbb5a8dfc5eca5b83c7256879f225915a5c0bf3bdd1384
137,bc1qz6lks9udfn78vx3cju9uyc6kqk6739hndak4ct,315,2096783,0,2022-12-31 17:47:07,2022-12-31 17:47:07,2096783,inbound,cdbb3dea8ac0192d4edbb5a8dfc5eca5b83c7256879f225915a5c0bf3bdd1384
138,bc1qz6lks9udfn78vx3cju9uyc6kqk6739hndak4ct,316,5915063,5915063,2023-01-09 14:41:34,2022-12-31 17:47:07,0,inbound,cdbb3dea8ac0192d4edbb5a8dfc5eca5b83c7256879f225915a5c0bf3bdd1384
139,bc1qz6lks9udfn78vx3cju9uyc6kqk6739hndak4ct,433,87148,87148,2022-12-29 05:01:38,2022-12-28 21:55:38,0,inbound,cdbb3dea8ac0192d4edbb5a8dfc5eca5b83c7256879f225915a5c0bf3bdd1384
140,bc1qz6lks9udfn78vx3cju9uyc6kqk6739hndak4ct,434,8248532145,8248532145,2023-04-10 02:40:04,2023-04-05 20:26:46,0,inbound,cdbb3dea8ac0192d4edbb5a8dfc5eca5b83c7256879f225915a5c0bf3bdd1384
141,bc1qz6lks9udfn78vx3cju9uyc6kqk6739hndak4ct,444,104921,104921,2022-12-30 17:35:31,2022-12-28 21:55:38,0,inbound,cdbb3dea8ac0192d4edbb5a8dfc5eca5b83c7256879f225915a5c0bf3bdd1384
142,bc1qz6lks9udfn78vx3cju9uyc6kqk6739hndak4ct,445,469300688,469300688,2023-03-15 14:38:24,2023-01-18 22:53:47,0,outbound,cdbb3dea8ac0192d4edbb5a8dfc5eca5b83c7256879f225915a5c0bf3bdd1384
143,bc1qz6lks9udfn78vx3cju9uyc6kqk6739hndak4ct,478,868602,868602,2022-12-30 07:32:45,2022-12-28 21:55:38,0,inbound,cdbb3dea8ac0192d4edbb5a8dfc5eca5b83c7256879f225915a5c0bf3bdd1384
144,bc1qz6lks9udfn78vx3cju9uyc6kqk6739hndak4ct,479,294379,294379,2022-12-29 05:01:37,2022-12-28 21:55:38,0,inbound,cdbb3dea8ac0192d4edbb5a8dfc5eca5b83c7256879f225915a5c0bf3bdd1384
145,bc1qz6lks9udfn78vx3cju9uyc6kqk6739hndak4ct,709,16914597,16914597,2023-03-30 18:10:52,2022-11-06 20:20:15,0,outbound,cdbb3dea8ac0192d4edbb5a8dfc5eca5b83c7256879f225915a5c0bf3bdd1384
146,bc1qz6lks9udfn78vx3cju9uyc6kqk6739hndak4ct,710,1137077069,1137077069,2023-04-09 20:02:46,2023-01-26 14:58:58,0,outbound,cdbb3dea8ac0192d4edbb5a8dfc5eca5b83c7256879f225915a5c0bf3bdd1384
147,bc1qz6lks9udfn78vx3cju9uyc6kqk6739hndak4ct,873,135570,135570,2022-12-24 18:26:45,2022-12-24 17:44:10,0,inbound,cdbb3dea8ac0192d4edbb5a8dfc5eca5b83c7256879f225915a5c0bf3bdd1384
148,bc1qz6lks9udfn78vx3cju9uyc6kqk6739hndak4ct,874,71291,71291,2022-12-24 18:28:32,2022-12-24 17:44:10,0,inbound,cdbb3dea8ac0192d4edbb5a8dfc5eca5b83c7256879f225915a5c0bf3bdd1384
149,bc1qz6lks9udfn78vx3cju9uyc6kqk6739hndak4ct,1175,308417251,308417251,2023-04-10 16:03:25,2023-03-09 10:38:59,0,outbound,cdbb3dea8ac0192d4edbb5a8dfc5eca5b83c7256879f225915a5c0bf3bdd1384
150,bc1qz6lks9udfn78vx3cju9uyc6kqk6739hndak4ct,1176,60053,60053,2022-12-27 20:03:01,2022-12-22 23:44:44,0,inbound,cdbb3dea8ac0192d4edbb5a8dfc5eca5b83c7256879f225915a5c0bf3bdd1384
151,bc1qz6lks9udfn78vx3cju9uyc6kqk6739hndak4ct,1662,1354112000,1354112000,2023-03-20 12:04:57,2022-03-07 04:58:14,0,inbound,cdbb3dea8ac0192d4edbb5a8dfc5eca5b83c7256879f225915a5c0bf3bdd1384
152,bc1qz6lks9udfn78vx3cju9uyc6kqk6739hndak4ct,1663,370710271,370710271,2023-01-18 11:24:27,2022-12-08 08:46:49,0,inbound,cdbb3dea8ac0192d4edbb5a8dfc5eca5b83c7256879f225915a5c0bf3bdd1384
153,bc1qz6lks9udfn78vx3cju9uyc6kqk6739hndak4ct,2004,11607291250,11604653370,2023-04-05 13:14:32,2022-12-09 04:23:11,2637880,inbound,3d2d12f2e71597036cc0a03a10df55c2f7fdd8d4708930658f73bc3560664c4e
154,bc1qz6lks9udfn78vx3cju9uyc6kqk6739hndak4ct,13,13558429,13558429,2023-04-06 18:19:25,2023-03-21 13:07:28,0,inbound,dce8271ff6ca6bacf4f9fd9ff463f587a0bb9d4c805af60777bec31dde32c916
155,bc1qz6lks9udfn78vx3cju9uyc6kqk6739hndak4ct,14,29143,29143,2023-03-23 21:39:07,2023-03-23 12:38:08,0,inbound,dce8271ff6ca6bacf4f9fd9ff463f587a0bb9d4c805af60777bec31dde32c916
156,bc1qz6lks9udfn78vx3cju9uyc6kqk6739hndak4ct,15,10892797,10892797,2023-04-04 16:13:49,2023-02-07 20:33:10,0,inbound,dce8271ff6ca6bacf4f9fd9ff463f587a0bb9d4c805af60777bec31dde32c916
157,bc1qz6lks9udfn78vx3cju9uyc6kqk6739hndak4ct,16,46703626,45336372,2023-04-07 08:17:48,2022-10-08 20:48:09,1367254,inbound,dce8271ff6ca6bacf4f9fd9ff463f587a0bb9d4c805af60777bec31dde32c916
158,bc1qz6lks9udfn78vx3cju9uyc6kqk6739hndak4ct,17,1405073,1405073,2023-03-23 13:25:17,2023-03-23 12:38:08,0,inbound,dce8271ff6ca6bacf4f9fd9ff463f587a0bb9d4c805af60777bec31dde32c916
159,bc1qz6lks9udfn78vx3cju9uyc6kqk6739hndak4ct,18,340828,340828,2023-03-26 08:25:12,2023-03-23 12:38:08,0,inbound,dce8271ff6ca6bacf4f9fd9ff463f587a0bb9d4c805af60777bec31dde32c916
160,bc1qz6lks9udfn78vx3cju9uyc6kqk6739hndak4ct,19,19670766,0,2023-03-23 12:38:08,2023-03-23 12:38:08,19670766,inbound,dce8271ff6ca6bacf4f9fd9ff463f587a0bb9d4c805af60777bec31dde32c916
161,bc1qz6lks9udfn78vx3cju9uyc6kqk6739hndak4ct,20,643421270,643421270,2023-03-23 12:48:08,2023-03-23 12:38:08,0,inbound,dce8271ff6ca6bacf4f9fd9ff463f587a0bb9d4c805af60777bec31dde32c916
162,bc1qz6lks9udfn78vx3cju9uyc6kqk6739hndak4ct,21,3925994,3925994,2023-03-23 12:48:30,2023-03-23 12:38:07,0,inbound,dce8271ff6ca6bacf4f9fd9ff463f587a0bb9d4c805af60777bec31dde32c916
163,bc1qz6lks9udfn78vx3cju9uyc6kqk6739hndak4ct,22,1105789,1068378,2023-03-23 12:38:08,2022-10-10 21:14:18,37411,inbound,dce8271ff6ca6bacf4f9fd9ff463f587a0bb9d4c805af60777bec31dde32c916
164,bc1qz6lks9udfn78vx3cju9uyc6kqk6739hndak4ct,23,45211,45211,2023-03-23 12:39:01,2023-03-23 12:38:08,0,inbound,dce8271ff6ca6bacf4f9fd9ff463f587a0bb9d4c805af60777bec31dde32c916
165,bc1qz6lks9udfn78vx3cju9uyc6kqk6739hndak4ct,24,5343825,5082577,2023-04-02 10:16:38,2022-07-03 22:22:09,261248,inbound,dce8271ff6ca6bacf4f9fd9ff463f587a0bb9d4c805af60777bec31dde32c916
166,bc1qz6lks9udfn78vx3cju9uyc6kqk6739hndak4ct,25,46793,0,2023-03-23 12:38:08,2023-03-23 12:38:08,46793,inbound,dce8271ff6ca6bacf4f9fd9ff463f587a0bb9d4c805af60777bec31dde32c916
167,bc1qz6lks9udfn78vx3cju9uyc6kqk6739hndak4ct,26,397601,397601,2023-03-23 21:33:32,2023-03-23 12:38:08,0,inbound,dce8271ff6ca6bacf4f9fd9ff463f587a0bb9d4c805af60777bec31dde32c916
168,bc1qz6lks9udfn78vx3cju9uyc6kqk6739hndak4ct,27,300000000,0,2023-03-23 12:38:07,2023-03-23 12:38:07,300000000,inbound,dce8271ff6ca6bacf4f9fd9ff463f587a0bb9d4c805af60777bec31dde32c916
169,bc1qz6lks9udfn78vx3cju9uyc6kqk6739hndak4ct,28,43378,0,2023-03-23 12:38:07,2023-03-23 12:38:07,43378,inbound,dce8271ff6ca6bacf4f9fd9ff463f587a0bb9d4c805af60777bec31dde32c916
170,bc1qz6lks9udfn78vx3cju9uyc6kqk6739hndak4ct,29,122896,122896,2023-03-31 18:22:52,2023-03-23 12:38:07,0,inbound,dce8271ff6ca6bacf4f9fd9ff463f587a0bb9d4c805af60777bec31dde32c916
171,bc1qz6lks9udfn78vx3cju9uyc6kqk6739hndak4ct,30,200930,200930,2023-03-23 12:44:24,2023-03-20 23:01:08,0,inbound,dce8271ff6ca6bacf4f9fd9ff463f587a0bb9d4c805af60777bec31dde32c916
172,bc1qz6lks9udfn78vx3cju9uyc6kqk6739hndak4ct,31,57013161,57000000,2023-03-23 12:38:08,2021-11-05 12:24:19,13161,inbound,dce8271ff6ca6bacf4f9fd9ff463f587a0bb9d4c805af60777bec31dde32c916
173,bc1qz6lks9udfn78vx3cju9uyc6kqk6739hndak4ct,32,290690791,274266622,2023-04-09 14:00:08,2023-03-20 07:29:12,16424169,outbound,dce8271ff6ca6bacf4f9fd9ff463f587a0bb9d4c805af60777bec31dde32c916
174,bc1qz6lks9udfn78vx3cju9uyc6kqk6739hndak4ct,33,439600,439600,2023-03-23 18:52:29,2023-03-23 12:38:07,0,inbound,dce8271ff6ca6bacf4f9fd9ff463f587a0bb9d4c805af60777bec31dde32c916
175,bc1qz6lks9udfn78vx3cju9uyc6kqk6739hndak4ct,34,104842,104842,2023-03-31 18:22:49,2023-03-23 12:38:07,0,inbound,dce8271ff6ca6bacf4f9fd9ff463f587a0bb9d4c805af60777bec31dde32c916
176,bc1qz6lks9udfn78vx3cju9uyc6kqk6739hndak4ct,35,684885,684885,2023-03-23 13:12:36,2023-03-23 12:38:08,0,inbound,dce8271ff6ca6bacf4f9fd9ff463f587a0bb9d4c805af60777bec31dde32c916
177,bc1qz6lks9udfn78vx3cju9uyc6kqk6739hndak4ct,36,95111,95111,2023-03-23 13:22:14,2023-03-23 12:38:07,0,inbound,dce8271ff6ca6bacf4f9fd9ff463f587a0bb9d4c805af60777bec31dde32c916
178,bc1qz6lks9udfn78vx3cju9uyc6kqk6739hndak4ct,37,461424132,461424132,2023-04-07 23:10:35,2022-11-15 15:12:11,0,inbound,dce8271ff6ca6bacf4f9fd9ff463f587a0bb9d4c805af60777bec31dde32c916
179,bc1qz6lks9udfn78vx3cju9uyc6kqk6739hndak4ct,38,108211,108211,2023-03-26 11:25:07,2023-03-23 12:38:08,0,inbound,dce8271ff6ca6bacf4f9fd9ff463f587a0bb9d4c805af60777bec31dde32c916
180,bc1qz6lks9udfn78vx3cju9uyc6kqk6739hndak4ct,39,2771690,2771690,2023-03-24 13:58:47,2023-03-23 12:38:07,0,inbound,dce8271ff6ca6bacf4f9fd9ff463f587a0bb9d4c805af60777bec31dde32c916
181,bc1qz6lks9udfn78vx3cju9uyc6kqk6739hndak4ct,40,168603,168603,2023-03-28 19:13:26,2023-03-23 12:38:08,0,inbound,dce8271ff6ca6bacf4f9fd9ff463f587a0bb9d4c805af60777bec31dde32c916
182,bc1qz6lks9udfn78vx3cju9uyc6kqk6739hndak4ct,41,238569,238569,2023-03-27 10:33:25,2023-03-23 12:38:08,0,inbound,dce8271ff6ca6bacf4f9fd9ff463f587a0bb9d4c805af60777bec31dde32c916
183,bc1qz6lks9udfn78vx3cju9uyc6kqk6739hndak4ct,42,310954,310954,2023-03-23 14:57:14,2023-03-22 05:26:09,0,inbound,dce8271ff6ca6bacf4f9fd9ff463f587a0bb9d4c805af60777bec31dde32c916
184,bc1qz6lks9udfn78vx3cju9uyc6kqk6739hndak4ct,43,18079,18079,2023-03-23 18:11:10,2023-03-23 12:38:08,0,inbound,dce8271ff6ca6bacf4f9fd9ff463f587a0bb9d4c805af60777bec31dde32c916
185,bc1qz6lks9udfn78vx3cju9uyc6kqk6739hndak4ct,44,14541902,14541902,2023-03-23 12:42:29,2023-03-23 12:38:09,0,inbound,dce8271ff6ca6bacf4f9fd9ff463f587a0bb9d4c805af60777bec31dde32c916
186,bc1qz6lks9udfn78vx3cju9uyc6kqk6739hndak4ct,45,3963041003,3963041003,2023-04-10 02:40:36,2023-03-31 13:51:04,0,inbound,dce8271ff6ca6bacf4f9fd9ff463f587a0bb9d4c805af60777bec31dde32c916
187,bc1qz6lks9udfn78vx3cju9uyc6kqk6739hndak4ct,46,9409109,9409109,2023-02-06 22:04:14,2023-01-31 14:47:07,0,inbound,dce8271ff6ca6bacf4f9fd9ff463f587a0bb9d4c805af60777bec31dde32c916
188,bc1qz6lks9udfn78vx3cju9uyc6kqk6739hndak4ct,162,60000,60000,2023-01-09 10:56:20,2023-01-05 11:09:45,0,inbound,dce8271ff6ca6bacf4f9fd9ff463f587a0bb9d4c805af60777bec31dde32c916
189,bc1qz6lks9udfn78vx3cju9uyc6kqk6739hndak4ct,163,574967,0,2023-01-17 12:57:46,2023-01-05 11:09:45,574967,inbound,dce8271ff6ca6bacf4f9fd9ff463f587a0bb9d4c805af60777bec31dde32c916
190,bc1qz6lks9udfn78vx3cju9uyc6kqk6739hndak4ct,164,1071556731,1058228327,2023-04-08 16:15:57,2023-03-13 19:17:29,13328404,inbound,dce8271ff6ca6bacf4f9fd9ff463f587a0bb9d4c805af60777bec31dde32c916
191,bc1qz6lks9udfn78vx3cju9uyc6kqk6739hndak4ct,165,57501409,57501409,2023-03-07 13:00:19,2022-10-02 02:10:35,0,inbound,dce8271ff6ca6bacf4f9fd9ff463f587a0bb9d4c805af60777bec31dde32c916
192,bc1qz6lks9udfn78vx3cju9uyc6kqk6739hndak4ct,166,189034965070135,188723522707085,2023-04-10 03:26:20,2023-04-10 00:13:10,311442363050,outbound,dce8271ff6ca6bacf4f9fd9ff463f587a0bb9d4c805af60777bec31dde32c916
193,bc1qz6lks9udfn78vx3cju9uyc6kqk6739hndak4ct,167,496372,0,2023-01-04 20:03:14,2023-01-04 20:03:14,496372,inbound,dce8271ff6ca6bacf4f9fd9ff463f587a0bb9d4c805af60777bec31dde32c916
194,bc1qz6lks9udfn78vx3cju9uyc6kqk6739hndak4ct,168,179382,179382,2023-01-05 05:02:40,2023-01-04 19:34:37,0,inbound,dce8271ff6ca6bacf4f9fd9ff463f587a0bb9d4c805af60777bec31dde32c916
195,bc1qz6lks9udfn78vx3cju9uyc6kqk6739hndak4ct,169,3896342565336130,3891910056552976,2023-04-10 03:28:00,2023-04-10 02:03:35,4432508783154,inbound,dce8271ff6ca6bacf4f9fd9ff463f587a0bb9d4c805af60777bec31dde32c916
196,bc1qz6lks9udfn78vx3cju9uyc6kqk6739hndak4ct,170,5822322,5154760,2023-03-22 13:30:51,2022-12-25 18:27:31,667562,inbound,dce8271ff6ca6bacf4f9fd9ff463f587a0bb9d4c805af60777bec31dde32c916
197,bc1qz6lks9udfn78vx3cju9uyc6kqk6739hndak4ct,171,155817,0,2023-01-04 19:34:37,2023-01-04 19:34:37,155817,inbound,dce8271ff6ca6bacf4f9fd9ff463f587a0bb9d4c805af60777bec31dde32c916
198,bc1qz6lks9udfn78vx3cju9uyc6kqk6739hndak4ct,172,24995468,24995468,2023-01-16 18:19:20,2022-12-02 21:25:18,0,inbound,dce8271ff6ca6bacf4f9fd9ff463f587a0bb9d4c805af60777bec31dde32c916
199,bc1qz6lks9udfn78vx3cju9uyc6kqk6739hndak4ct,173,600812,600812,2023-01-05 10:36:48,2023-01-04 19:34:37,0,inbound,dce8271ff6ca6bacf4f9fd9ff463f587a0bb9d4c805af60777bec31dde32c916
200,bc1qz6lks9udfn78vx3cju9uyc6kqk6739hndak4ct,174,247000,0,2023-01-04 19:34:37,2023-01-04 19:34:37,247000,inbound,dce8271ff6ca6bacf4f9fd9ff463f587a0bb9d4c805af60777bec31dde32c916
201,bc1qz6lks9udfn78vx3cju9uyc6kqk6739hndak4ct,175,404655,404655,2023-01-06 00:02:17,2023-01-04 19:34:37,0,inbound,dce8271ff6ca6bacf4f9fd9ff463f587a0bb9d4c805af60777bec31dde32c916
202,bc1qz6lks9udfn78vx3cju9uyc6kqk6739hndak4ct,176,677222696,671794243,2023-03-17 13:07:05,2022-12-10 15:56:48,5428453,inbound,dce8271ff6ca6bacf4f9fd9ff463f587a0bb9d4c805af60777bec31dde32c916
203,bc1qz6lks9udfn78vx3cju9uyc6kqk6739hndak4ct,177,80000,80000,2023-01-04 21:27:26,2023-01-04 19:34:37,0,inbound,dce8271ff6ca6bacf4f9fd9ff463f587a0bb9d4c805af60777bec31dde32c916
204,bc1qz6lks9udfn78vx3cju9uyc6kqk6739hndak4ct,178,5679000,0,2023-01-04 19:34:37,2023-01-04 19:34:37,5679000,inbound,dce8271ff6ca6bacf4f9fd9ff463f587a0bb9d4c805af60777bec31dde32c916
205,bc1qz6lks9udfn78vx3cju9uyc6kqk6739hndak4ct,179,1902333,1694134,2023-03-21 20:00:30,2022-10-10 08:00:43,208199,inbound,dce8271ff6ca6bacf4f9fd9ff463f587a0bb9d4c805af60777bec31dde32c916
206,bc1qz6lks9udfn78vx3cju9uyc6kqk6739hndak4ct,180,1975261,1975261,2023-01-05 19:11:38,2023-01-04 19:34:37,0,inbound,dce8271ff6ca6bacf4f9fd9ff463f587a0bb9d4c805af60777bec31dde32c916
207,bc1qz6lks9udfn78vx3cju9uyc6kqk6739hndak4ct,181,490960,0,2023-01-04 19:34:37,2023-01-04 19:34:37,490960,inbound,dce8271ff6ca6bacf4f9fd9ff463f587a0bb9d4c805af60777bec31dde32c916
208,bc1qz6lks9udfn78vx3cju9uyc6kqk6739hndak4ct,182,355470,355470,2023-01-05 09:08:22,2023-01-04 19:34:37,0,inbound,dce8271ff6ca6bacf4f9fd9ff463f587a0bb9d4c805af60777bec31dde32c916
209,bc1qz6lks9udfn78vx3cju9uyc6kqk6739hndak4ct,183,131645220,121972863,2023-03-30 13:13:11,2023-04-04 17:57:31,9672357,inbound,dce8271ff6ca6bacf4f9fd9ff463f587a0bb9d4c805af60777bec31dde32c916
210,bc1qz6lks9udfn78vx3cju9uyc6kqk6739hndak4ct,184,92385340,82282949,2023-04-08 07:41:59,2023-01-29 18:08:12,10102391,outbound,dce8271ff6ca6bacf4f9fd9ff463f587a0bb9d4c805af60777bec31dde32c916
211,bc1qz6lks9udfn78vx3cju9uyc6kqk6739hndak4ct,185,170277453,169832307,2023-04-09 21:41:48,2023-03-13 16:14:13,445146,inbound,dce8271ff6ca6bacf4f9fd9ff463f587a0bb9d4c805af60777bec31dde32c916
212,bc1qz6lks9udfn78vx3cju9uyc6kqk6739hndak4ct,186,12980000,12980000,2023-01-06 09:41:49,2023-01-04 19:34:37,0,inbound,dce8271ff6ca6bacf4f9fd9ff463f587a0bb9d4c805af60777bec31dde32c916
213,bc1qz6lks9udfn78vx3cju9uyc6kqk6739hndak4ct,187,34554259,34554259,2023-01-04 19:54:46,2023-01-04 16:22:36,0,inbound,dce8271ff6ca6bacf4f9fd9ff463f587a0bb9d4c805af60777bec31dde32c916
214,bc1qz6lks9udfn78vx3cju9uyc6kqk6739hndak4ct,188,24058000,24058000,2023-01-09 00:12:03,2023-01-04 19:34:37,0,inbound,dce8271ff6ca6bacf4f9fd9ff463f587a0bb9d4c805af60777bec31dde32c916
215,bc1qz6lks9udfn78vx3cju9uyc6kqk6739hndak4ct,189,42628040,42628040,2023-03-20 14:39:11,2022-06-28 03:16:42,0,inbound,dce8271ff6ca6bacf4f9fd9ff463f587a0bb9d4c805af60777bec31dde32c916
216,bc1qz6lks9udfn78vx3cju9uyc6kqk6739hndak4ct,190,78753054600,78753054600,2023-04-05 15:14:34,2023-02-27 18:21:25,0,inbound,dce8271ff6ca6bacf4f9fd9ff463f587a0bb9d4c805af60777bec31dde32c916
217,bc1qz6lks9udfn78vx3cju9uyc6kqk6739hndak4ct,191,2627887,2627887,2023-01-04 20:20:06,2023-01-04 19:34:37,0,inbound,dce8271ff6ca6bacf4f9fd9ff463f587a0bb9d4c805af60777bec31dde32c916
218,bc1qz6lks9udfn78vx3cju9uyc6kqk6739hndak4ct,192,80000,80000,2023-01-06 00:37:43,2023-01-04 19:34:37,0,inbound,dce8271ff6ca6bacf4f9fd9ff463f587a0bb9d4c805af60777bec31dde32c916
219,bc1qz6lks9udfn78vx3cju9uyc6kqk6739hndak4ct,193,4383199,4383199,2023-02-11 00:13:55,2023-01-04 19:34:37,0,inbound,dce8271ff6ca6bacf4f9fd9ff463f587a0bb9d4c805af60777bec31dde32c916
220,bc1qz6lks9udfn78vx3cju9uyc6kqk6739hndak4ct,194,242100,242100,2023-01-04 20:50:14,2023-01-04 19:34:37,0,inbound,dce8271ff6ca6bacf4f9fd9ff463f587a0bb9d4c805af60777bec31dde32c916
221,bc1qz6lks9udfn78vx3cju9uyc6kqk6739hndak4ct,195,194000,194000,2023-01-05 05:02:40,2023-01-04 19:34:37,0,inbound,dce8271ff6ca6bacf4f9fd9ff463f587a0bb9d4c805af60777bec31dde32c916
222,bc1qz6lks9udfn78vx3cju9uyc6kqk6739hndak4ct,234,375995,375995,2023-01-03 18:03:49,2023-01-03 16:39:11,0,inbound,dce8271ff6ca6bacf4f9fd9ff463f587a0bb9d4c805af60777bec31dde32c916
223,bc1qz6lks9udfn78vx3cju9uyc6kqk6739hndak4ct,235,163045796,107342774,2023-03-03 12:50:28,2023-02-21 10:28:14,55703022,inbound,dce8271ff6ca6bacf4f9fd9ff463f587a0bb9d4c805af60777bec31dde32c916
224,bc1qz6lks9udfn78vx3cju9uyc6kqk6739hndak4ct,236,39906968,39906968,2023-01-28 20:48:18,2022-07-17 18:30:08,0,inbound,dce8271ff6ca6bacf4f9fd9ff463f587a0bb9d4c805af60777bec31dde32c916
225,bc1qz6lks9udfn78vx3cju9uyc6kqk6739hndak4ct,237,10644294,8807052,2023-04-09 14:03:41,2023-03-03 09:09:09,1837242,inbound,dce8271ff6ca6bacf4f9fd9ff463f587a0bb9d4c805af60777bec31dde32c916
226,bc1qz6lks9udfn78vx3cju9uyc6kqk6739hndak4ct,238,3004555,3004555,2023-01-10 09:31:31,2023-01-03 16:39:11,0,inbound,dce8271ff6ca6bacf4f9fd9ff463f587a0bb9d4c805af60777bec31dde32c916
227,bc1qz6lks9udfn78vx3cju9uyc6kqk6739hndak4ct,239,36193118,32886800,2023-04-09 14:03:38,2023-03-31 17:17:09,3306318,inbound,dce8271ff6ca6bacf4f9fd9ff463f587a0bb9d4c805af60777bec31dde32c916
228,bc1qz6lks9udfn78vx3cju9uyc6kqk6739hndak4ct,240,338477,338477,2023-01-03 18:03:49,2023-01-03 16:39:11,0,inbound,dce8271ff6ca6bacf4f9fd9ff463f587a0bb9d4c805af60777bec31dde32c916
229,bc1qz6lks9udfn78vx3cju9uyc6kqk6739hndak4ct,241,6720730593,6709759441,2023-04-10 02:50:00,2023-04-08 00:33:02,10971152,inbound,dce8271ff6ca6bacf4f9fd9ff463f587a0bb9d4c805af60777bec31dde32c916
230,bc1qz6lks9udfn78vx3cju9uyc6kqk6739hndak4ct,242,138662361,138662361,2023-01-20 17:15:58,2022-12-12 08:17:12,0,inbound,dce8271ff6ca6bacf4f9fd9ff463f587a0bb9d4c805af60777bec31dde32c916
231,bc1qz6lks9udfn78vx3cju9uyc6kqk6739hndak4ct,243,91168,91168,2023-01-04 02:03:51,2023-01-03 16:39:11,0,inbound,dce8271ff6ca6bacf4f9fd9ff463f587a0bb9d4c805af60777bec31dde32c916
232,bc1qz6lks9udfn78vx3cju9uyc6kqk6739hndak4ct,244,79696,79696,2023-01-04 21:54:56,2023-01-03 16:39:10,0,inbound,dce8271ff6ca6bacf4f9fd9ff463f587a0bb9d4c805af60777bec31dde32c916
233,bc1qz6lks9udfn78vx3cju9uyc6kqk6739hndak4ct,245,74596389,74596389,2023-02-10 12:03:39,2023-01-17 06:02:09,0,outbound,dce8271ff6ca6bacf4f9fd9ff463f587a0bb9d4c805af60777bec31dde32c916
234,bc1qz6lks9udfn78vx3cju9uyc6kqk6739hndak4ct,257,234744,234744,2023-01-03 17:02:14,2023-01-03 16:39:09,0,inbound,dce8271ff6ca6bacf4f9fd9ff463f587a0bb9d4c805af60777bec31dde32c916
235,bc1qz6lks9udfn78vx3cju9uyc6kqk6739hndak4ct,258,8599976,8599976,2023-01-03 18:45:49,2022-11-21 19:30:07,0,inbound,dce8271ff6ca6bacf4f9fd9ff463f587a0bb9d4c805af60777bec31dde32c916
236,bc1qz6lks9udfn78vx3cju9uyc6kqk6739hndak4ct,259,317606,317606,2023-02-03 03:01:05,2023-01-03 16:39:09,0,inbound,dce8271ff6ca6bacf4f9fd9ff463f587a0bb9d4c805af60777bec31dde32c916
237,bc1qz6lks9udfn78vx3cju9uyc6kqk6739hndak4ct,260,320572662,320572662,2023-03-08 09:08:09,2022-11-22 02:58:31,0,inbound,dce8271ff6ca6bacf4f9fd9ff463f587a0bb9d4c805af60777bec31dde32c916
238,bc1qz6lks9udfn78vx3cju9uyc6kqk6739hndak4ct,261,126585094,124751902,2023-04-05 02:58:21,2022-10-26 21:17:58,1833192,inbound,dce8271ff6ca6bacf4f9fd9ff463f587a0bb9d4c805af60777bec31dde32c916
239,bc1qz6lks9udfn78vx3cju9uyc6kqk6739hndak4ct,262,72180,0,2022-12-31 17:47:07,2022-12-31 17:47:07,72180,inbound,dce8271ff6ca6bacf4f9fd9ff463f587a0bb9d4c805af60777bec31dde32c916
240,bc1qz6lks9udfn78vx3cju9uyc6kqk6739hndak4ct,263,243502,243502,2023-01-01 00:04:28,2022-12-31 17:47:07,0,inbound,dce8271ff6ca6bacf4f9fd9ff463f587a0bb9d4c805af60777bec31dde32c916
241,bc1qz6lks9udfn78vx3cju9uyc6kqk6739hndak4ct,264,724033,724033,2022-12-31 18:39:32,2022-12-31 17:47:07,0,inbound,dce8271ff6ca6bacf4f9fd9ff463f587a0bb9d4c805af60777bec31dde32c916
242,bc1qz6lks9udfn78vx3cju9uyc6kqk6739hndak4ct,265,1233439,1233439,2023-01-03 06:49:05,2022-12-31 17:47:07,0,inbound,dce8271ff6ca6bacf4f9fd9ff463f587a0bb9d4c805af60777bec31dde32c916
243,bc1qz6lks9udfn78vx3cju9uyc6kqk6739hndak4ct,266,37948956,37229139,2023-04-10 00:55:05,2022-09-09 22:22:07,719817,outbound,dce8271ff6ca6bacf4f9fd9ff463f587a0bb9d4c805af60777bec31dde32c916
244,bc1qz6lks9udfn78vx3cju9uyc6kqk6739hndak4ct,267,2941195,2941195,2022-12-31 18:54:34,2022-12-31 17:47:07,0,inbound,dce8271ff6ca6bacf4f9fd9ff463f587a0bb9d4c805af60777bec31dde32c916
245,bc1qz6lks9udfn78vx3cju9uyc6kqk6739hndak4ct,268,319817,319817,2023-01-03 08:47:51,2022-12-31 17:47:07,0,inbound,dce8271ff6ca6bacf4f9fd9ff463f587a0bb9d4c805af60777bec31dde32c916
246,bc1qz6lks9udfn78vx3cju9uyc6kqk6739hndak4ct,269,561480,561480,2023-01-05 03:36:34,2022-12-31 17:47:07,0,inbound,dce8271ff6ca6bacf4f9fd9ff463f587a0bb9d4c805af60777bec31dde32c916
247,bc1qz6lks9udfn78vx3cju9uyc6kqk6739hndak4ct,270,285302,285302,2023-01-03 06:48:15,2022-12-31 17:47:07,0,inbound,dce8271ff6ca6bacf4f9fd9ff463f587a0bb9d4c805af60777bec31dde32c916
248,bc1qz6lks9udfn78vx3cju9uyc6kqk6739hndak4ct,271,8627472,8627472,2023-02-09 08:38:08,2022-12-17 17:54:09,0,inbound,dce8271ff6ca6bacf4f9fd9ff463f587a0bb9d4c805af60777bec31dde32c916
249,bc1qz6lks9udfn78vx3cju9uyc6kqk6739hndak4ct,283,572913,572913,2023-01-01 00:04:32,2022-12-31 17:47:07,0,inbound,dce8271ff6ca6bacf4f9fd9ff463f587a0bb9d4c805af60777bec31dde32c916
250,bc1qz6lks9udfn78vx3cju9uyc6kqk6739hndak4ct,284,1146573,1146573,2022-12-31 18:50:06,2022-12-31 17:47:07,0,inbound,dce8271ff6ca6bacf4f9fd9ff463f587a0bb9d4c805af60777bec31dde32c916
251,bc1qz6lks9udfn78vx3cju9uyc6kqk6739hndak4ct,285,285302,285302,2023-01-01 00:04:31,2022-12-31 17:47:07,0,inbound,dce8271ff6ca6bacf4f9fd9ff463f587a0bb9d4c805af60777bec31dde32c916
252,bc1qz6lks9udfn78vx3cju9uyc6kqk6739hndak4ct,286,109102,109102,2023-01-18 06:16:19,2022-12-31 17:47:07,0,inbound,dce8271ff6ca6bacf4f9fd9ff463f587a0bb9d4c805af60777bec31dde32c916
253,bc1qz6lks9udfn78vx3cju9uyc6kqk6739hndak4ct,287,576696,0,2023-03-31 02:14:08,2022-09-08 03:31:51,576696,inbound,dce8271ff6ca6bacf4f9fd9ff463f587a0bb9d4c805af60777bec31dde32c916
254,bc1qz6lks9udfn78vx3cju9uyc6kqk6739hndak4ct,288,9464013,9464013,2022-12-31 20:26:11,2022-12-31 17:47:07,0,inbound,dce8271ff6ca6bacf4f9fd9ff463f587a0bb9d4c805af60777bec31dde32c916
255,bc1qz6lks9udfn78vx3cju9uyc6kqk6739hndak4ct,289,1666331,1666331,2023-02-25 13:18:32,2022-12-28 18:04:08,0,inbound,dce8271ff6ca6bacf4f9fd9ff463f587a0bb9d4c805af60777bec31dde32c916
256,bc1qz6lks9udfn78vx3cju9uyc6kqk6739hndak4ct,290,3203306,3115500,2023-04-08 21:35:13,2022-12-10 04:57:08,87806,inbound,dce8271ff6ca6bacf4f9fd9ff463f587a0bb9d4c805af60777bec31dde32c916
257,bc1qz6lks9udfn78vx3cju9uyc6kqk6739hndak4ct,291,291356943,291356943,2023-04-09 15:03:51,2022-10-17 16:00:48,0,inbound,dce8271ff6ca6bacf4f9fd9ff463f587a0bb9d4c805af60777bec31dde32c916
258,bc1qz6lks9udfn78vx3cju9uyc6kqk6739hndak4ct,292,772419,772419,2022-12-31 18:59:13,2022-12-31 17:47:07,0,inbound,dce8271ff6ca6bacf4f9fd9ff463f587a0bb9d4c805af60777bec31dde32c916
259,bc1qz6lks9udfn78vx3cju9uyc6kqk6739hndak4ct,293,390252,280332,2022-12-31 17:47:07,2021-11-30 21:52:43,109920,inbound,dce8271ff6ca6bacf4f9fd9ff463f587a0bb9d4c805af60777bec31dde32c916
260,bc1qz6lks9udfn78vx3cju9uyc6kqk6739hndak4ct,294,126716,126716,2023-01-02 22:45:32,2022-12-31 17:47:07,0,inbound,dce8271ff6ca6bacf4f9fd9ff463f587a0bb9d4c805af60777bec31dde32c916
261,bc1qz6lks9udfn78vx3cju9uyc6kqk6739hndak4ct,295,131302,131302,2022-12-31 18:29:27,2022-12-31 17:47:07,0,inbound,dce8271ff6ca6bacf4f9fd9ff463f587a0bb9d4c805af60777bec31dde32c916
262,bc1qz6lks9udfn78vx3cju9uyc6kqk6739hndak4ct,296,343908,343908,2023-01-01 00:04:31,2022-12-31 17:47:07,0,inbound,dce8271ff6ca6bacf4f9fd9ff463f587a0bb9d4c805af60777bec31dde32c916
263,bc1qz6lks9udfn78vx3cju9uyc6kqk6739hndak4ct,297,167873,167873,2023-01-03 04:51:39,2022-12-31 17:47:07,0,inbound,dce8271ff6ca6bacf4f9fd9ff463f587a0bb9d4c805af60777bec31dde32c916
264,bc1qz6lks9udfn78vx3cju9uyc6kqk6739hndak4ct,298,156302,156302,2023-01-06 16:45:37,2022-12-31 17:47:07,0,inbound,dce8271ff6ca6bacf4f9fd9ff463f587a0bb9d4c805af60777bec31dde32c916
265,bc1qz6lks9udfn78vx3cju9uyc6kqk6739hndak4ct,299,1478428,1478428,2023-01-02 04:54:42,2022-12-31 17:47:07,0,inbound,dce8271ff6ca6bacf4f9fd9ff463f587a0bb9d4c805af60777bec31dde32c916
266,bc1qz6lks9udfn78vx3cju9uyc6kqk6739hndak4ct,300,165892,165892,2023-01-03 14:44:16,2022-12-31 17:47:07,0,inbound,dce8271ff6ca6bacf4f9fd9ff463f587a0bb9d4c805af60777bec31dde32c916
267,bc1qz6lks9udfn78vx3cju9uyc6kqk6739hndak4ct,301,1943117,1943117,2022-12-31 18:50:13,2022-12-31 17:47:07,0,inbound,dce8271ff6ca6bacf4f9fd9ff463f587a0bb9d4c805af60777bec31dde32c916
268,bc1qz6lks9udfn78vx3cju9uyc6kqk6739hndak4ct,302,1147468,1147468,2023-01-02 05:19:23,2022-12-31 17:47:07,0,inbound,dce8271ff6ca6bacf4f9fd9ff463f587a0bb9d4c805af60777bec31dde32c916
269,bc1qz6lks9udfn78vx3cju9uyc6kqk6739hndak4ct,303,2179507,2179507,2023-02-09 21:15:34,2022-12-31 17:47:07,0,inbound,dce8271ff6ca6bacf4f9fd9ff463f587a0bb9d4c805af60777bec31dde32c916
270,bc1qz6lks9udfn78vx3cju9uyc6kqk6739hndak4ct,304,285280,285280,2023-01-03 06:48:24,2022-12-31 17:47:07,0,inbound,dce8271ff6ca6bacf4f9fd9ff463f587a0bb9d4c805af60777bec31dde32c916
271,bc1qz6lks9udfn78vx3cju9uyc6kqk6739hndak4ct,305,313787,313787,2023-01-04 12:36:11,2022-12-31 17:47:07,0,inbound,dce8271ff6ca6bacf4f9fd9ff463f587a0bb9d4c805af60777bec31dde32c916
272,bc1qz6lks9udfn78vx3cju9uyc6kqk6739hndak4ct,317,3187002,3187002,2023-01-02 02:23:11,2022-12-31 17:47:07,0,inbound,dce8271ff6ca6bacf4f9fd9ff463f587a0bb9d4c805af60777bec31dde32c916
273,bc1qz6lks9udfn78vx3cju9uyc6kqk6739hndak4ct,318,196113,196113,2023-01-01 00:04:28,2022-12-31 17:47:07,0,inbound,dce8271ff6ca6bacf4f9fd9ff463f587a0bb9d4c805af60777bec31dde32c916
274,bc1qz6lks9udfn78vx3cju9uyc6kqk6739hndak4ct,319,8716520,8716520,2023-01-03 10:28:01,2022-02-10 17:04:27,0,inbound,dce8271ff6ca6bacf4f9fd9ff463f587a0bb9d4c805af60777bec31dde32c916
275,bc1qz6lks9udfn78vx3cju9uyc6kqk6739hndak4ct,320,28747847,28747847,2023-03-15 23:41:26,2023-02-10 23:18:56,0,outbound,dce8271ff6ca6bacf4f9fd9ff463f587a0bb9d4c805af60777bec31dde32c916
276,bc1qz6lks9udfn78vx3cju9uyc6kqk6739hndak4ct,321,195702,195702,2022-12-31 19:32:48,2022-12-31 17:47:07,0,inbound,dce8271ff6ca6bacf4f9fd9ff463f587a0bb9d4c805af60777bec31dde32c916
277,bc1qz6lks9udfn78vx3cju9uyc6kqk6739hndak4ct,322,241374,241374,2023-01-04 01:59:20,2022-12-31 17:47:07,0,inbound,dce8271ff6ca6bacf4f9fd9ff463f587a0bb9d4c805af60777bec31dde32c916
278,bc1qz6lks9udfn78vx3cju9uyc6kqk6739hndak4ct,323,27029683,27029683,2023-04-01 13:23:50,2022-12-16 00:04:51,0,inbound,dce8271ff6ca6bacf4f9fd9ff463f587a0bb9d4c805af60777bec31dde32c916
279,bc1qz6lks9udfn78vx3cju9uyc6kqk6739hndak4ct,324,22340731,22340731,2022-12-30 16:42:12,2022-12-13 17:52:50,0,inbound,dce8271ff6ca6bacf4f9fd9ff463f587a0bb9d4c805af60777bec31dde32c916
280,bc1qz6lks9udfn78vx3cju9uyc6kqk6739hndak4ct,325,899196402,893769272,2023-04-04 04:59:52,2022-12-23 21:57:28,5427130,outbound,dce8271ff6ca6bacf4f9fd9ff463f587a0bb9d4c805af60777bec31dde32c916
281,bc1qz6lks9udfn78vx3cju9uyc6kqk6739hndak4ct,326,33561276309130,33561266328601,2023-04-10 01:20:11,2023-03-31 16:42:16,9980529,outbound,dce8271ff6ca6bacf4f9fd9ff463f587a0bb9d4c805af60777bec31dde32c916
282,bc1qz6lks9udfn78vx3cju9uyc6kqk6739hndak4ct,327,6598123,6598123,2023-03-20 15:56:55,2022-12-30 15:38:49,0,inbound,dce8271ff6ca6bacf4f9fd9ff463f587a0bb9d4c805af60777bec31dde32c916
283,bc1qz6lks9udfn78vx3cju9uyc6kqk6739hndak4ct,328,421231,421231,2022-12-30 15:47:01,2022-12-30 15:38:49,0,inbound,dce8271ff6ca6bacf4f9fd9ff463f587a0bb9d4c805af60777bec31dde32c916
284,bc1qz6lks9udfn78vx3cju9uyc6kqk6739hndak4ct,329,5611815,5611815,2023-01-10 03:18:15,2022-12-28 18:54:49,0,inbound,dce8271ff6ca6bacf4f9fd9ff463f587a0bb9d4c805af60777bec31dde32c916
285,bc1qz6lks9udfn78vx3cju9uyc6kqk6739hndak4ct,330,213571204,213571204,2023-03-16 10:22:52,2022-05-20 19:24:08,0,inbound,dce8271ff6ca6bacf4f9fd9ff463f587a0bb9d4c805af60777bec31dde32c916
286,bc1qz6lks9udfn78vx3cju9uyc6kqk6739hndak4ct,331,80000,80000,2022-12-30 16:56:40,2022-12-30 15:38:49,0,inbound,dce8271ff6ca6bacf4f9fd9ff463f587a0bb9d4c805af60777bec31dde32c916
287,bc1qz6lks9udfn78vx3cju9uyc6kqk6739hndak4ct,332,89074473,0,2022-12-30 15:38:49,2022-12-30 15:38:49,89074473,inbound,dce8271ff6ca6bacf4f9fd9ff463f587a0bb9d4c805af60777bec31dde32c916
288,bc1qz6lks9udfn78vx3cju9uyc6kqk6739hndak4ct,333,114032615,0,2023-03-19 09:46:38,2022-12-22 11:58:50,114032615,inbound,dce8271ff6ca6bacf4f9fd9ff463f587a0bb9d4c805af60777bec31dde32c916
289,bc1qz6lks9udfn78vx3cju9uyc6kqk6739hndak4ct,334,1999908,1999908,2023-01-02 17:16:11,2022-12-30 15:38:49,0,inbound,dce8271ff6ca6bacf4f9fd9ff463f587a0bb9d4c805af60777bec31dde32c916
290,bc1qz6lks9udfn78vx3cju9uyc6kqk6739hndak4ct,335,7894503,7894503,2023-01-10 17:31:12,2022-12-30 15:38:49,0,inbound,dce8271ff6ca6bacf4f9fd9ff463f587a0bb9d4c805af60777bec31dde32c916
291,bc1qz6lks9udfn78vx3cju9uyc6kqk6739hndak4ct,336,27752100,0,2022-12-30 15:38:49,2022-12-30 15:38:49,27752100,inbound,dce8271ff6ca6bacf4f9fd9ff463f587a0bb9d4c805af60777bec31dde32c916
292,bc1qz6lks9udfn78vx3cju9uyc6kqk6739hndak4ct,337,24127905,24127905,2023-03-14 12:05:47,2022-07-23 08:44:38,0,inbound,dce8271ff6ca6bacf4f9fd9ff463f587a0bb9d4c805af60777bec31dde32c916
293,bc1qz6lks9udfn78vx3cju9uyc6kqk6739hndak4ct,338,3963049,0,2022-12-30 15:38:49,2022-12-30 15:38:49,3963049,inbound,dce8271ff6ca6bacf4f9fd9ff463f587a0bb9d4c805af60777bec31dde32c916
294,bc1qz6lks9udfn78vx3cju9uyc6kqk6739hndak4ct,339,912883000,912883000,2022-12-30 17:13:43,2022-05-30 15:16:39,0,inbound,dce8271ff6ca6bacf4f9fd9ff463f587a0bb9d4c805af60777bec31dde32c916
295,bc1qz6lks9udfn78vx3cju9uyc6kqk6739hndak4ct,340,3449906,3449906,2023-01-02 12:12:11,2022-12-30 15:38:49,0,inbound,dce8271ff6ca6bacf4f9fd9ff463f587a0bb9d4c805af60777bec31dde32c916
296,bc1qz6lks9udfn78vx3cju9uyc6kqk6739hndak4ct,341,70906331,70906331,2023-04-01 00:02:20,2023-03-01 16:20:46,0,inbound,dce8271ff6ca6bacf4f9fd9ff463f587a0bb9d4c805af60777bec31dde32c916
297,bc1qz6lks9udfn78vx3cju9uyc6kqk6739hndak4ct,342,18875041,18875041,2023-04-01 20:26:45,2022-02-01 09:32:19,0,inbound,dce8271ff6ca6bacf4f9fd9ff463f587a0bb9d4c805af60777bec31dde32c916
298,bc1qz6lks9udfn78vx3cju9uyc6kqk6739hndak4ct,343,588460,588460,2022-12-31 03:10:49,2022-12-30 15:38:49,0,inbound,dce8271ff6ca6bacf4f9fd9ff463f587a0bb9d4c805af60777bec31dde32c916
299,bc1qz6lks9udfn78vx3cju9uyc6kqk6739hndak4ct,344,1310000,1310000,2022-12-31 20:22:07,2022-12-30 15:38:49,0,inbound,dce8271ff6ca6bacf4f9fd9ff463f587a0bb9d4c805af60777bec31dde32c916
300,bc1qz6lks9udfn78vx3cju9uyc6kqk6739hndak4ct,345,100000,100000,2023-01-10 07:17:26,2022-12-30 15:38:49,0,inbound,dce8271ff6ca6bacf4f9fd9ff463f587a0bb9d4c805af60777bec31dde32c916
301,bc1qz6lks9udfn78vx3cju9uyc6kqk6739hndak4ct,346,658011,657137,2022-12-30 17:46:17,2022-10-02 15:05:18,874,inbound,dce8271ff6ca6bacf4f9fd9ff463f587a0bb9d4c805af60777bec31dde32c916
302,bc1qz6lks9udfn78vx3cju9uyc6kqk6739hndak4ct,347,333843652,328938630,2023-04-01 04:37:55,2022-12-28 04:44:13,4905022,outbound,dce8271ff6ca6bacf4f9fd9ff463f587a0bb9d4c805af60777bec31dde32c916
303,bc1qz6lks9udfn78vx3cju9uyc6kqk6739hndak4ct,348,12192925,12192925,2022-12-30 16:02:15,2022-12-30 15:38:49,0,inbound,dce8271ff6ca6bacf4f9fd9ff463f587a0bb9d4c805af60777bec31dde32c916
304,bc1qz6lks9udfn78vx3cju9uyc6kqk6739hndak4ct,349,5813000,0,2022-12-30 15:38:49,2022-12-30 15:38:49,5813000,inbound,dce8271ff6ca6bacf4f9fd9ff463f587a0bb9d4c805af60777bec31dde32c916
305,bc1qz6lks9udfn78vx3cju9uyc6kqk6739hndak4ct,350,4567377801,4539124882,2023-04-09 20:02:08,2023-03-21 10:34:16,28252919,outbound,dce8271ff6ca6bacf4f9fd9ff463f587a0bb9d4c805af60777bec31dde32c916
306,bc1qz6lks9udfn78vx3cju9uyc6kqk6739hndak4ct,446,888002784,887385784,2023-02-06 03:15:37,2022-11-16 01:24:23,617000,inbound,dce8271ff6ca6bacf4f9fd9ff463f587a0bb9d4c805af60777bec31dde32c916
307,bc1qz6lks9udfn78vx3cju9uyc6kqk6739hndak4ct,447,605954,605954,2022-12-29 06:38:29,2022-12-28 21:55:38,0,inbound,dce8271ff6ca6bacf4f9fd9ff463f587a0bb9d4c805af60777bec31dde32c916
308,bc1qz6lks9udfn78vx3cju9uyc6kqk6739hndak4ct,448,7377314,7377314,2023-01-22 00:30:19,2022-07-14 20:57:56,0,inbound,dce8271ff6ca6bacf4f9fd9ff463f587a0bb9d4c805af60777bec31dde32c916
309,bc1qz6lks9udfn78vx3cju9uyc6kqk6739hndak4ct,449,54723544,54723544,2023-04-03 18:02:45,2022-10-21 19:50:50,0,inbound,dce8271ff6ca6bacf4f9fd9ff463f587a0bb9d4c805af60777bec31dde32c916
310,bc1qz6lks9udfn78vx3cju9uyc6kqk6739hndak4ct,450,41472021,39982789,2023-04-09 13:24:39,2022-12-31 19:43:27,1489232,inbound,dce8271ff6ca6bacf4f9fd9ff463f587a0bb9d4c805af60777bec31dde32c916
311,bc1qz6lks9udfn78vx3cju9uyc6kqk6739hndak4ct,451,326048206,326048206,2023-03-25 06:03:21,2023-02-09 05:23:43,0,inbound,dce8271ff6ca6bacf4f9fd9ff463f587a0bb9d4c805af60777bec31dde32c916
312,bc1qz6lks9udfn78vx3cju9uyc6kqk6739hndak4ct,452,195437095,194049955,2023-04-01 14:28:38,2023-03-01 19:54:39,1387140,inbound,dce8271ff6ca6bacf4f9fd9ff463f587a0bb9d4c805af60777bec31dde32c916
313,bc1qz6lks9udfn78vx3cju9uyc6kqk6739hndak4ct,453,20463841,20463841,2023-04-05 13:03:35,2022-08-20 16:35:28,0,inbound,dce8271ff6ca6bacf4f9fd9ff463f587a0bb9d4c805af60777bec31dde32c916
314,bc1qz6lks9udfn78vx3cju9uyc6kqk6739hndak4ct,454,8001024,8001024,2023-01-20 10:11:04,2022-12-21 22:44:54,0,inbound,dce8271ff6ca6bacf4f9fd9ff463f587a0bb9d4c805af60777bec31dde32c916
315,bc1qz6lks9udfn78vx3cju9uyc6kqk6739hndak4ct,455,282514,282514,2022-12-29 00:02:23,2022-12-28 21:55:38,0,inbound,dce8271ff6ca6bacf4f9fd9ff463f587a0bb9d4c805af60777bec31dde32c916
316,bc1qz6lks9udfn78vx3cju9uyc6kqk6739hndak4ct,456,1418637,1418637,2022-12-29 07:56:56,2022-12-28 18:04:51,0,inbound,dce8271ff6ca6bacf4f9fd9ff463f587a0bb9d4c805af60777bec31dde32c916
317,bc1qz6lks9udfn78vx3cju9uyc6kqk6739hndak4ct,457,272618,272618,2022-12-29 04:55:17,2022-12-28 21:55:38,0,inbound,dce8271ff6ca6bacf4f9fd9ff463f587a0bb9d4c805af60777bec31dde32c916
318,bc1qz6lks9udfn78vx3cju9uyc6kqk6739hndak4ct,458,2961522,2961522,2022-12-28 23:15:13,2022-12-28 21:55:38,0,inbound,dce8271ff6ca6bacf4f9fd9ff463f587a0bb9d4c805af60777bec31dde32c916
319,bc1qz6lks9udfn78vx3cju9uyc6kqk6739hndak4ct,459,31841387,31834145,2023-01-26 05:07:15,2022-11-03 23:37:00,7242,inbound,dce8271ff6ca6bacf4f9fd9ff463f587a0bb9d4c805af60777bec31dde32c916
320,bc1qz6lks9udfn78vx3cju9uyc6kqk6739hndak4ct,460,316385956,309845491,2023-03-12 10:34:16,2023-02-22 06:57:07,6540465,inbound,dce8271ff6ca6bacf4f9fd9ff463f587a0bb9d4c805af60777bec31dde32c916
321,bc1qz6lks9udfn78vx3cju9uyc6kqk6739hndak4ct,461,193833,193833,2022-12-29 00:02:16,2022-12-28 21:55:38,0,inbound,dce8271ff6ca6bacf4f9fd9ff463f587a0bb9d4c805af60777bec31dde32c916
322,bc1qz6lks9udfn78vx3cju9uyc6kqk6739hndak4ct,462,214737921,212387886,2023-04-06 08:01:04,2023-02-05 18:00:51,2350035,inbound,dce8271ff6ca6bacf4f9fd9ff463f587a0bb9d4c805af60777bec31dde32c916
323,bc1qz6lks9udfn78vx3cju9uyc6kqk6739hndak4ct,463,5095753892,5095753892,2023-04-07 08:02:17,2023-02-08 08:05:26,0,inbound,dce8271ff6ca6bacf4f9fd9ff463f587a0bb9d4c805af60777bec31dde32c916
324,bc1qz6lks9udfn78vx3cju9uyc6kqk6739hndak4ct,480,1717262555,1714582307,2023-04-09 13:11:56,2023-03-08 21:49:25,2680248,outbound,dce8271ff6ca6bacf4f9fd9ff463f587a0bb9d4c805af60777bec31dde32c916
325,bc1qz6lks9udfn78vx3cju9uyc6kqk6739hndak4ct,481,121164,121164,2023-01-03 23:24:34,2022-12-28 21:55:38,0,inbound,dce8271ff6ca6bacf4f9fd9ff463f587a0bb9d4c805af60777bec31dde32c916
326,bc1qz6lks9udfn78vx3cju9uyc6kqk6739hndak4ct,482,532890,532890,2023-01-26 22:17:13,2022-12-28 21:55:38,0,inbound,dce8271ff6ca6bacf4f9fd9ff463f587a0bb9d4c805af60777bec31dde32c916
327,bc1qz6lks9udfn78vx3cju9uyc6kqk6739hndak4ct,483,5938463,5938463,2022-12-28 22:43:11,2022-12-28 21:55:38,0,inbound,dce8271ff6ca6bacf4f9fd9ff463f587a0bb9d4c805af60777bec31dde32c916
328,bc1qz6lks9udfn78vx3cju9uyc6kqk6739hndak4ct,484,359521,359521,2022-12-28 22:52:12,2022-12-28 21:55:38,0,inbound,dce8271ff6ca6bacf4f9fd9ff463f587a0bb9d4c805af60777bec31dde32c916
329,bc1qz6lks9udfn78vx3cju9uyc6kqk6739hndak4ct,485,181870,181870,2022-12-28 22:12:21,2022-12-28 21:55:38,0,inbound,dce8271ff6ca6bacf4f9fd9ff463f587a0bb9d4c805af60777bec31dde32c916
330,bc1qz6lks9udfn78vx3cju9uyc6kqk6739hndak4ct,486,19543145,17478086,2023-04-09 19:51:05,2022-11-16 14:29:48,2065059,inbound,dce8271ff6ca6bacf4f9fd9ff463f587a0bb9d4c805af60777bec31dde32c916
331,bc1qz6lks9udfn78vx3cju9uyc6kqk6739hndak4ct,487,5682892,5682892,2022-12-29 12:02:17,2022-12-28 21:55:38,0,inbound,dce8271ff6ca6bacf4f9fd9ff463f587a0bb9d4c805af60777bec31dde32c916
332,bc1qz6lks9udfn78vx3cju9uyc6kqk6739hndak4ct,488,252060,252060,2023-01-03 09:27:37,2022-12-28 21:55:38,0,inbound,dce8271ff6ca6bacf4f9fd9ff463f587a0bb9d4c805af60777bec31dde32c916
333,bc1qz6lks9udfn78vx3cju9uyc6kqk6739hndak4ct,489,227017757,227017757,2022-12-29 01:53:14,2022-12-28 21:55:38,0,inbound,dce8271ff6ca6bacf4f9fd9ff463f587a0bb9d4c805af60777bec31dde32c916
334,bc1qz6lks9udfn78vx3cju9uyc6kqk6739hndak4ct,490,57858667,45619417,2023-04-07 13:30:07,2022-11-06 05:51:26,12239250,inbound,dce8271ff6ca6bacf4f9fd9ff463f587a0bb9d4c805af60777bec31dde32c916
335,bc1qz6lks9udfn78vx3cju9uyc6kqk6739hndak4ct,491,108827,108827,2022-12-28 22:02:25,2022-12-28 21:55:38,0,inbound,dce8271ff6ca6bacf4f9fd9ff463f587a0bb9d4c805af60777bec31dde32c916
336,bc1qz6lks9udfn78vx3cju9uyc6kqk6739hndak4ct,492,163543,163543,2022-12-29 00:02:15,2022-12-28 21:55:38,0,inbound,dce8271ff6ca6bacf4f9fd9ff463f587a0bb9d4c805af60777bec31dde32c916
337,bc1qz6lks9udfn78vx3cju9uyc6kqk6739hndak4ct,493,6045524,6045524,2023-02-20 13:28:59,2022-12-28 20:15:07,0,inbound,dce8271ff6ca6bacf4f9fd9ff463f587a0bb9d4c805af60777bec31dde32c916
338,bc1qz6lks9udfn78vx3cju9uyc6kqk6739hndak4ct,494,23470664618,23468373559,2023-04-09 18:35:24,2023-03-24 10:34:36,2291059,inbound,dce8271ff6ca6bacf4f9fd9ff463f587a0bb9d4c805af60777bec31dde32c916
339,bc1qz6lks9udfn78vx3cju9uyc6kqk6739hndak4ct,495,282523,282523,2022-12-28 22:01:48,2022-12-28 21:55:38,0,inbound,dce8271ff6ca6bacf4f9fd9ff463f587a0bb9d4c805af60777bec31dde32c916
340,bc1qz6lks9udfn78vx3cju9uyc6kqk6739hndak4ct,496,5174588,5174588,2023-04-03 01:54:42,2022-07-27 15:52:25,0,inbound,dce8271ff6ca6bacf4f9fd9ff463f587a0bb9d4c805af60777bec31dde32c916
341,bc1qz6lks9udfn78vx3cju9uyc6kqk6739hndak4ct,497,121168,121168,2022-12-30 06:18:13,2022-12-28 21:55:38,0,inbound,dce8271ff6ca6bacf4f9fd9ff463f587a0bb9d4c805af60777bec31dde32c916
342,bc1qz6lks9udfn78vx3cju9uyc6kqk6739hndak4ct,498,99486512,99229834,2023-03-31 05:11:36,2023-02-07 06:03:41,256678,outbound,dce8271ff6ca6bacf4f9fd9ff463f587a0bb9d4c805af60777bec31dde32c916
343,bc1qz6lks9udfn78vx3cju9uyc6kqk6739hndak4ct,499,12154461,11949753,2023-03-26 08:48:17,2022-11-27 23:27:04,204708,inbound,dce8271ff6ca6bacf4f9fd9ff463f587a0bb9d4c805af60777bec31dde32c916
344,bc1qz6lks9udfn78vx3cju9uyc6kqk6739hndak4ct,500,1474069,1474069,2022-12-30 23:03:10,2022-12-28 21:55:38,0,inbound,dce8271ff6ca6bacf4f9fd9ff463f587a0bb9d4c805af60777bec31dde32c916
345,bc1qz6lks9udfn78vx3cju9uyc6kqk6739hndak4ct,501,363444,363444,2022-12-29 15:06:18,2022-12-28 21:55:38,0,inbound,dce8271ff6ca6bacf4f9fd9ff463f587a0bb9d4c805af60777bec31dde32c916
346,bc1qz6lks9udfn78vx3cju9uyc6kqk6739hndak4ct,502,252916,252916,2022-12-29 08:18:27,2022-12-28 21:55:38,0,inbound,dce8271ff6ca6bacf4f9fd9ff463f587a0bb9d4c805af60777bec31dde32c916
347,bc1qz6lks9udfn78vx3cju9uyc6kqk6739hndak4ct,503,64163284,64163284,2023-04-09 17:50:10,2023-01-28 02:01:44,0,outbound,dce8271ff6ca6bacf4f9fd9ff463f587a0bb9d4c805af60777bec31dde32c916
348,bc1qz6lks9udfn78vx3cju9uyc6kqk6739hndak4ct,504,10949238,10949238,2022-12-28 22:28:37,2022-12-26 10:24:28,0,inbound,dce8271ff6ca6bacf4f9fd9ff463f587a0bb9d4c805af60777bec31dde32c916
349,bc1qz6lks9udfn78vx3cju9uyc6kqk6739hndak4ct,505,45763,45763,2023-01-04 01:41:10,2022-12-28 21:55:38,0,inbound,dce8271ff6ca6bacf4f9fd9ff463f587a0bb9d4c805af60777bec31dde32c916
350,bc1qz6lks9udfn78vx3cju9uyc6kqk6739hndak4ct,506,227017753,227017753,2022-12-29 01:53:14,2022-12-28 21:55:38,0,inbound,dce8271ff6ca6bacf4f9fd9ff463f587a0bb9d4c805af60777bec31dde32c916
351,bc1qz6lks9udfn78vx3cju9uyc6kqk6739hndak4ct,507,227017753,227017753,2022-12-29 01:54:43,2022-12-28 21:55:38,0,inbound,dce8271ff6ca6bacf4f9fd9ff463f587a0bb9d4c805af60777bec31dde32c916
352,bc1qz6lks9udfn78vx3cju9uyc6kqk6739hndak4ct,508,8079148,7847614,2023-04-02 09:19:45,2022-12-21 02:47:54,231534,inbound,dce8271ff6ca6bacf4f9fd9ff463f587a0bb9d4c805af60777bec31dde32c916
353,bc1qz6lks9udfn78vx3cju9uyc6kqk6739hndak4ct,509,61342867,60998365,2023-04-07 12:12:05,2022-12-04 23:23:04,344502,outbound,dce8271ff6ca6bacf4f9fd9ff463f587a0bb9d4c805af60777bec31dde32c916
354,bc1qz6lks9udfn78vx3cju9uyc6kqk6739hndak4ct,510,244734616,244734616,2023-04-06 03:40:41,2020-11-24 19:09:19,0,inbound,dce8271ff6ca6bacf4f9fd9ff463f587a0bb9d4c805af60777bec31dde32c916
355,bc1qz6lks9udfn78vx3cju9uyc6kqk6739hndak4ct,511,124436251,124245815,2023-04-09 08:06:15,2023-01-06 13:01:30,190436,outbound,dce8271ff6ca6bacf4f9fd9ff463f587a0bb9d4c805af60777bec31dde32c916
356,bc1qz6lks9udfn78vx3cju9uyc6kqk6739hndak4ct,512,208507,208507,2022-12-28 22:03:09,2022-12-28 21:55:38,0,inbound,dce8271ff6ca6bacf4f9fd9ff463f587a0bb9d4c805af60777bec31dde32c916
357,bc1qz6lks9udfn78vx3cju9uyc6kqk6739hndak4ct,513,341733,341733,2022-12-29 00:02:20,2022-12-28 21:55:38,0,inbound,dce8271ff6ca6bacf4f9fd9ff463f587a0bb9d4c805af60777bec31dde32c916
358,bc1qz6lks9udfn78vx3cju9uyc6kqk6739hndak4ct,711,130617,130617,2023-01-03 09:19:24,2022-12-26 19:27:29,0,inbound,dce8271ff6ca6bacf4f9fd9ff463f587a0bb9d4c805af60777bec31dde32c916
359,bc1qz6lks9udfn78vx3cju9uyc6kqk6739hndak4ct,712,20930082,20930082,2022-12-28 23:16:08,2022-10-01 15:00:55,0,outbound,dce8271ff6ca6bacf4f9fd9ff463f587a0bb9d4c805af60777bec31dde32c916
360,bc1qz6lks9udfn78vx3cju9uyc6kqk6739hndak4ct,713,5937051,5937051,2022-12-28 00:33:40,2022-12-26 19:27:29,0,inbound,dce8271ff6ca6bacf4f9fd9ff463f587a0bb9d4c805af60777bec31dde32c916
361,bc1qz6lks9udfn78vx3cju9uyc6kqk6739hndak4ct,714,41596,41596,2023-01-12 18:24:12,2022-12-26 19:27:29,0,inbound,dce8271ff6ca6bacf4f9fd9ff463f587a0bb9d4c805af60777bec31dde32c916
362,bc1qz6lks9udfn78vx3cju9uyc6kqk6739hndak4ct,715,2535122776,2535122776,2023-04-10 13:17:51,2023-04-06 19:31:00,0,inbound,dce8271ff6ca6bacf4f9fd9ff463f587a0bb9d4c805af60777bec31dde32c916
363,bc1qz6lks9udfn78vx3cju9uyc6kqk6739hndak4ct,716,335054,335054,2023-01-14 14:34:08,2022-12-26 19:27:29,0,inbound,dce8271ff6ca6bacf4f9fd9ff463f587a0bb9d4c805af60777bec31dde32c916
364,bc1qz6lks9udfn78vx3cju9uyc6kqk6739hndak4ct,717,566989,566989,2023-01-03 17:01:10,2022-12-26 19:27:29,0,inbound,dce8271ff6ca6bacf4f9fd9ff463f587a0bb9d4c805af60777bec31dde32c916
365,bc1qz6lks9udfn78vx3cju9uyc6kqk6739hndak4ct,718,205947,205947,2022-12-27 00:07:42,2022-12-26 19:27:29,0,inbound,dce8271ff6ca6bacf4f9fd9ff463f587a0bb9d4c805af60777bec31dde32c916
366,bc1qz6lks9udfn78vx3cju9uyc6kqk6739hndak4ct,719,9016693,8479121,2023-04-09 23:29:57,2022-11-05 00:45:46,537572,inbound,dce8271ff6ca6bacf4f9fd9ff463f587a0bb9d4c805af60777bec31dde32c916
367,bc1qz6lks9udfn78vx3cju9uyc6kqk6739hndak4ct,720,108056,108056,2022-12-27 05:01:37,2022-12-26 19:27:29,0,inbound,dce8271ff6ca6bacf4f9fd9ff463f587a0bb9d4c805af60777bec31dde32c916
368,bc1qz6lks9udfn78vx3cju9uyc6kqk6739hndak4ct,721,593706,593706,2022-12-27 01:09:28,2022-12-26 19:27:29,0,inbound,dce8271ff6ca6bacf4f9fd9ff463f587a0bb9d4c805af60777bec31dde32c916
369,bc1qz6lks9udfn78vx3cju9uyc6kqk6739hndak4ct,722,1139924,1139924,2022-12-27 07:44:42,2022-12-26 19:27:29,0,inbound,dce8271ff6ca6bacf4f9fd9ff463f587a0bb9d4c805af60777bec31dde32c916
370,bc1qz6lks9udfn78vx3cju9uyc6kqk6739hndak4ct,723,201863,201863,2022-12-27 06:00:33,2022-12-26 19:27:29,0,inbound,dce8271ff6ca6bacf4f9fd9ff463f587a0bb9d4c805af60777bec31dde32c916
371,bc1qz6lks9udfn78vx3cju9uyc6kqk6739hndak4ct,724,335074,335074,2022-12-27 17:54:27,2022-12-26 19:27:29,0,inbound,dce8271ff6ca6bacf4f9fd9ff463f587a0bb9d4c805af60777bec31dde32c916
372,bc1qz6lks9udfn78vx3cju9uyc6kqk6739hndak4ct,725,150251979,150251979,2023-03-03 20:57:12,2022-05-15 18:02:59,0,inbound,dce8271ff6ca6bacf4f9fd9ff463f587a0bb9d4c805af60777bec31dde32c916
373,bc1qz6lks9udfn78vx3cju9uyc6kqk6739hndak4ct,726,1092305,1092305,2022-12-30 15:11:39,2022-12-26 19:27:29,0,inbound,dce8271ff6ca6bacf4f9fd9ff463f587a0bb9d4c805af60777bec31dde32c916
374,bc1qz6lks9udfn78vx3cju9uyc6kqk6739hndak4ct,727,160301,160301,2022-12-26 20:31:32,2022-12-26 19:27:29,0,inbound,dce8271ff6ca6bacf4f9fd9ff463f587a0bb9d4c805af60777bec31dde32c916
375,bc1qz6lks9udfn78vx3cju9uyc6kqk6739hndak4ct,728,162432459,162354820,2023-04-10 10:17:58,2023-02-17 23:48:57,77639,inbound,dce8271ff6ca6bacf4f9fd9ff463f587a0bb9d4c805af60777bec31dde32c916
376,bc1qz6lks9udfn78vx3cju9uyc6kqk6739hndak4ct,729,144110138,144110138,2023-04-04 22:29:41,2022-12-30 17:02:11,0,inbound,dce8271ff6ca6bacf4f9fd9ff463f587a0bb9d4c805af60777bec31dde32c916
377,bc1qz6lks9udfn78vx3cju9uyc6kqk6739hndak4ct,730,76503478,75814978,2023-03-30 13:13:37,2023-03-05 08:54:29,688500,outbound,dce8271ff6ca6bacf4f9fd9ff463f587a0bb9d4c805af60777bec31dde32c916
378,bc1qz6lks9udfn78vx3cju9uyc6kqk6739hndak4ct,731,102895,0,2022-12-26 19:27:29,2022-12-26 19:27:29,102895,inbound,dce8271ff6ca6bacf4f9fd9ff463f587a0bb9d4c805af60777bec31dde32c916
379,bc1qz6lks9udfn78vx3cju9uyc6kqk6739hndak4ct,732,641193,641193,2022-12-27 00:07:48,2022-12-26 19:27:29,0,inbound,dce8271ff6ca6bacf4f9fd9ff463f587a0bb9d4c805af60777bec31dde32c916
380,bc1qz6lks9udfn78vx3cju9uyc6kqk6739hndak4ct,733,13633653302,13616065164,2023-04-10 15:24:31,2023-04-07 10:40:57,17588138,inbound,dce8271ff6ca6bacf4f9fd9ff463f587a0bb9d4c805af60777bec31dde32c916
381,bc1qz6lks9udfn78vx3cju9uyc6kqk6739hndak4ct,734,184048,184048,2022-12-27 15:45:59,2022-12-26 19:27:29,0,inbound,dce8271ff6ca6bacf4f9fd9ff463f587a0bb9d4c805af60777bec31dde32c916
382,bc1qz6lks9udfn78vx3cju9uyc6kqk6739hndak4ct,735,917803,917803,2022-12-27 00:07:55,2022-12-26 19:27:29,0,inbound,dce8271ff6ca6bacf4f9fd9ff463f587a0bb9d4c805af60777bec31dde32c916
383,bc1qz6lks9udfn78vx3cju9uyc6kqk6739hndak4ct,736,456592698,456452848,2023-04-09 20:32:25,2022-10-11 15:47:27,139850,outbound,dce8271ff6ca6bacf4f9fd9ff463f587a0bb9d4c805af60777bec31dde32c916
384,bc1qz6lks9udfn78vx3cju9uyc6kqk6739hndak4ct,737,2292067936,2292067936,2023-04-10 14:07:02,2023-04-05 08:13:04,0,outbound,dce8271ff6ca6bacf4f9fd9ff463f587a0bb9d4c805af60777bec31dde32c916
385,bc1qz6lks9udfn78vx3cju9uyc6kqk6739hndak4ct,738,68877491,68877491,2023-04-09 18:19:23,2023-02-19 23:55:12,0,inbound,dce8271ff6ca6bacf4f9fd9ff463f587a0bb9d4c805af60777bec31dde32c916
386,bc1qz6lks9udfn78vx3cju9uyc6kqk6739hndak4ct,739,132133,132133,2022-12-26 21:31:50,2022-12-26 19:27:29,0,inbound,dce8271ff6ca6bacf4f9fd9ff463f587a0bb9d4c805af60777bec31dde32c916
387,bc1qz6lks9udfn78vx3cju9uyc6kqk6739hndak4ct,740,123712,123712,2022-12-26 20:31:32,2022-12-26 19:27:29,0,inbound,dce8271ff6ca6bacf4f9fd9ff463f587a0bb9d4c805af60777bec31dde32c916
388,bc1qz6lks9udfn78vx3cju9uyc6kqk6739hndak4ct,741,75486596,73983533,2023-04-10 08:25:53,2023-03-22 03:48:02,1503063,inbound,dce8271ff6ca6bacf4f9fd9ff463f587a0bb9d4c805af60777bec31dde32c916
389,bc1qz6lks9udfn78vx3cju9uyc6kqk6739hndak4ct,742,80044108,80025951,2023-03-08 22:22:41,2022-12-27 20:14:52,18157,outbound,dce8271ff6ca6bacf4f9fd9ff463f587a0bb9d4c805af60777bec31dde32c916
390,bc1qz6lks9udfn78vx3cju9uyc6kqk6739hndak4ct,743,142303,142303,2022-12-27 00:07:43,2022-12-26 19:27:29,0,inbound,dce8271ff6ca6bacf4f9fd9ff463f587a0bb9d4c805af60777bec31dde32c916
391,bc1qz6lks9udfn78vx3cju9uyc6kqk6739hndak4ct,744,419880,0,2022-12-26 19:27:29,2022-12-26 19:27:29,419880,inbound,dce8271ff6ca6bacf4f9fd9ff463f587a0bb9d4c805af60777bec31dde32c916
392,bc1qz6lks9udfn78vx3cju9uyc6kqk6739hndak4ct,875,10942406590,10931815791,2023-04-10 13:17:51,2023-04-03 16:48:44,10590799,outbound,dce8271ff6ca6bacf4f9fd9ff463f587a0bb9d4c805af60777bec31dde32c916
393,bc1qz6lks9udfn78vx3cju9uyc6kqk6739hndak4ct,876,161934,161934,2022-12-25 00:02:56,2022-12-24 17:44:10,0,inbound,dce8271ff6ca6bacf4f9fd9ff463f587a0bb9d4c805af60777bec31dde32c916
394,bc1qz6lks9udfn78vx3cju9uyc6kqk6739hndak4ct,877,118820,118820,2023-01-02 23:28:25,2022-12-24 17:44:10,0,inbound,dce8271ff6ca6bacf4f9fd9ff463f587a0bb9d4c805af60777bec31dde32c916
395,bc1qz6lks9udfn78vx3cju9uyc6kqk6739hndak4ct,878,320846,320846,2022-12-26 23:20:12,2022-12-24 17:44:10,0,inbound,dce8271ff6ca6bacf4f9fd9ff463f587a0bb9d4c805af60777bec31dde32c916
396,bc1qz6lks9udfn78vx3cju9uyc6kqk6739hndak4ct,879,136161,136161,2022-12-25 20:19:04,2022-12-24 17:44:10,0,inbound,dce8271ff6ca6bacf4f9fd9ff463f587a0bb9d4c805af60777bec31dde32c916
397,bc1qz6lks9udfn78vx3cju9uyc6kqk6739hndak4ct,880,31628069,31628069,2023-04-09 22:14:44,2023-01-07 20:21:27,0,outbound,dce8271ff6ca6bacf4f9fd9ff463f587a0bb9d4c805af60777bec31dde32c916
398,bc1qz6lks9udfn78vx3cju9uyc6kqk6739hndak4ct,881,76926173,76237585,2023-04-10 15:13:08,2023-03-11 12:23:07,688588,inbound,dce8271ff6ca6bacf4f9fd9ff463f587a0bb9d4c805af60777bec31dde32c916
399,bc1qz6lks9udfn78vx3cju9uyc6kqk6739hndak4ct,882,600140,0,2022-12-24 17:44:10,2022-12-24 17:44:10,600140,inbound,dce8271ff6ca6bacf4f9fd9ff463f587a0bb9d4c805af60777bec31dde32c916
400,bc1qz6lks9udfn78vx3cju9uyc6kqk6739hndak4ct,883,117823,117823,2022-12-25 00:02:53,2022-12-24 17:44:10,0,inbound,dce8271ff6ca6bacf4f9fd9ff463f587a0bb9d4c805af60777bec31dde32c916
401,bc1qz6lks9udfn78vx3cju9uyc6kqk6739hndak4ct,884,210006,210006,2022-12-25 21:59:15,2022-12-24 17:44:10,0,inbound,dce8271ff6ca6bacf4f9fd9ff463f587a0bb9d4c805af60777bec31dde32c916
402,bc1qz6lks9udfn78vx3cju9uyc6kqk6739hndak4ct,885,72967910,72967910,2023-04-05 01:25:17,2022-05-12 23:19:11,0,inbound,dce8271ff6ca6bacf4f9fd9ff463f587a0bb9d4c805af60777bec31dde32c916
403,bc1qz6lks9udfn78vx3cju9uyc6kqk6739hndak4ct,886,175432271,175432271,2022-12-31 06:11:21,2022-12-28 01:25:09,0,inbound,dce8271ff6ca6bacf4f9fd9ff463f587a0bb9d4c805af60777bec31dde32c916
404,bc1qz6lks9udfn78vx3cju9uyc6kqk6739hndak4ct,887,261421785,261361067,2023-04-09 13:36:30,2023-03-22 19:02:06,60718,inbound,dce8271ff6ca6bacf4f9fd9ff463f587a0bb9d4c805af60777bec31dde32c916
405,bc1qz6lks9udfn78vx3cju9uyc6kqk6739hndak4ct,888,46221423,46079998,2023-03-31 10:45:15,2022-04-21 06:55:10,141425,inbound,dce8271ff6ca6bacf4f9fd9ff463f587a0bb9d4c805af60777bec31dde32c916
406,bc1qz6lks9udfn78vx3cju9uyc6kqk6739hndak4ct,889,279334973,271284768,2023-04-10 14:20:07,2023-02-22 21:59:05,8050205,outbound,dce8271ff6ca6bacf4f9fd9ff463f587a0bb9d4c805af60777bec31dde32c916
407,bc1qz6lks9udfn78vx3cju9uyc6kqk6739hndak4ct,890,280991,280991,2022-12-28 13:32:12,2022-12-24 17:44:10,0,inbound,dce8271ff6ca6bacf4f9fd9ff463f587a0bb9d4c805af60777bec31dde32c916
408,bc1qz6lks9udfn78vx3cju9uyc6kqk6739hndak4ct,891,1066195,1066195,2022-12-26 16:20:25,2022-12-24 17:44:10,0,inbound,dce8271ff6ca6bacf4f9fd9ff463f587a0bb9d4c805af60777bec31dde32c916
409,bc1qz6lks9udfn78vx3cju9uyc6kqk6739hndak4ct,892,7443484,7443484,2022-12-31 12:40:47,2022-06-16 03:51:06,0,inbound,dce8271ff6ca6bacf4f9fd9ff463f587a0bb9d4c805af60777bec31dde32c916
410,bc1qz6lks9udfn78vx3cju9uyc6kqk6739hndak4ct,893,897054,897054,2022-12-27 07:44:42,2022-12-24 17:44:10,0,inbound,dce8271ff6ca6bacf4f9fd9ff463f587a0bb9d4c805af60777bec31dde32c916
411,bc1qz6lks9udfn78vx3cju9uyc6kqk6739hndak4ct,894,564384,564384,2022-12-25 00:03:01,2022-12-24 17:44:10,0,inbound,dce8271ff6ca6bacf4f9fd9ff463f587a0bb9d4c805af60777bec31dde32c916
412,bc1qz6lks9udfn78vx3cju9uyc6kqk6739hndak4ct,895,297042,297042,2022-12-24 18:29:11,2022-12-24 17:44:10,0,inbound,dce8271ff6ca6bacf4f9fd9ff463f587a0bb9d4c805af60777bec31dde32c916
413,bc1qz6lks9udfn78vx3cju9uyc6kqk6739hndak4ct,896,1075200,1075200,2022-12-26 20:46:53,2022-12-24 17:44:10,0,inbound,dce8271ff6ca6bacf4f9fd9ff463f587a0bb9d4c805af60777bec31dde32c916
414,bc1qz6lks9udfn78vx3cju9uyc6kqk6739hndak4ct,897,594088,594088,2022-12-25 06:02:21,2022-12-24 17:44:10,0,inbound,dce8271ff6ca6bacf4f9fd9ff463f587a0bb9d4c805af60777bec31dde32c916
415,bc1qz6lks9udfn78vx3cju9uyc6kqk6739hndak4ct,898,5157178,5157178,2023-04-09 14:39:27,2022-11-25 20:29:08,0,inbound,dce8271ff6ca6bacf4f9fd9ff463f587a0bb9d4c805af60777bec31dde32c916
416,bc1qz6lks9udfn78vx3cju9uyc6kqk6739hndak4ct,899,438359,438359,2022-12-25 01:05:14,2022-12-24 17:44:10,0,inbound,dce8271ff6ca6bacf4f9fd9ff463f587a0bb9d4c805af60777bec31dde32c916
417,bc1qz6lks9udfn78vx3cju9uyc6kqk6739hndak4ct,900,3449395,3449395,2022-12-24 19:19:58,2022-12-24 17:44:10,0,inbound,dce8271ff6ca6bacf4f9fd9ff463f587a0bb9d4c805af60777bec31dde32c916
418,bc1qz6lks9udfn78vx3cju9uyc6kqk6739hndak4ct,901,5410000,5410000,2022-12-25 09:58:46,2022-12-24 17:44:10,0,inbound,dce8271ff6ca6bacf4f9fd9ff463f587a0bb9d4c805af60777bec31dde32c916
419,bc1qz6lks9udfn78vx3cju9uyc6kqk6739hndak4ct,902,588148,588148,2023-01-03 16:12:24,2022-12-24 17:44:10,0,inbound,dce8271ff6ca6bacf4f9fd9ff463f587a0bb9d4c805af60777bec31dde32c916
420,bc1qz6lks9udfn78vx3cju9uyc6kqk6739hndak4ct,903,990488,990488,2023-01-03 16:12:24,2022-12-24 17:44:10,0,inbound,dce8271ff6ca6bacf4f9fd9ff463f587a0bb9d4c805af60777bec31dde32c916
421,bc1qz6lks9udfn78vx3cju9uyc6kqk6739hndak4ct,904,558308396,558308396,2023-02-25 18:58:13,2022-06-02 22:38:58,0,inbound,dce8271ff6ca6bacf4f9fd9ff463f587a0bb9d4c805af60777bec31dde32c916
422,bc1qz6lks9udfn78vx3cju9uyc6kqk6739hndak4ct,905,845560,845560,2022-12-25 02:47:19,2022-12-24 17:44:10,0,inbound,dce8271ff6ca6bacf4f9fd9ff463f587a0bb9d4c805af60777bec31dde32c916
423,bc1qz6lks9udfn78vx3cju9uyc6kqk6739hndak4ct,906,279562,279562,2022-12-25 00:02:59,2022-12-24 17:44:10,0,inbound,dce8271ff6ca6bacf4f9fd9ff463f587a0bb9d4c805af60777bec31dde32c916
424,bc1qz6lks9udfn78vx3cju9uyc6kqk6739hndak4ct,907,1178832,1178832,2022-12-24 19:14:48,2022-12-24 17:44:10,0,inbound,dce8271ff6ca6bacf4f9fd9ff463f587a0bb9d4c805af60777bec31dde32c916
425,bc1qz6lks9udfn78vx3cju9uyc6kqk6739hndak4ct,908,106608,106608,2022-12-25 00:02:53,2022-12-24 17:44:10,0,inbound,dce8271ff6ca6bacf4f9fd9ff463f587a0bb9d4c805af60777bec31dde32c916
426,bc1qz6lks9udfn78vx3cju9uyc6kqk6739hndak4ct,1177,58401339,58401339,2022-12-31 23:16:38,2022-11-17 17:04:16,0,inbound,dce8271ff6ca6bacf4f9fd9ff463f587a0bb9d4c805af60777bec31dde32c916
427,bc1qz6lks9udfn78vx3cju9uyc6kqk6739hndak4ct,1178,11402645,11402645,2023-01-18 20:38:20,2022-12-18 23:55:45,0,inbound,dce8271ff6ca6bacf4f9fd9ff463f587a0bb9d4c805af60777bec31dde32c916
428,bc1qz6lks9udfn78vx3cju9uyc6kqk6739hndak4ct,1179,42141539,41761173,2023-03-30 13:51:18,2023-01-10 06:02:59,380366,outbound,dce8271ff6ca6bacf4f9fd9ff463f587a0bb9d4c805af60777bec31dde32c916
429,bc1qz6lks9udfn78vx3cju9uyc6kqk6739hndak4ct,1180,190647,190647,2022-12-23 05:01:44,2022-12-22 23:44:44,0,inbound,dce8271ff6ca6bacf4f9fd9ff463f587a0bb9d4c805af60777bec31dde32c916
430,bc1qz6lks9udfn78vx3cju9uyc6kqk6739hndak4ct,1181,148959,148959,2022-12-23 02:51:22,2022-12-22 23:44:44,0,inbound,dce8271ff6ca6bacf4f9fd9ff463f587a0bb9d4c805af60777bec31dde32c916
431,bc1qz6lks9udfn78vx3cju9uyc6kqk6739hndak4ct,1182,10181905,9337823,2023-04-10 08:25:37,2023-02-22 10:23:55,844082,inbound,dce8271ff6ca6bacf4f9fd9ff463f587a0bb9d4c805af60777bec31dde32c916
432,bc1qz6lks9udfn78vx3cju9uyc6kqk6739hndak4ct,1183,74401,74401,2023-02-02 20:47:11,2022-12-22 23:44:44,0,inbound,dce8271ff6ca6bacf4f9fd9ff463f587a0bb9d4c805af60777bec31dde32c916
433,bc1qz6lks9udfn78vx3cju9uyc6kqk6739hndak4ct,1184,3370279,3370279,2022-12-30 00:09:41,2022-12-17 08:59:31,0,inbound,dce8271ff6ca6bacf4f9fd9ff463f587a0bb9d4c805af60777bec31dde32c916
434,bc1qz6lks9udfn78vx3cju9uyc6kqk6739hndak4ct,1185,33401,33401,2022-12-23 06:03:49,2022-12-22 23:44:44,0,inbound,dce8271ff6ca6bacf4f9fd9ff463f587a0bb9d4c805af60777bec31dde32c916
435,bc1qz6lks9udfn78vx3cju9uyc6kqk6739hndak4ct,1186,686520,686520,2022-12-23 00:10:42,2022-12-22 23:44:44,0,inbound,dce8271ff6ca6bacf4f9fd9ff463f587a0bb9d4c805af60777bec31dde32c916
436,bc1qz6lks9udfn78vx3cju9uyc6kqk6739hndak4ct,1187,2152532,2152532,2023-01-09 21:15:42,2022-11-14 16:39:08,0,inbound,dce8271ff6ca6bacf4f9fd9ff463f587a0bb9d4c805af60777bec31dde32c916
437,bc1qz6lks9udfn78vx3cju9uyc6kqk6739hndak4ct,1188,306937,306937,2022-12-27 09:30:12,2022-12-22 23:44:44,0,inbound,dce8271ff6ca6bacf4f9fd9ff463f587a0bb9d4c805af60777bec31dde32c916
438,bc1qz6lks9udfn78vx3cju9uyc6kqk6739hndak4ct,1189,1756601392,1755656909,2023-04-10 11:20:52,2023-01-19 01:02:03,944483,inbound,dce8271ff6ca6bacf4f9fd9ff463f587a0bb9d4c805af60777bec31dde32c916
439,bc1qz6lks9udfn78vx3cju9uyc6kqk6739hndak4ct,1190,47177097,45007642,2023-04-10 08:25:58,2023-03-12 20:16:32,2169455,outbound,dce8271ff6ca6bacf4f9fd9ff463f587a0bb9d4c805af60777bec31dde32c916
440,bc1qz6lks9udfn78vx3cju9uyc6kqk6739hndak4ct,1191,64084859,64084859,2023-04-03 23:30:57,2023-01-05 20:35:18,0,outbound,dce8271ff6ca6bacf4f9fd9ff463f587a0bb9d4c805af60777bec31dde32c916
441,bc1qz6lks9udfn78vx3cju9uyc6kqk6739hndak4ct,1192,7456014,7028880,2023-04-10 01:57:31,2022-06-02 14:47:48,427134,inbound,dce8271ff6ca6bacf4f9fd9ff463f587a0bb9d4c805af60777bec31dde32c916
442,bc1qz6lks9udfn78vx3cju9uyc6kqk6739hndak4ct,1193,2701968988,2692158058,2023-04-09 23:28:01,2023-03-13 16:01:58,9810930,outbound,dce8271ff6ca6bacf4f9fd9ff463f587a0bb9d4c805af60777bec31dde32c916
443,bc1qz6lks9udfn78vx3cju9uyc6kqk6739hndak4ct,1194,318764,318764,2022-12-23 12:58:22,2022-12-22 23:44:44,0,inbound,dce8271ff6ca6bacf4f9fd9ff463f587a0bb9d4c805af60777bec31dde32c916
444,bc1qz6lks9udfn78vx3cju9uyc6kqk6739hndak4ct,1195,5827525,5827525,2022-12-23 00:09:57,2022-12-22 23:44:44,0,inbound,dce8271ff6ca6bacf4f9fd9ff463f587a0bb9d4c805af60777bec31dde32c916
445,bc1qz6lks9udfn78vx3cju9uyc6kqk6739hndak4ct,1196,5945000,5945000,2022-12-23 00:30:54,2022-12-22 23:44:44,0,inbound,dce8271ff6ca6bacf4f9fd9ff463f587a0bb9d4c805af60777bec31dde32c916
446,bc1qz6lks9udfn78vx3cju9uyc6kqk6739hndak4ct,1197,588562,588562,2022-12-23 02:59:40,2022-12-22 23:44:44,0,inbound,dce8271ff6ca6bacf4f9fd9ff463f587a0bb9d4c805af60777bec31dde32c916
447,bc1qz6lks9udfn78vx3cju9uyc6kqk6739hndak4ct,1198,1648329959,1648329959,2023-03-16 15:36:10,2023-02-27 22:30:51,0,inbound,dce8271ff6ca6bacf4f9fd9ff463f587a0bb9d4c805af60777bec31dde32c916
448,bc1qz6lks9udfn78vx3cju9uyc6kqk6739hndak4ct,1199,6950587,6950587,2023-03-30 02:15:36,2022-09-29 16:54:20,0,inbound,dce8271ff6ca6bacf4f9fd9ff463f587a0bb9d4c805af60777bec31dde32c916
449,bc1qz6lks9udfn78vx3cju9uyc6kqk6739hndak4ct,1200,689827327,689827327,2023-04-10 05:37:30,2023-01-03 20:43:13,0,outbound,dce8271ff6ca6bacf4f9fd9ff463f587a0bb9d4c805af60777bec31dde32c916
450,bc1qz6lks9udfn78vx3cju9uyc6kqk6739hndak4ct,1201,142873,142873,2022-12-22 14:08:23,2022-12-22 13:42:07,0,inbound,dce8271ff6ca6bacf4f9fd9ff463f587a0bb9d4c805af60777bec31dde32c916
451,bc1qz6lks9udfn78vx3cju9uyc6kqk6739hndak4ct,1202,85019920,85019920,2022-12-22 22:02:09,2022-05-26 16:02:34,0,outbound,dce8271ff6ca6bacf4f9fd9ff463f587a0bb9d4c805af60777bec31dde32c916
452,bc1qz6lks9udfn78vx3cju9uyc6kqk6739hndak4ct,1203,6037636,6027444,2023-02-24 05:10:48,2022-08-11 09:10:05,10192,inbound,dce8271ff6ca6bacf4f9fd9ff463f587a0bb9d4c805af60777bec31dde32c916
453,bc1qz6lks9udfn78vx3cju9uyc6kqk6739hndak4ct,1204,4753277,4753277,2022-12-29 09:26:38,2022-12-22 13:42:07,0,inbound,dce8271ff6ca6bacf4f9fd9ff463f587a0bb9d4c805af60777bec31dde32c916
454,bc1qz6lks9udfn78vx3cju9uyc6kqk6739hndak4ct,1205,740369,740369,2023-01-18 19:07:54,2022-12-22 13:42:07,0,inbound,dce8271ff6ca6bacf4f9fd9ff463f587a0bb9d4c805af60777bec31dde32c916
455,bc1qz6lks9udfn78vx3cju9uyc6kqk6739hndak4ct,1206,47663284,46389424,2023-04-08 22:38:00,2020-07-24 07:08:45,1273860,inbound,dce8271ff6ca6bacf4f9fd9ff463f587a0bb9d4c805af60777bec31dde32c916
456,bc1qz6lks9udfn78vx3cju9uyc6kqk6739hndak4ct,1207,243068098,243068098,2022-12-23 13:59:20,2022-10-29 08:31:09,0,outbound,dce8271ff6ca6bacf4f9fd9ff463f587a0bb9d4c805af60777bec31dde32c916
457,bc1qz6lks9udfn78vx3cju9uyc6kqk6739hndak4ct,1208,4877707,0,2022-12-22 13:42:07,2022-12-22 13:22:06,4877707,inbound,dce8271ff6ca6bacf4f9fd9ff463f587a0bb9d4c805af60777bec31dde32c916
458,bc1qz6lks9udfn78vx3cju9uyc6kqk6739hndak4ct,1209,892497,892497,2022-12-30 02:40:27,2022-12-22 13:42:07,0,inbound,dce8271ff6ca6bacf4f9fd9ff463f587a0bb9d4c805af60777bec31dde32c916
459,bc1qz6lks9udfn78vx3cju9uyc6kqk6739hndak4ct,1210,565265,565265,2023-01-02 15:34:50,2022-12-22 13:42:07,0,inbound,dce8271ff6ca6bacf4f9fd9ff463f587a0bb9d4c805af60777bec31dde32c916
460,bc1qz6lks9udfn78vx3cju9uyc6kqk6739hndak4ct,1664,531000,531000,2022-12-12 14:55:22,2022-12-12 07:56:46,0,inbound,dce8271ff6ca6bacf4f9fd9ff463f587a0bb9d4c805af60777bec31dde32c916
461,bc1qz6lks9udfn78vx3cju9uyc6kqk6739hndak4ct,1665,1070190,1070190,2022-12-27 22:45:02,2022-12-12 07:56:46,0,inbound,dce8271ff6ca6bacf4f9fd9ff463f587a0bb9d4c805af60777bec31dde32c916
462,bc1qz6lks9udfn78vx3cju9uyc6kqk6739hndak4ct,1666,17541180103,15951341724,2023-04-04 13:08:20,2023-01-25 12:25:00,1589838379,inbound,dce8271ff6ca6bacf4f9fd9ff463f587a0bb9d4c805af60777bec31dde32c916
463,bc1qz6lks9udfn78vx3cju9uyc6kqk6739hndak4ct,1667,3304154,0,2022-12-12 07:56:46,2022-01-14 09:51:23,3304154,inbound,dce8271ff6ca6bacf4f9fd9ff463f587a0bb9d4c805af60777bec31dde32c916
464,bc1qz6lks9udfn78vx3cju9uyc6kqk6739hndak4ct,1668,2892840,2892840,2022-12-12 08:56:14,2022-12-12 07:56:46,0,inbound,dce8271ff6ca6bacf4f9fd9ff463f587a0bb9d4c805af60777bec31dde32c916
465,bc1qz6lks9udfn78vx3cju9uyc6kqk6739hndak4ct,1669,56974000,56974000,2023-01-15 13:55:02,2022-12-12 07:56:46,0,inbound,dce8271ff6ca6bacf4f9fd9ff463f587a0bb9d4c805af60777bec31dde32c916
466,bc1qz6lks9udfn78vx3cju9uyc6kqk6739hndak4ct,1670,1770700,1770700,2022-12-12 10:03:59,2022-12-12 07:56:46,0,inbound,dce8271ff6ca6bacf4f9fd9ff463f587a0bb9d4c805af60777bec31dde32c916
467,bc1qz6lks9udfn78vx3cju9uyc6kqk6739hndak4ct,1671,80046815272,80046815272,2023-02-01 19:51:21,2023-01-13 09:02:38,0,inbound,dce8271ff6ca6bacf4f9fd9ff463f587a0bb9d4c805af60777bec31dde32c916
468,bc1qz6lks9udfn78vx3cju9uyc6kqk6739hndak4ct,1672,528039,528039,2022-12-12 10:00:42,2022-12-12 07:56:46,0,inbound,dce8271ff6ca6bacf4f9fd9ff463f587a0bb9d4c805af60777bec31dde32c916
469,bc1qz6lks9udfn78vx3cju9uyc6kqk6739hndak4ct,1673,58229013,58229013,2023-03-18 13:39:54,2022-05-19 13:10:31,0,inbound,dce8271ff6ca6bacf4f9fd9ff463f587a0bb9d4c805af60777bec31dde32c916
470,bc1qz6lks9udfn78vx3cju9uyc6kqk6739hndak4ct,1674,160000,160000,2022-12-12 16:57:32,2022-12-12 07:56:46,0,inbound,dce8271ff6ca6bacf4f9fd9ff463f587a0bb9d4c805af60777bec31dde32c916
471,bc1qz6lks9udfn78vx3cju9uyc6kqk6739hndak4ct,1675,1542320,1542320,2022-12-14 07:12:03,2022-11-25 17:53:13,0,inbound,dce8271ff6ca6bacf4f9fd9ff463f587a0bb9d4c805af60777bec31dde32c916
472,bc1qz6lks9udfn78vx3cju9uyc6kqk6739hndak4ct,1676,1211139676,1211139676,2023-03-31 09:07:42,2022-03-21 12:27:45,0,outbound,dce8271ff6ca6bacf4f9fd9ff463f587a0bb9d4c805af60777bec31dde32c916
473,bc1qz6lks9udfn78vx3cju9uyc6kqk6739hndak4ct,1677,53000000,0,2022-12-18 20:04:50,2022-11-24 11:37:28,53000000,inbound,dce8271ff6ca6bacf4f9fd9ff463f587a0bb9d4c805af60777bec31dde32c916
474,bc1qz6lks9udfn78vx3cju9uyc6kqk6739hndak4ct,1678,12964900,0,2022-12-13 07:38:52,2022-12-12 07:56:46,12964900,inbound,dce8271ff6ca6bacf4f9fd9ff463f587a0bb9d4c805af60777bec31dde32c916
475,bc1qz6lks9udfn78vx3cju9uyc6kqk6739hndak4ct,1679,89253,89253,2022-12-14 08:42:44,2022-12-12 07:56:46,0,inbound,dce8271ff6ca6bacf4f9fd9ff463f587a0bb9d4c805af60777bec31dde32c916
476,bc1qz6lks9udfn78vx3cju9uyc6kqk6739hndak4ct,1680,168785817,168785817,2023-01-24 11:52:44,2022-12-01 07:32:45,0,inbound,dce8271ff6ca6bacf4f9fd9ff463f587a0bb9d4c805af60777bec31dde32c916
477,bc1qz6lks9udfn78vx3cju9uyc6kqk6739hndak4ct,1681,29230806,29230806,2022-12-12 15:38:09,2022-08-29 05:30:41,0,inbound,dce8271ff6ca6bacf4f9fd9ff463f587a0bb9d4c805af60777bec31dde32c916
478,bc1qz6lks9udfn78vx3cju9uyc6kqk6739hndak4ct,1682,14773000,14773000,2022-12-13 11:47:50,2022-12-12 07:56:46,0,inbound,dce8271ff6ca6bacf4f9fd9ff463f587a0bb9d4c805af60777bec31dde32c916
479,bc1qz6lks9udfn78vx3cju9uyc6kqk6739hndak4ct,1683,9286928,9286928,2023-01-13 16:05:47,2022-12-11 18:06:38,0,inbound,dce8271ff6ca6bacf4f9fd9ff463f587a0bb9d4c805af60777bec31dde32c916
480,bc1qz6lks9udfn78vx3cju9uyc6kqk6739hndak4ct,1684,2720685844,2720685844,2022-12-11 14:24:12,2017-07-07 11:56:39,0,inbound,dce8271ff6ca6bacf4f9fd9ff463f587a0bb9d4c805af60777bec31dde32c916
481,bc1qz6lks9udfn78vx3cju9uyc6kqk6739hndak4ct,1685,15005704,12507864,2023-04-06 08:21:08,2021-03-05 02:09:10,2497840,inbound,dce8271ff6ca6bacf4f9fd9ff463f587a0bb9d4c805af60777bec31dde32c916
482,bc1qz6lks9udfn78vx3cju9uyc6kqk6739hndak4ct,1686,500000,500000,2022-12-11 19:03:02,2022-12-11 12:36:49,0,inbound,dce8271ff6ca6bacf4f9fd9ff463f587a0bb9d4c805af60777bec31dde32c916
483,bc1qz6lks9udfn78vx3cju9uyc6kqk6739hndak4ct,1687,3775329,3775329,2022-12-11 14:14:27,2022-12-11 12:36:49,0,inbound,dce8271ff6ca6bacf4f9fd9ff463f587a0bb9d4c805af60777bec31dde32c916
484,bc1qz6lks9udfn78vx3cju9uyc6kqk6739hndak4ct,1688,2059000,0,2022-12-11 12:36:49,2022-12-11 12:36:49,2059000,inbound,dce8271ff6ca6bacf4f9fd9ff463f587a0bb9d4c805af60777bec31dde32c916
485,bc1qz6lks9udfn78vx3cju9uyc6kqk6739hndak4ct,1689,24123000,24123000,2023-01-12 10:19:17,2022-12-11 12:36:49,0,inbound,dce8271ff6ca6bacf4f9fd9ff463f587a0bb9d4c805af60777bec31dde32c916
486,bc1qz6lks9udfn78vx3cju9uyc6kqk6739hndak4ct,1690,12000000,12000000,2022-12-11 13:10:16,2022-12-11 12:36:49,0,inbound,dce8271ff6ca6bacf4f9fd9ff463f587a0bb9d4c805af60777bec31dde32c916
487,bc1qz6lks9udfn78vx3cju9uyc6kqk6739hndak4ct,1691,5463131,5463131,2023-02-15 15:42:17,2022-07-24 12:21:55,0,inbound,dce8271ff6ca6bacf4f9fd9ff463f587a0bb9d4c805af60777bec31dde32c916
488,bc1qz6lks9udfn78vx3cju9uyc6kqk6739hndak4ct,1692,17074283,17074283,2022-12-14 09:27:57,2022-12-11 12:36:49,0,inbound,dce8271ff6ca6bacf4f9fd9ff463f587a0bb9d4c805af60777bec31dde32c916
489,bc1qz6lks9udfn78vx3cju9uyc6kqk6739hndak4ct,1693,12322350780,12322350780,2023-03-28 06:31:52,2021-05-27 05:35:10,0,inbound,dce8271ff6ca6bacf4f9fd9ff463f587a0bb9d4c805af60777bec31dde32c916
490,bc1qz6lks9udfn78vx3cju9uyc6kqk6739hndak4ct,1694,2805258,2805258,2022-12-28 16:52:40,2022-12-11 12:36:49,0,inbound,dce8271ff6ca6bacf4f9fd9ff463f587a0bb9d4c805af60777bec31dde32c916
491,bc1qz6lks9udfn78vx3cju9uyc6kqk6739hndak4ct,1695,130056902,130056902,2023-04-10 09:56:31,2023-01-08 18:30:47,0,outbound,dce8271ff6ca6bacf4f9fd9ff463f587a0bb9d4c805af60777bec31dde32c916
492,bc1qz6lks9udfn78vx3cju9uyc6kqk6739hndak4ct,1696,113322,113322,2022-12-11 13:29:36,2022-12-11 12:36:49,0,inbound,dce8271ff6ca6bacf4f9fd9ff463f587a0bb9d4c805af60777bec31dde32c916
493,bc1qz6lks9udfn78vx3cju9uyc6kqk6739hndak4ct,1697,130321670,123347273,2023-04-10 12:50:38,2023-01-06 13:34:37,6974397,inbound,dce8271ff6ca6bacf4f9fd9ff463f587a0bb9d4c805af60777bec31dde32c916
494,bc1qz6lks9udfn78vx3cju9uyc6kqk6739hndak4ct,47,26465841,26465841,2023-03-31 00:00:54,2023-02-11 18:00:59,0,outbound,4382bb696d0c4d5b2cc151661aec535ee417ca0db7a817683fff8539b29fc457
495,bc1qz6lks9udfn78vx3cju9uyc6kqk6739hndak4ct,48,4108528,0,2023-01-31 15:56:10,2023-01-31 15:56:10,4108528,inbound,4382bb696d0c4d5b2cc151661aec535ee417ca0db7a817683fff8539b29fc457
496,bc1qz6lks9udfn78vx3cju9uyc6kqk6739hndak4ct,49,134072,134072,2023-01-31 17:30:15,2023-01-31 15:56:10,0,inbound,4382bb696d0c4d5b2cc151661aec535ee417ca0db7a817683fff8539b29fc457
497,bc1qz6lks9udfn78vx3cju9uyc6kqk6739hndak4ct,50,498898,498898,2023-01-31 22:17:35,2023-01-31 15:56:10,0,inbound,4382bb696d0c4d5b2cc151661aec535ee417ca0db7a817683fff8539b29fc457
498,bc1qz6lks9udfn78vx3cju9uyc6kqk6739hndak4ct,51,16433,16433,2023-02-04 14:31:54,2023-01-31 15:56:10,0,inbound,4382bb696d0c4d5b2cc151661aec535ee417ca0db7a817683fff8539b29fc457
499,bc1qz6lks9udfn78vx3cju9uyc6kqk6739hndak4ct,52,212545192,212545192,2023-04-08 19:03:15,2022-12-26 02:37:14,0,outbound,4382bb696d0c4d5b2cc151661aec535ee417ca0db7a817683fff8539b29fc457
500,bc1qz6lks9udfn78vx3cju9uyc6kqk6739hndak4ct,53,2714925139,2702736961,2023-04-09 07:37:54,2023-03-14 07:46:57,12188178,inbound,4382bb696d0c4d5b2cc151661aec535ee417ca0db7a817683fff8539b29fc457
501,bc1qz6lks9udfn78vx3cju9uyc6kqk6739hndak4ct,54,86487,0,2023-01-31 15:56:10,2023-01-31 15:56:10,86487,inbound,4382bb696d0c4d5b2cc151661aec535ee417ca0db7a817683fff8539b29fc457
502,bc1qz6lks9udfn78vx3cju9uyc6kqk6739hndak4ct,55,1297302,0,2023-01-31 15:56:10,2023-01-31 15:56:10,1297302,inbound,4382bb696d0c4d5b2cc151661aec535ee417ca0db7a817683fff8539b29fc457
503,bc1qz6lks9udfn78vx3cju9uyc6kqk6739hndak4ct,56,605487,605487,2023-02-06 15:30:38,2023-01-31 15:56:10,0,inbound,4382bb696d0c4d5b2cc151661aec535ee417ca0db7a817683fff8539b29fc457
504,bc1qz6lks9udfn78vx3cju9uyc6kqk6739hndak4ct,57,2873751,2873751,2023-01-31 16:15:18,2023-01-31 15:56:10,0,inbound,4382bb696d0c4d5b2cc151661aec535ee417ca0db7a817683fff8539b29fc457
505,bc1qz6lks9udfn78vx3cju9uyc6kqk6739hndak4ct,58,10766,10766,2023-01-31 16:38:24,2023-01-31 15:56:10,0,inbound,4382bb696d0c4d5b2cc151661aec535ee417ca0db7a817683fff8539b29fc457
506,bc1qz6lks9udfn78vx3cju9uyc6kqk6739hndak4ct,59,159602124,157732070,2023-04-09 13:59:39,2023-03-30 19:58:16,1870054,inbound,4382bb696d0c4d5b2cc151661aec535ee417ca0db7a817683fff8539b29fc457
507,bc1qz6lks9udfn78vx3cju9uyc6kqk6739hndak4ct,60,128909,128909,2023-01-31 18:02:30,2023-01-31 15:56:10,0,inbound,4382bb696d0c4d5b2cc151661aec535ee417ca0db7a817683fff8539b29fc457
508,bc1qz6lks9udfn78vx3cju9uyc6kqk6739hndak4ct,61,8390994,8390994,2023-02-28 00:07:19,2023-01-03 22:59:06,0,inbound,4382bb696d0c4d5b2cc151661aec535ee417ca0db7a817683fff8539b29fc457
509,bc1qz6lks9udfn78vx3cju9uyc6kqk6739hndak4ct,62,203444,0,2023-01-31 15:56:10,2023-01-31 15:56:10,203444,inbound,4382bb696d0c4d5b2cc151661aec535ee417ca0db7a817683fff8539b29fc457
510,bc1qz6lks9udfn78vx3cju9uyc6kqk6739hndak4ct,63,127228,127228,2023-01-31 16:38:24,2023-01-31 15:56:10,0,inbound,4382bb696d0c4d5b2cc151661aec535ee417ca0db7a817683fff8539b29fc457
511,bc1qz6lks9udfn78vx3cju9uyc6kqk6739hndak4ct,64,532498,532498,2023-01-31 18:02:24,2023-01-31 15:56:10,0,inbound,4382bb696d0c4d5b2cc151661aec535ee417ca0db7a817683fff8539b29fc457
512,bc1qz6lks9udfn78vx3cju9uyc6kqk6739hndak4ct,65,2472122,2472122,2023-02-03 16:57:20,2023-01-31 15:56:10,0,inbound,4382bb696d0c4d5b2cc151661aec535ee417ca0db7a817683fff8539b29fc457
513,bc1qz6lks9udfn78vx3cju9uyc6kqk6739hndak4ct,66,22322105,22311619,2023-03-21 16:12:37,2022-11-27 15:56:07,10486,inbound,4382bb696d0c4d5b2cc151661aec535ee417ca0db7a817683fff8539b29fc457
514,bc1qz6lks9udfn78vx3cju9uyc6kqk6739hndak4ct,67,726059,726059,2023-02-01 08:01:15,2023-01-31 15:56:10,0,inbound,4382bb696d0c4d5b2cc151661aec535ee417ca0db7a817683fff8539b29fc457
515,bc1qz6lks9udfn78vx3cju9uyc6kqk6739hndak4ct,68,1041033,1041033,2023-02-07 02:24:36,2023-01-31 15:56:10,0,inbound,4382bb696d0c4d5b2cc151661aec535ee417ca0db7a817683fff8539b29fc457
516,bc1qz6lks9udfn78vx3cju9uyc6kqk6739hndak4ct,69,1288800,1253614,2023-02-23 01:31:00,2023-01-31 15:56:09,35186,inbound,4382bb696d0c4d5b2cc151661aec535ee417ca0db7a817683fff8539b29fc457
517,bc1qz6lks9udfn78vx3cju9uyc6kqk6739hndak4ct,70,30581803,30581803,2023-03-13 19:40:04,2021-05-08 22:47:07,0,inbound,4382bb696d0c4d5b2cc151661aec535ee417ca0db7a817683fff8539b29fc457
518,bc1qz6lks9udfn78vx3cju9uyc6kqk6739hndak4ct,71,478701086,478701086,2023-04-06 23:23:23,2023-01-22 12:22:38,0,inbound,4382bb696d0c4d5b2cc151661aec535ee417ca0db7a817683fff8539b29fc457
519,bc1qz6lks9udfn78vx3cju9uyc6kqk6739hndak4ct,72,406394,406394,2023-02-06 11:09:46,2023-01-31 15:56:10,0,inbound,4382bb696d0c4d5b2cc151661aec535ee417ca0db7a817683fff8539b29fc457
520,bc1qz6lks9udfn78vx3cju9uyc6kqk6739hndak4ct,73,4384186,4384186,2023-02-08 02:00:02,2023-01-31 15:56:10,0,inbound,4382bb696d0c4d5b2cc151661aec535ee417ca0db7a817683fff8539b29fc457
521,bc1qz6lks9udfn78vx3cju9uyc6kqk6739hndak4ct,74,8756806,8756806,2023-01-31 16:14:32,2023-01-31 15:56:09,0,inbound,4382bb696d0c4d5b2cc151661aec535ee417ca0db7a817683fff8539b29fc457
522,bc1qz6lks9udfn78vx3cju9uyc6kqk6739hndak4ct,75,577073,577073,2023-02-01 23:24:26,2023-01-31 15:56:10,0,inbound,4382bb696d0c4d5b2cc151661aec535ee417ca0db7a817683fff8539b29fc457
523,bc1qz6lks9udfn78vx3cju9uyc6kqk6739hndak4ct,76,70993606,70993606,2023-04-07 06:09:01,2022-12-23 04:19:07,0,inbound,4382bb696d0c4d5b2cc151661aec535ee417ca0db7a817683fff8539b29fc457
524,bc1qz6lks9udfn78vx3cju9uyc6kqk6739hndak4ct,77,259461,259461,2023-02-02 18:00:40,2023-01-31 15:56:09,0,inbound,4382bb696d0c4d5b2cc151661aec535ee417ca0db7a817683fff8539b29fc457
525,bc1qz6lks9udfn78vx3cju9uyc6kqk6739hndak4ct,78,108109,108109,2023-02-02 23:30:25,2023-01-31 15:56:10,0,inbound,4382bb696d0c4d5b2cc151661aec535ee417ca0db7a817683fff8539b29fc457
526,bc1qz6lks9udfn78vx3cju9uyc6kqk6739hndak4ct,79,43225,43225,2023-02-10 01:05:15,2023-01-31 15:56:10,0,inbound,4382bb696d0c4d5b2cc151661aec535ee417ca0db7a817683fff8539b29fc457
527,bc1qz6lks9udfn78vx3cju9uyc6kqk6739hndak4ct,80,440785,440785,2023-02-08 12:02:21,2023-01-31 15:56:10,0,inbound,4382bb696d0c4d5b2cc151661aec535ee417ca0db7a817683fff8539b29fc457
528,bc1qz6lks9udfn78vx3cju9uyc6kqk6739hndak4ct,81,349400,349400,2023-02-02 12:02:06,2023-01-31 15:56:10,0,inbound,4382bb696d0c4d5b2cc151661aec535ee417ca0db7a817683fff8539b29fc457
529,bc1qz6lks9udfn78vx3cju9uyc6kqk6739hndak4ct,82,33138086,33121221,2023-03-29 09:50:11,2022-12-14 18:11:11,16865,inbound,4382bb696d0c4d5b2cc151661aec535ee417ca0db7a817683fff8539b29fc457
530,bc1qz6lks9udfn78vx3cju9uyc6kqk6739hndak4ct,83,1542200,1542200,2023-01-31 16:01:35,2022-07-28 00:38:58,0,inbound,4382bb696d0c4d5b2cc151661aec535ee417ca0db7a817683fff8539b29fc457
531,bc1qz6lks9udfn78vx3cju9uyc6kqk6739hndak4ct,84,16165584,16146268,2023-04-05 01:25:44,2023-02-03 15:20:09,19316,inbound,4382bb696d0c4d5b2cc151661aec535ee417ca0db7a817683fff8539b29fc457
532,bc1qz6lks9udfn78vx3cju9uyc6kqk6739hndak4ct,85,44298844,44298844,2023-01-28 21:16:38,2023-01-28 20:49:33,0,inbound,4382bb696d0c4d5b2cc151661aec535ee417ca0db7a817683fff8539b29fc457
533,bc1qz6lks9udfn78vx3cju9uyc6kqk6739hndak4ct,196,143636,143636,2023-01-05 00:25:13,2023-01-04 19:34:37,0,inbound,4382bb696d0c4d5b2cc151661aec535ee417ca0db7a817683fff8539b29fc457
534,bc1qz6lks9udfn78vx3cju9uyc6kqk6739hndak4ct,197,8204018,8024497,2023-03-20 23:45:11,2022-09-05 19:30:44,179521,outbound,4382bb696d0c4d5b2cc151661aec535ee417ca0db7a817683fff8539b29fc457
535,bc1qz6lks9udfn78vx3cju9uyc6kqk6739hndak4ct,198,147852914,147852914,2023-02-08 09:23:40,2023-01-04 19:34:37,0,inbound,4382bb696d0c4d5b2cc151661aec535ee417ca0db7a817683fff8539b29fc457
536,bc1qz6lks9udfn78vx3cju9uyc6kqk6739hndak4ct,199,104174492,104174492,2023-01-22 00:52:24,2022-12-31 14:54:18,0,inbound,4382bb696d0c4d5b2cc151661aec535ee417ca0db7a817683fff8539b29fc457
537,bc1qz6lks9udfn78vx3cju9uyc6kqk6739hndak4ct,200,15032,15032,2023-01-04 16:47:57,2023-01-03 20:29:03,0,inbound,4382bb696d0c4d5b2cc151661aec535ee417ca0db7a817683fff8539b29fc457
538,bc1qz6lks9udfn78vx3cju9uyc6kqk6739hndak4ct,201,105001,105001,2023-01-06 13:00:54,2023-01-03 20:29:03,0,inbound,4382bb696d0c4d5b2cc151661aec535ee417ca0db7a817683fff8539b29fc457
539,bc1qz6lks9udfn78vx3cju9uyc6kqk6739hndak4ct,202,506545,356372,2023-01-03 20:29:03,2022-12-16 16:59:00,150173,inbound,4382bb696d0c4d5b2cc151661aec535ee417ca0db7a817683fff8539b29fc457
540,bc1qz6lks9udfn78vx3cju9uyc6kqk6739hndak4ct,203,6658471,6658471,2023-02-28 22:24:43,2022-10-25 20:01:34,0,inbound,4382bb696d0c4d5b2cc151661aec535ee417ca0db7a817683fff8539b29fc457
541,bc1qz6lks9udfn78vx3cju9uyc6kqk6739hndak4ct,204,1465105,1465105,2023-01-04 15:12:10,2023-01-03 20:29:03,0,inbound,4382bb696d0c4d5b2cc151661aec535ee417ca0db7a817683fff8539b29fc457
542,bc1qz6lks9udfn78vx3cju9uyc6kqk6739hndak4ct,205,281351772,281351772,2023-02-12 05:39:13,2023-01-27 05:00:31,0,outbound,4382bb696d0c4d5b2cc151661aec535ee417ca0db7a817683fff8539b29fc457
543,bc1qz6lks9udfn78vx3cju9uyc6kqk6739hndak4ct,206,3871802,3871802,2023-01-22 15:57:23,2023-01-03 20:29:03,0,inbound,4382bb696d0c4d5b2cc151661aec535ee417ca0db7a817683fff8539b29fc457
544,bc1qz6lks9udfn78vx3cju9uyc6kqk6739hndak4ct,207,88279184,88279184,2023-01-27 20:37:11,2022-11-14 17:20:31,0,inbound,4382bb696d0c4d5b2cc151661aec535ee417ca0db7a817683fff8539b29fc457
545,bc1qz6lks9udfn78vx3cju9uyc6kqk6739hndak4ct,208,13152942,13152942,2023-01-03 23:57:13,2023-01-03 20:29:03,0,inbound,4382bb696d0c4d5b2cc151661aec535ee417ca0db7a817683fff8539b29fc457
546,bc1qz6lks9udfn78vx3cju9uyc6kqk6739hndak4ct,209,14572745,14572745,2023-01-04 02:09:22,2023-01-03 20:29:03,0,inbound,4382bb696d0c4d5b2cc151661aec535ee417ca0db7a817683fff8539b29fc457
547,bc1qz6lks9udfn78vx3cju9uyc6kqk6739hndak4ct,210,142033564,142033564,2023-03-22 16:33:36,2022-11-14 12:07:26,0,inbound,4382bb696d0c4d5b2cc151661aec535ee417ca0db7a817683fff8539b29fc457
548,bc1qz6lks9udfn78vx3cju9uyc6kqk6739hndak4ct,211,666596,666596,2023-01-10 12:13:12,2023-01-03 15:06:08,0,inbound,4382bb696d0c4d5b2cc151661aec535ee417ca0db7a817683fff8539b29fc457
549,bc1qz6lks9udfn78vx3cju9uyc6kqk6739hndak4ct,212,143862,143862,2023-01-03 17:02:44,2023-01-03 16:39:11,0,inbound,4382bb696d0c4d5b2cc151661aec535ee417ca0db7a817683fff8539b29fc457
550,bc1qz6lks9udfn78vx3cju9uyc6kqk6739hndak4ct,213,36065,36065,2023-01-04 00:56:29,2023-01-03 16:39:11,0,inbound,4382bb696d0c4d5b2cc151661aec535ee417ca0db7a817683fff8539b29fc457
551,bc1qz6lks9udfn78vx3cju9uyc6kqk6739hndak4ct,214,14873473,14873473,2023-02-27 19:00:30,2021-10-23 17:34:08,0,inbound,4382bb696d0c4d5b2cc151661aec535ee417ca0db7a817683fff8539b29fc457
552,bc1qz6lks9udfn78vx3cju9uyc6kqk6739hndak4ct,215,35753022,35753022,2023-04-03 12:36:07,2022-12-29 13:16:31,0,inbound,4382bb696d0c4d5b2cc151661aec535ee417ca0db7a817683fff8539b29fc457
553,bc1qz6lks9udfn78vx3cju9uyc6kqk6739hndak4ct,216,195692,195692,2023-01-03 18:03:49,2023-01-03 16:39:11,0,inbound,4382bb696d0c4d5b2cc151661aec535ee417ca0db7a817683fff8539b29fc457
554,bc1qz6lks9udfn78vx3cju9uyc6kqk6739hndak4ct,217,73743,73743,2023-01-09 05:12:17,2023-01-03 16:39:09,0,inbound,4382bb696d0c4d5b2cc151661aec535ee417ca0db7a817683fff8539b29fc457
555,bc1qz6lks9udfn78vx3cju9uyc6kqk6739hndak4ct,218,29089,29089,2023-01-03 20:44:06,2023-01-03 16:39:09,0,inbound,4382bb696d0c4d5b2cc151661aec535ee417ca0db7a817683fff8539b29fc457
556,bc1qz6lks9udfn78vx3cju9uyc6kqk6739hndak4ct,219,8121529,3143623,2023-03-25 19:48:08,2022-11-17 13:12:10,4977906,inbound,4382bb696d0c4d5b2cc151661aec535ee417ca0db7a817683fff8539b29fc457
557,bc1qz6lks9udfn78vx3cju9uyc6kqk6739hndak4ct,220,61379934,61310868,2023-04-09 14:48:19,2023-01-30 18:48:55,69066,outbound,4382bb696d0c4d5b2cc151661aec535ee417ca0db7a817683fff8539b29fc457
558,bc1qz6lks9udfn78vx3cju9uyc6kqk6739hndak4ct,221,857468,857468,2023-01-03 17:17:14,2023-01-03 16:39:09,0,inbound,4382bb696d0c4d5b2cc151661aec535ee417ca0db7a817683fff8539b29fc457
559,bc1qz6lks9udfn78vx3cju9uyc6kqk6739hndak4ct,222,54063,54063,2023-01-06 12:04:55,2023-01-03 16:39:09,0,inbound,4382bb696d0c4d5b2cc151661aec535ee417ca0db7a817683fff8539b29fc457
560,bc1qz6lks9udfn78vx3cju9uyc6kqk6739hndak4ct,351,8329000,8329000,2022-12-30 16:25:57,2022-12-30 15:38:49,0,inbound,4382bb696d0c4d5b2cc151661aec535ee417ca0db7a817683fff8539b29fc457
561,bc1qz6lks9udfn78vx3cju9uyc6kqk6739hndak4ct,352,36479800,36479800,2023-03-27 06:37:04,2019-12-26 17:22:33,0,outbound,4382bb696d0c4d5b2cc151661aec535ee417ca0db7a817683fff8539b29fc457
562,bc1qz6lks9udfn78vx3cju9uyc6kqk6739hndak4ct,353,1847838,1847838,2022-12-31 18:27:56,2022-12-27 13:16:49,0,inbound,4382bb696d0c4d5b2cc151661aec535ee417ca0db7a817683fff8539b29fc457
563,bc1qz6lks9udfn78vx3cju9uyc6kqk6739hndak4ct,354,90063743,90063743,2023-01-04 10:26:23,2022-12-30 15:38:49,0,inbound,4382bb696d0c4d5b2cc151661aec535ee417ca0db7a817683fff8539b29fc457
564,bc1qz6lks9udfn78vx3cju9uyc6kqk6739hndak4ct,355,3458774,3458774,2022-12-30 17:20:16,2022-12-30 15:38:49,0,inbound,4382bb696d0c4d5b2cc151661aec535ee417ca0db7a817683fff8539b29fc457
565,bc1qz6lks9udfn78vx3cju9uyc6kqk6739hndak4ct,356,11389465,11389465,2022-12-30 17:56:56,2021-04-15 06:15:31,0,inbound,4382bb696d0c4d5b2cc151661aec535ee417ca0db7a817683fff8539b29fc457
566,bc1qz6lks9udfn78vx3cju9uyc6kqk6739hndak4ct,357,14941000,14941000,2022-12-30 16:04:27,2022-12-30 15:38:49,0,inbound,4382bb696d0c4d5b2cc151661aec535ee417ca0db7a817683fff8539b29fc457
567,bc1qz6lks9udfn78vx3cju9uyc6kqk6739hndak4ct,358,893280,893280,2023-01-15 17:38:33,2022-04-02 10:08:08,0,inbound,4382bb696d0c4d5b2cc151661aec535ee417ca0db7a817683fff8539b29fc457
568,bc1qz6lks9udfn78vx3cju9uyc6kqk6739hndak4ct,359,232045,232045,2023-01-01 06:45:07,2022-12-30 15:38:49,0,inbound,4382bb696d0c4d5b2cc151661aec535ee417ca0db7a817683fff8539b29fc457
569,bc1qz6lks9udfn78vx3cju9uyc6kqk6739hndak4ct,360,1000000,0,2022-12-30 15:38:49,2022-12-30 15:38:49,1000000,inbound,4382bb696d0c4d5b2cc151661aec535ee417ca0db7a817683fff8539b29fc457
570,bc1qz6lks9udfn78vx3cju9uyc6kqk6739hndak4ct,361,1432991,1432991,2023-01-13 04:33:10,2022-12-30 00:42:45,0,inbound,4382bb696d0c4d5b2cc151661aec535ee417ca0db7a817683fff8539b29fc457
571,bc1qz6lks9udfn78vx3cju9uyc6kqk6739hndak4ct,362,66598600,66598600,2023-01-01 10:36:17,2022-12-30 15:38:49,0,inbound,4382bb696d0c4d5b2cc151661aec535ee417ca0db7a817683fff8539b29fc457
572,bc1qz6lks9udfn78vx3cju9uyc6kqk6739hndak4ct,363,49122478,49122478,2023-04-03 01:51:57,2022-11-16 06:04:51,0,inbound,4382bb696d0c4d5b2cc151661aec535ee417ca0db7a817683fff8539b29fc457
573,bc1qz6lks9udfn78vx3cju9uyc6kqk6739hndak4ct,364,873337,0,2022-12-30 15:38:49,2022-12-30 15:38:49,873337,inbound,4382bb696d0c4d5b2cc151661aec535ee417ca0db7a817683fff8539b29fc457
574,bc1qz6lks9udfn78vx3cju9uyc6kqk6739hndak4ct,365,174835,174835,2022-12-30 21:31:07,2022-12-30 15:38:49,0,inbound,4382bb696d0c4d5b2cc151661aec535ee417ca0db7a817683fff8539b29fc457
575,bc1qz6lks9udfn78vx3cju9uyc6kqk6739hndak4ct,366,21612721,0,2022-12-30 15:38:49,2021-01-26 07:09:43,21612721,inbound,4382bb696d0c4d5b2cc151661aec535ee417ca0db7a817683fff8539b29fc457
576,bc1qz6lks9udfn78vx3cju9uyc6kqk6739hndak4ct,367,747998,0,2022-12-30 15:38:49,2022-12-30 15:38:49,747998,inbound,4382bb696d0c4d5b2cc151661aec535ee417ca0db7a817683fff8539b29fc457
577,bc1qz6lks9udfn78vx3cju9uyc6kqk6739hndak4ct,368,625405,0,2022-12-30 15:38:49,2022-12-30 15:38:49,625405,inbound,4382bb696d0c4d5b2cc151661aec535ee417ca0db7a817683fff8539b29fc457
578,bc1qz6lks9udfn78vx3cju9uyc6kqk6739hndak4ct,369,226136096,226136096,2023-03-04 13:32:27,2022-01-19 21:19:11,0,inbound,4382bb696d0c4d5b2cc151661aec535ee417ca0db7a817683fff8539b29fc457
579,bc1qz6lks9udfn78vx3cju9uyc6kqk6739hndak4ct,370,22709394,22709394,2022-12-31 05:43:03,2022-12-30 15:38:49,0,inbound,4382bb696d0c4d5b2cc151661aec535ee417ca0db7a817683fff8539b29fc457
580,bc1qz6lks9udfn78vx3cju9uyc6kqk6739hndak4ct,371,23459993,23459993,2023-03-16 19:35:26,2022-09-15 16:04:43,0,inbound,4382bb696d0c4d5b2cc151661aec535ee417ca0db7a817683fff8539b29fc457
581,bc1qz6lks9udfn78vx3cju9uyc6kqk6739hndak4ct,372,119491819,117720309,2023-04-04 11:32:38,2021-04-02 05:17:54,1771510,inbound,4382bb696d0c4d5b2cc151661aec535ee417ca0db7a817683fff8539b29fc457
582,bc1qz6lks9udfn78vx3cju9uyc6kqk6739hndak4ct,373,1997832,1997832,2023-01-04 20:03:14,2022-12-30 07:29:13,0,inbound,4382bb696d0c4d5b2cc151661aec535ee417ca0db7a817683fff8539b29fc457
583,bc1qz6lks9udfn78vx3cju9uyc6kqk6739hndak4ct,374,2375776115,2375776115,2023-02-25 07:01:34,2022-11-22 08:16:33,0,inbound,4382bb696d0c4d5b2cc151661aec535ee417ca0db7a817683fff8539b29fc457
584,bc1qz6lks9udfn78vx3cju9uyc6kqk6739hndak4ct,375,1967332585,1967332585,2023-01-01 07:08:00,2020-10-14 17:40:48,0,inbound,4382bb696d0c4d5b2cc151661aec535ee417ca0db7a817683fff8539b29fc457
585,bc1qz6lks9udfn78vx3cju9uyc6kqk6739hndak4ct,376,13190123051007377,13189896362625015,2023-04-10 03:26:17,2023-04-08 23:54:50,226688382362,outbound,4382bb696d0c4d5b2cc151661aec535ee417ca0db7a817683fff8539b29fc457
586,bc1qz6lks9udfn78vx3cju9uyc6kqk6739hndak4ct,377,1453058,1453058,2023-02-08 20:16:03,2022-12-30 01:36:46,0,inbound,4382bb696d0c4d5b2cc151661aec535ee417ca0db7a817683fff8539b29fc457
587,bc1qz6lks9udfn78vx3cju9uyc6kqk6739hndak4ct,378,3641815711,3641815711,2023-02-10 15:21:38,2023-01-25 01:30:29,0,outbound,4382bb696d0c4d5b2cc151661aec535ee417ca0db7a817683fff8539b29fc457
588,bc1qz6lks9udfn78vx3cju9uyc6kqk6739hndak4ct,379,80000,80000,2022-12-31 07:20:13,2022-12-30 01:36:46,0,inbound,4382bb696d0c4d5b2cc151661aec535ee417ca0db7a817683fff8539b29fc457
589,bc1qz6lks9udfn78vx3cju9uyc6kqk6739hndak4ct,380,88957946,88957946,2023-03-01 07:12:50,2022-12-26 06:42:54,0,inbound,4382bb696d0c4d5b2cc151661aec535ee417ca0db7a817683fff8539b29fc457
590,bc1qz6lks9udfn78vx3cju9uyc6kqk6739hndak4ct,381,130205869,130205869,2023-03-11 00:00:50,2023-01-11 16:39:17,0,outbound,4382bb696d0c4d5b2cc151661aec535ee417ca0db7a817683fff8539b29fc457
591,bc1qz6lks9udfn78vx3cju9uyc6kqk6739hndak4ct,382,80000,0,2022-12-30 01:36:46,2022-12-30 01:36:46,80000,inbound,4382bb696d0c4d5b2cc151661aec535ee417ca0db7a817683fff8539b29fc457
592,bc1qz6lks9udfn78vx3cju9uyc6kqk6739hndak4ct,383,2387000,0,2022-12-30 01:36:46,2022-12-30 01:36:46,2387000,inbound,4382bb696d0c4d5b2cc151661aec535ee417ca0db7a817683fff8539b29fc457
593,bc1qz6lks9udfn78vx3cju9uyc6kqk6739hndak4ct,384,1192681,1192681,2023-01-07 03:22:34,2022-12-26 06:06:45,0,inbound,4382bb696d0c4d5b2cc151661aec535ee417ca0db7a817683fff8539b29fc457
594,bc1qz6lks9udfn78vx3cju9uyc6kqk6739hndak4ct,385,10873473459,10873473459,2023-03-12 01:31:05,2022-12-31 08:42:11,0,inbound,4382bb696d0c4d5b2cc151661aec535ee417ca0db7a817683fff8539b29fc457
595,bc1qz6lks9udfn78vx3cju9uyc6kqk6739hndak4ct,386,255915000,0,2022-12-30 01:36:46,2022-12-28 01:02:45,255915000,inbound,4382bb696d0c4d5b2cc151661aec535ee417ca0db7a817683fff8539b29fc457
596,bc1qz6lks9udfn78vx3cju9uyc6kqk6739hndak4ct,387,809313000,809313000,2023-03-01 15:39:54,2022-12-18 05:22:46,0,inbound,4382bb696d0c4d5b2cc151661aec535ee417ca0db7a817683fff8539b29fc457
597,bc1qz6lks9udfn78vx3cju9uyc6kqk6739hndak4ct,388,5856148,5856148,2022-12-30 01:44:33,2022-12-30 01:36:46,0,inbound,4382bb696d0c4d5b2cc151661aec535ee417ca0db7a817683fff8539b29fc457
598,bc1qz6lks9udfn78vx3cju9uyc6kqk6739hndak4ct,389,5616679,5616679,2023-02-16 10:50:56,2022-11-14 11:24:50,0,inbound,4382bb696d0c4d5b2cc151661aec535ee417ca0db7a817683fff8539b29fc457
599,bc1qz6lks9udfn78vx3cju9uyc6kqk6739hndak4ct,514,275441132,274996888,2023-04-09 12:49:29,2023-01-08 04:42:25,444244,outbound,4382bb696d0c4d5b2cc151661aec535ee417ca0db7a817683fff8539b29fc457
600,bc1qz6lks9udfn78vx3cju9uyc6kqk6739hndak4ct,515,45721,45721,2022-12-29 00:02:13,2022-12-28 21:55:38,0,inbound,4382bb696d0c4d5b2cc151661aec535ee417ca0db7a817683fff8539b29fc457
601,bc1qz6lks9udfn78vx3cju9uyc6kqk6739hndak4ct,516,302910,302910,2022-12-29 00:03:43,2022-12-28 21:55:38,0,inbound,4382bb696d0c4d5b2cc151661aec535ee417ca0db7a817683fff8539b29fc457
602,bc1qz6lks9udfn78vx3cju9uyc6kqk6739hndak4ct,517,33476795982,33473968237,2023-04-10 13:13:42,2023-04-08 11:19:33,2827745,inbound,4382bb696d0c4d5b2cc151661aec535ee417ca0db7a817683fff8539b29fc457
603,bc1qz6lks9udfn78vx3cju9uyc6kqk6739hndak4ct,518,187544767,187537661,2023-04-09 17:49:57,2023-03-08 18:01:58,7106,outbound,4382bb696d0c4d5b2cc151661aec535ee417ca0db7a817683fff8539b29fc457
604,bc1qz6lks9udfn78vx3cju9uyc6kqk6739hndak4ct,519,34537988,29718570,2023-04-10 10:10:40,2022-11-11 10:00:40,4819418,outbound,4382bb696d0c4d5b2cc151661aec535ee417ca0db7a817683fff8539b29fc457
605,bc1qz6lks9udfn78vx3cju9uyc6kqk6739hndak4ct,520,183571060,183571060,2023-03-28 19:02:08,2022-12-27 16:11:29,0,inbound,4382bb696d0c4d5b2cc151661aec535ee417ca0db7a817683fff8539b29fc457
606,bc1qz6lks9udfn78vx3cju9uyc6kqk6739hndak4ct,521,140480,140480,2023-01-11 18:26:26,2022-12-28 21:55:38,0,inbound,4382bb696d0c4d5b2cc151661aec535ee417ca0db7a817683fff8539b29fc457
607,bc1qz6lks9udfn78vx3cju9uyc6kqk6739hndak4ct,522,203940663,203662272,2023-02-11 06:40:45,2022-12-17 18:55:50,278391,inbound,4382bb696d0c4d5b2cc151661aec535ee417ca0db7a817683fff8539b29fc457
608,bc1qz6lks9udfn78vx3cju9uyc6kqk6739hndak4ct,523,104916,104916,2023-01-04 01:41:10,2022-12-28 21:55:38,0,inbound,4382bb696d0c4d5b2cc151661aec535ee417ca0db7a817683fff8539b29fc457
609,bc1qz6lks9udfn78vx3cju9uyc6kqk6739hndak4ct,524,61690609,61690609,2022-12-30 23:30:16,2022-12-11 15:46:01,0,inbound,4382bb696d0c4d5b2cc151661aec535ee417ca0db7a817683fff8539b29fc457
610,bc1qz6lks9udfn78vx3cju9uyc6kqk6739hndak4ct,525,12978238,12978238,2023-03-10 01:34:24,2021-05-09 03:14:43,0,inbound,4382bb696d0c4d5b2cc151661aec535ee417ca0db7a817683fff8539b29fc457
611,bc1qz6lks9udfn78vx3cju9uyc6kqk6739hndak4ct,526,64329181,64329181,2023-03-02 18:38:10,2022-12-23 14:11:47,0,inbound,4382bb696d0c4d5b2cc151661aec535ee417ca0db7a817683fff8539b29fc457
612,bc1qz6lks9udfn78vx3cju9uyc6kqk6739hndak4ct,527,79793667,78602375,2023-04-05 17:46:23,2023-03-02 11:25:10,1191292,inbound,4382bb696d0c4d5b2cc151661aec535ee417ca0db7a817683fff8539b29fc457
613,bc1qz6lks9udfn78vx3cju9uyc6kqk6739hndak4ct,528,427104,427104,2023-01-07 23:49:00,2022-12-28 21:55:38,0,inbound,4382bb696d0c4d5b2cc151661aec535ee417ca0db7a817683fff8539b29fc457
614,bc1qz6lks9udfn78vx3cju9uyc6kqk6739hndak4ct,529,1309327924,1309327924,2023-04-09 22:07:55,2023-03-29 22:18:16,0,outbound,4382bb696d0c4d5b2cc151661aec535ee417ca0db7a817683fff8539b29fc457
615,bc1qz6lks9udfn78vx3cju9uyc6kqk6739hndak4ct,530,92950867,90134193,2023-04-02 23:33:21,2022-02-16 23:20:38,2816674,outbound,4382bb696d0c4d5b2cc151661aec535ee417ca0db7a817683fff8539b29fc457
616,bc1qz6lks9udfn78vx3cju9uyc6kqk6739hndak4ct,531,113021615,113021615,2023-02-24 09:21:24,2022-12-21 02:18:27,0,outbound,4382bb696d0c4d5b2cc151661aec535ee417ca0db7a817683fff8539b29fc457
617,bc1qz6lks9udfn78vx3cju9uyc6kqk6739hndak4ct,532,936093,936093,2022-12-28 22:02:14,2022-12-28 21:55:38,0,inbound,4382bb696d0c4d5b2cc151661aec535ee417ca0db7a817683fff8539b29fc457
618,bc1qz6lks9udfn78vx3cju9uyc6kqk6739hndak4ct,533,187740108,185364054,2023-04-10 08:26:26,2023-04-02 02:53:09,2376054,inbound,4382bb696d0c4d5b2cc151661aec535ee417ca0db7a817683fff8539b29fc457
619,bc1qz6lks9udfn78vx3cju9uyc6kqk6739hndak4ct,534,227017753,227017753,2022-12-29 01:54:43,2022-12-28 21:55:38,0,inbound,4382bb696d0c4d5b2cc151661aec535ee417ca0db7a817683fff8539b29fc457
620,bc1qz6lks9udfn78vx3cju9uyc6kqk6739hndak4ct,535,231576018,230323053,2023-04-10 08:26:06,2023-03-31 21:16:54,1252965,outbound,4382bb696d0c4d5b2cc151661aec535ee417ca0db7a817683fff8539b29fc457
621,bc1qz6lks9udfn78vx3cju9uyc6kqk6739hndak4ct,536,505760,505760,2022-12-29 10:43:43,2022-12-28 21:55:38,0,inbound,4382bb696d0c4d5b2cc151661aec535ee417ca0db7a817683fff8539b29fc457
622,bc1qz6lks9udfn78vx3cju9uyc6kqk6739hndak4ct,537,1222576107,1221823419,2023-04-10 08:25:58,2023-03-24 03:36:27,752688,outbound,4382bb696d0c4d5b2cc151661aec535ee417ca0db7a817683fff8539b29fc457
623,bc1qz6lks9udfn78vx3cju9uyc6kqk6739hndak4ct,538,578690,578690,2022-12-30 20:01:20,2022-12-28 21:55:38,0,inbound,4382bb696d0c4d5b2cc151661aec535ee417ca0db7a817683fff8539b29fc457
624,bc1qz6lks9udfn78vx3cju9uyc6kqk6739hndak4ct,539,193777,193777,2022-12-29 05:01:35,2022-12-28 21:55:38,0,inbound,4382bb696d0c4d5b2cc151661aec535ee417ca0db7a817683fff8539b29fc457
625,bc1qz6lks9udfn78vx3cju9uyc6kqk6739hndak4ct,540,460123,460123,2022-12-29 10:43:43,2022-12-28 21:55:38,0,inbound,4382bb696d0c4d5b2cc151661aec535ee417ca0db7a817683fff8539b29fc457
626,bc1qz6lks9udfn78vx3cju9uyc6kqk6739hndak4ct,541,54831609,25924736,2023-04-09 02:07:44,2022-12-19 23:21:28,28906873,inbound,4382bb696d0c4d5b2cc151661aec535ee417ca0db7a817683fff8539b29fc457
627,bc1qz6lks9udfn78vx3cju9uyc6kqk6739hndak4ct,542,107583182,106496635,2023-04-10 11:02:18,2023-03-24 04:53:43,1086547,inbound,4382bb696d0c4d5b2cc151661aec535ee417ca0db7a817683fff8539b29fc457
628,bc1qz6lks9udfn78vx3cju9uyc6kqk6739hndak4ct,543,282559,282559,2022-12-29 04:13:28,2022-12-28 21:55:38,0,inbound,4382bb696d0c4d5b2cc151661aec535ee417ca0db7a817683fff8539b29fc457
629,bc1qz6lks9udfn78vx3cju9uyc6kqk6739hndak4ct,544,104785584,104422851,2023-04-09 16:41:40,2023-01-06 15:48:41,362733,outbound,4382bb696d0c4d5b2cc151661aec535ee417ca0db7a817683fff8539b29fc457
630,bc1qz6lks9udfn78vx3cju9uyc6kqk6739hndak4ct,545,1789236,1789236,2023-01-19 00:02:09,2022-12-24 13:46:44,0,inbound,4382bb696d0c4d5b2cc151661aec535ee417ca0db7a817683fff8539b29fc457
631,bc1qz6lks9udfn78vx3cju9uyc6kqk6739hndak4ct,546,133216,133216,2022-12-29 00:02:10,2022-12-28 21:55:38,0,inbound,4382bb696d0c4d5b2cc151661aec535ee417ca0db7a817683fff8539b29fc457
632,bc1qz6lks9udfn78vx3cju9uyc6kqk6739hndak4ct,547,290229104,279825415,2023-04-10 11:21:36,2023-03-12 22:12:31,10403689,outbound,4382bb696d0c4d5b2cc151661aec535ee417ca0db7a817683fff8539b29fc457
633,bc1qz6lks9udfn78vx3cju9uyc6kqk6739hndak4ct,548,617967,617967,2022-12-29 01:03:44,2022-12-28 21:55:38,0,inbound,4382bb696d0c4d5b2cc151661aec535ee417ca0db7a817683fff8539b29fc457
634,bc1qz6lks9udfn78vx3cju9uyc6kqk6739hndak4ct,549,119957032,119957032,2023-04-09 07:40:06,2023-01-25 16:52:52,0,outbound,4382bb696d0c4d5b2cc151661aec535ee417ca0db7a817683fff8539b29fc457
635,bc1qz6lks9udfn78vx3cju9uyc6kqk6739hndak4ct,550,37000,37000,2022-12-29 13:20:58,2022-12-28 21:55:38,0,inbound,4382bb696d0c4d5b2cc151661aec535ee417ca0db7a817683fff8539b29fc457
636,bc1qz6lks9udfn78vx3cju9uyc6kqk6739hndak4ct,551,75272,75272,2022-12-29 06:58:54,2022-12-28 21:55:38,0,inbound,4382bb696d0c4d5b2cc151661aec535ee417ca0db7a817683fff8539b29fc457
637,bc1qz6lks9udfn78vx3cju9uyc6kqk6739hndak4ct,552,164060,164060,2022-12-29 00:02:58,2022-12-28 21:55:38,0,inbound,4382bb696d0c4d5b2cc151661aec535ee417ca0db7a817683fff8539b29fc457
638,bc1qz6lks9udfn78vx3cju9uyc6kqk6739hndak4ct,745,202457,202457,2022-12-26 20:46:12,2022-12-26 19:27:29,0,inbound,4382bb696d0c4d5b2cc151661aec535ee417ca0db7a817683fff8539b29fc457
639,bc1qz6lks9udfn78vx3cju9uyc6kqk6739hndak4ct,746,243422,0,2022-12-26 19:27:29,2022-12-26 19:27:29,243422,inbound,4382bb696d0c4d5b2cc151661aec535ee417ca0db7a817683fff8539b29fc457
640,bc1qz6lks9udfn78vx3cju9uyc6kqk6739hndak4ct,747,174062,174062,2022-12-29 06:21:17,2022-12-26 19:27:29,0,inbound,4382bb696d0c4d5b2cc151661aec535ee417ca0db7a817683fff8539b29fc457
641,bc1qz6lks9udfn78vx3cju9uyc6kqk6739hndak4ct,748,25103941,24906658,2023-02-23 13:57:40,2022-12-28 19:45:41,197283,outbound,4382bb696d0c4d5b2cc151661aec535ee417ca0db7a817683fff8539b29fc457
642,bc1qz6lks9udfn78vx3cju9uyc6kqk6739hndak4ct,749,61740022,61726066,2023-04-05 10:37:31,2022-06-29 00:50:51,13956,inbound,4382bb696d0c4d5b2cc151661aec535ee417ca0db7a817683fff8539b29fc457
643,bc1qz6lks9udfn78vx3cju9uyc6kqk6739hndak4ct,750,859598,859598,2022-12-30 19:57:39,2022-12-26 19:27:29,0,inbound,4382bb696d0c4d5b2cc151661aec535ee417ca0db7a817683fff8539b29fc457
644,bc1qz6lks9udfn78vx3cju9uyc6kqk6739hndak4ct,751,59970,59970,2022-12-27 16:28:52,2022-12-26 19:27:29,0,inbound,4382bb696d0c4d5b2cc151661aec535ee417ca0db7a817683fff8539b29fc457
645,bc1qz6lks9udfn78vx3cju9uyc6kqk6739hndak4ct,752,2903385,2903385,2022-12-26 19:56:05,2022-12-26 19:27:29,0,inbound,4382bb696d0c4d5b2cc151661aec535ee417ca0db7a817683fff8539b29fc457
646,bc1qz6lks9udfn78vx3cju9uyc6kqk6739hndak4ct,753,1165696075,1165695185,2023-02-01 07:06:22,2022-12-12 00:49:30,890,inbound,4382bb696d0c4d5b2cc151661aec535ee417ca0db7a817683fff8539b29fc457
647,bc1qz6lks9udfn78vx3cju9uyc6kqk6739hndak4ct,754,653076,653076,2022-12-27 03:19:09,2022-12-26 19:27:29,0,inbound,4382bb696d0c4d5b2cc151661aec535ee417ca0db7a817683fff8539b29fc457
648,bc1qz6lks9udfn78vx3cju9uyc6kqk6739hndak4ct,755,61295985,61295985,2023-04-10 01:50:21,2023-02-10 16:01:01,0,inbound,4382bb696d0c4d5b2cc151661aec535ee417ca0db7a817683fff8539b29fc457
649,bc1qz6lks9udfn78vx3cju9uyc6kqk6739hndak4ct,756,567175,567175,2022-12-27 09:07:50,2022-12-26 19:27:29,0,inbound,4382bb696d0c4d5b2cc151661aec535ee417ca0db7a817683fff8539b29fc457
650,bc1qz6lks9udfn78vx3cju9uyc6kqk6739hndak4ct,757,277065,277065,2022-12-27 05:01:34,2022-12-26 19:27:29,0,inbound,4382bb696d0c4d5b2cc151661aec535ee417ca0db7a817683fff8539b29fc457
651,bc1qz6lks9udfn78vx3cju9uyc6kqk6739hndak4ct,758,160941,160941,2022-12-27 00:07:43,2022-12-26 19:27:29,0,inbound,4382bb696d0c4d5b2cc151661aec535ee417ca0db7a817683fff8539b29fc457
652,bc1qz6lks9udfn78vx3cju9uyc6kqk6739hndak4ct,759,236404,236404,2022-12-31 08:51:36,2022-12-26 19:27:29,0,inbound,4382bb696d0c4d5b2cc151661aec535ee417ca0db7a817683fff8539b29fc457
653,bc1qz6lks9udfn78vx3cju9uyc6kqk6739hndak4ct,760,584666,584666,2022-12-26 19:59:11,2022-12-26 19:27:29,0,inbound,4382bb696d0c4d5b2cc151661aec535ee417ca0db7a817683fff8539b29fc457
654,bc1qz6lks9udfn78vx3cju9uyc6kqk6739hndak4ct,761,621539,621539,2022-12-27 04:33:56,2022-12-26 19:27:29,0,inbound,4382bb696d0c4d5b2cc151661aec535ee417ca0db7a817683fff8539b29fc457
655,bc1qz6lks9udfn78vx3cju9uyc6kqk6739hndak4ct,762,890571,890571,2022-12-26 20:09:11,2022-12-26 19:27:29,0,inbound,4382bb696d0c4d5b2cc151661aec535ee417ca0db7a817683fff8539b29fc457
656,bc1qz6lks9udfn78vx3cju9uyc6kqk6739hndak4ct,763,84293,84293,2022-12-27 00:07:42,2022-12-26 19:27:29,0,inbound,4382bb696d0c4d5b2cc151661aec535ee417ca0db7a817683fff8539b29fc457
657,bc1qz6lks9udfn78vx3cju9uyc6kqk6739hndak4ct,764,991022,991022,2022-12-26 20:40:05,2022-12-26 19:27:29,0,inbound,4382bb696d0c4d5b2cc151661aec535ee417ca0db7a817683fff8539b29fc457
658,bc1qz6lks9udfn78vx3cju9uyc6kqk6739hndak4ct,765,553227,553227,2022-12-27 00:07:45,2022-12-26 19:27:29,0,inbound,4382bb696d0c4d5b2cc151661aec535ee417ca0db7a817683fff8539b29fc457
659,bc1qz6lks9udfn78vx3cju9uyc6kqk6739hndak4ct,766,118742,118742,2023-01-03 22:54:43,2022-12-26 19:27:29,0,inbound,4382bb696d0c4d5b2cc151661aec535ee417ca0db7a817683fff8539b29fc457
660,bc1qz6lks9udfn78vx3cju9uyc6kqk6739hndak4ct,767,211404831,211404831,2023-04-08 20:05:57,2022-12-19 18:12:39,0,outbound,4382bb696d0c4d5b2cc151661aec535ee417ca0db7a817683fff8539b29fc457
661,bc1qz6lks9udfn78vx3cju9uyc6kqk6739hndak4ct,768,45415461,45199701,2023-04-03 21:53:03,2022-10-01 05:36:41,215760,inbound,4382bb696d0c4d5b2cc151661aec535ee417ca0db7a817683fff8539b29fc457
662,bc1qz6lks9udfn78vx3cju9uyc6kqk6739hndak4ct,769,1281953908,1281953908,2023-04-09 06:08:48,2023-03-17 11:41:27,0,inbound,4382bb696d0c4d5b2cc151661aec535ee417ca0db7a817683fff8539b29fc457
663,bc1qz6lks9udfn78vx3cju9uyc6kqk6739hndak4ct,770,297378,297378,2022-12-27 00:07:45,2022-12-26 19:27:29,0,inbound,4382bb696d0c4d5b2cc151661aec535ee417ca0db7a817683fff8539b29fc457
664,bc1qz6lks9udfn78vx3cju9uyc6kqk6739hndak4ct,771,419524,419524,2022-12-27 17:54:28,2022-12-26 19:27:29,0,inbound,4382bb696d0c4d5b2cc151661aec535ee417ca0db7a817683fff8539b29fc457
665,bc1qz6lks9udfn78vx3cju9uyc6kqk6739hndak4ct,772,1136425,1136425,2022-12-26 21:10:11,2022-12-26 19:27:29,0,inbound,4382bb696d0c4d5b2cc151661aec535ee417ca0db7a817683fff8539b29fc457
666,bc1qz6lks9udfn78vx3cju9uyc6kqk6739hndak4ct,773,75381420,75381420,2023-03-08 00:27:30,2022-12-24 06:10:39,0,outbound,4382bb696d0c4d5b2cc151661aec535ee417ca0db7a817683fff8539b29fc457
667,bc1qz6lks9udfn78vx3cju9uyc6kqk6739hndak4ct,774,130612,130612,2022-12-26 20:32:35,2022-12-26 19:27:29,0,inbound,4382bb696d0c4d5b2cc151661aec535ee417ca0db7a817683fff8539b29fc457
668,bc1qz6lks9udfn78vx3cju9uyc6kqk6739hndak4ct,775,593705,593705,2022-12-26 20:36:13,2022-12-26 19:27:29,0,inbound,4382bb696d0c4d5b2cc151661aec535ee417ca0db7a817683fff8539b29fc457
669,bc1qz6lks9udfn78vx3cju9uyc6kqk6739hndak4ct,776,335237,335237,2022-12-27 05:01:34,2022-12-26 19:27:29,0,inbound,4382bb696d0c4d5b2cc151661aec535ee417ca0db7a817683fff8539b29fc457
670,bc1qz6lks9udfn78vx3cju9uyc6kqk6739hndak4ct,777,307526568,307526568,2023-04-09 12:43:35,2023-02-12 10:19:07,0,inbound,4382bb696d0c4d5b2cc151661aec535ee417ca0db7a817683fff8539b29fc457
671,bc1qz6lks9udfn78vx3cju9uyc6kqk6739hndak4ct,778,123192,123192,2022-12-27 00:02:00,2022-12-26 19:27:29,0,inbound,4382bb696d0c4d5b2cc151661aec535ee417ca0db7a817683fff8539b29fc457
672,bc1qz6lks9udfn78vx3cju9uyc6kqk6739hndak4ct,779,178130,178130,2022-12-28 12:04:34,2022-12-26 19:27:29,0,inbound,4382bb696d0c4d5b2cc151661aec535ee417ca0db7a817683fff8539b29fc457
673,bc1qz6lks9udfn78vx3cju9uyc6kqk6739hndak4ct,780,336850,336850,2022-12-26 20:11:20,2022-12-26 19:27:29,0,inbound,4382bb696d0c4d5b2cc151661aec535ee417ca0db7a817683fff8539b29fc457
674,bc1qz6lks9udfn78vx3cju9uyc6kqk6739hndak4ct,781,231307152,231307152,2023-03-21 18:17:13,2023-01-14 02:51:32,0,inbound,4382bb696d0c4d5b2cc151661aec535ee417ca0db7a817683fff8539b29fc457
675,bc1qz6lks9udfn78vx3cju9uyc6kqk6739hndak4ct,782,685048,685048,2022-12-27 00:07:48,2022-12-26 19:27:29,0,inbound,4382bb696d0c4d5b2cc151661aec535ee417ca0db7a817683fff8539b29fc457
676,bc1qz6lks9udfn78vx3cju9uyc6kqk6739hndak4ct,783,219009,219009,2022-12-27 20:52:46,2022-12-26 19:27:29,0,inbound,4382bb696d0c4d5b2cc151661aec535ee417ca0db7a817683fff8539b29fc457
677,bc1qz6lks9udfn78vx3cju9uyc6kqk6739hndak4ct,909,297202,297202,2022-12-27 14:41:19,2022-12-24 17:44:10,0,inbound,4382bb696d0c4d5b2cc151661aec535ee417ca0db7a817683fff8539b29fc457
678,bc1qz6lks9udfn78vx3cju9uyc6kqk6739hndak4ct,910,42969587,42969587,2022-12-27 01:07:38,2022-10-14 00:15:09,0,inbound,4382bb696d0c4d5b2cc151661aec535ee417ca0db7a817683fff8539b29fc457
679,bc1qz6lks9udfn78vx3cju9uyc6kqk6739hndak4ct,911,135395,135395,2022-12-25 00:02:56,2022-12-24 17:44:10,0,inbound,4382bb696d0c4d5b2cc151661aec535ee417ca0db7a817683fff8539b29fc457
680,bc1qz6lks9udfn78vx3cju9uyc6kqk6739hndak4ct,912,173362917,173362917,2023-03-29 16:33:35,2022-11-28 08:03:09,0,inbound,4382bb696d0c4d5b2cc151661aec535ee417ca0db7a817683fff8539b29fc457
681,bc1qz6lks9udfn78vx3cju9uyc6kqk6739hndak4ct,913,126578,126578,2022-12-30 07:00:25,2022-12-24 17:44:10,0,inbound,4382bb696d0c4d5b2cc151661aec535ee417ca0db7a817683fff8539b29fc457
682,bc1qz6lks9udfn78vx3cju9uyc6kqk6739hndak4ct,914,597173,597173,2022-12-26 16:22:25,2022-12-24 17:44:10,0,inbound,4382bb696d0c4d5b2cc151661aec535ee417ca0db7a817683fff8539b29fc457
683,bc1qz6lks9udfn78vx3cju9uyc6kqk6739hndak4ct,915,60816667,60816667,2023-04-04 17:25:00,2018-07-03 21:53:00,0,inbound,4382bb696d0c4d5b2cc151661aec535ee417ca0db7a817683fff8539b29fc457
684,bc1qz6lks9udfn78vx3cju9uyc6kqk6739hndak4ct,916,5000000,5000000,2022-12-29 09:26:38,2022-12-24 17:44:10,0,inbound,4382bb696d0c4d5b2cc151661aec535ee417ca0db7a817683fff8539b29fc457
685,bc1qz6lks9udfn78vx3cju9uyc6kqk6739hndak4ct,917,239652139,236397578,2023-01-12 22:02:49,2022-10-25 10:57:12,3254561,inbound,4382bb696d0c4d5b2cc151661aec535ee417ca0db7a817683fff8539b29fc457
686,bc1qz6lks9udfn78vx3cju9uyc6kqk6739hndak4ct,918,371837,371837,2022-12-26 17:10:24,2022-12-24 17:44:10,0,inbound,4382bb696d0c4d5b2cc151661aec535ee417ca0db7a817683fff8539b29fc457
687,bc1qz6lks9udfn78vx3cju9uyc6kqk6739hndak4ct,919,59411,0,2022-12-24 17:44:10,2022-12-24 17:44:10,59411,inbound,4382bb696d0c4d5b2cc151661aec535ee417ca0db7a817683fff8539b29fc457
688,bc1qz6lks9udfn78vx3cju9uyc6kqk6739hndak4ct,920,30604305,30604305,2023-03-26 18:34:39,2022-10-24 15:56:41,0,outbound,4382bb696d0c4d5b2cc151661aec535ee417ca0db7a817683fff8539b29fc457
689,bc1qz6lks9udfn78vx3cju9uyc6kqk6739hndak4ct,921,631197,631197,2023-01-02 12:57:28,2022-12-24 17:44:10,0,inbound,4382bb696d0c4d5b2cc151661aec535ee417ca0db7a817683fff8539b29fc457
690,bc1qz6lks9udfn78vx3cju9uyc6kqk6739hndak4ct,922,136166,136166,2023-01-02 23:28:25,2022-12-24 17:44:10,0,inbound,4382bb696d0c4d5b2cc151661aec535ee417ca0db7a817683fff8539b29fc457
691,bc1qz6lks9udfn78vx3cju9uyc6kqk6739hndak4ct,923,106095,106095,2023-01-23 16:00:26,2022-12-24 17:44:10,0,inbound,4382bb696d0c4d5b2cc151661aec535ee417ca0db7a817683fff8539b29fc457
692,bc1qz6lks9udfn78vx3cju9uyc6kqk6739hndak4ct,924,303076,303076,2022-12-27 14:33:15,2022-12-24 17:44:10,0,inbound,4382bb696d0c4d5b2cc151661aec535ee417ca0db7a817683fff8539b29fc457
693,bc1qz6lks9udfn78vx3cju9uyc6kqk6739hndak4ct,925,1264775,1264775,2022-12-26 00:06:39,2022-12-24 17:44:10,0,inbound,4382bb696d0c4d5b2cc151661aec535ee417ca0db7a817683fff8539b29fc457
694,bc1qz6lks9udfn78vx3cju9uyc6kqk6739hndak4ct,926,279214,279214,2022-12-28 16:59:45,2022-12-24 17:44:10,0,inbound,4382bb696d0c4d5b2cc151661aec535ee417ca0db7a817683fff8539b29fc457
695,bc1qz6lks9udfn78vx3cju9uyc6kqk6739hndak4ct,927,768492376,738566345,2023-04-07 01:36:57,2020-08-15 15:26:59,29926031,inbound,4382bb696d0c4d5b2cc151661aec535ee417ca0db7a817683fff8539b29fc457
696,bc1qz6lks9udfn78vx3cju9uyc6kqk6739hndak4ct,928,292795,292795,2022-12-26 17:42:25,2022-12-24 17:44:10,0,inbound,4382bb696d0c4d5b2cc151661aec535ee417ca0db7a817683fff8539b29fc457
697,bc1qz6lks9udfn78vx3cju9uyc6kqk6739hndak4ct,929,891125,891125,2022-12-24 20:00:56,2022-12-24 17:44:10,0,inbound,4382bb696d0c4d5b2cc151661aec535ee417ca0db7a817683fff8539b29fc457
698,bc1qz6lks9udfn78vx3cju9uyc6kqk6739hndak4ct,930,128445,128445,2022-12-25 05:01:30,2022-12-24 17:44:10,0,inbound,4382bb696d0c4d5b2cc151661aec535ee417ca0db7a817683fff8539b29fc457
699,bc1qz6lks9udfn78vx3cju9uyc6kqk6739hndak4ct,931,30225044,17938990,2023-04-10 02:02:19,2021-10-01 23:52:45,12286054,inbound,4382bb696d0c4d5b2cc151661aec535ee417ca0db7a817683fff8539b29fc457
700,bc1qz6lks9udfn78vx3cju9uyc6kqk6739hndak4ct,932,578345,578345,2022-12-25 00:03:02,2022-12-24 17:44:10,0,inbound,4382bb696d0c4d5b2cc151661aec535ee417ca0db7a817683fff8539b29fc457
701,bc1qz6lks9udfn78vx3cju9uyc6kqk6739hndak4ct,933,570637,570637,2022-12-26 16:26:20,2022-12-24 17:44:10,0,inbound,4382bb696d0c4d5b2cc151661aec535ee417ca0db7a817683fff8539b29fc457
702,bc1qz6lks9udfn78vx3cju9uyc6kqk6739hndak4ct,934,11881,0,2022-12-24 17:44:10,2022-12-24 17:44:10,11881,inbound,4382bb696d0c4d5b2cc151661aec535ee417ca0db7a817683fff8539b29fc457
703,bc1qz6lks9udfn78vx3cju9uyc6kqk6739hndak4ct,935,574095,574095,2022-12-26 11:34:18,2022-12-24 17:44:10,0,inbound,4382bb696d0c4d5b2cc151661aec535ee417ca0db7a817683fff8539b29fc457
704,bc1qz6lks9udfn78vx3cju9uyc6kqk6739hndak4ct,936,65390953,65073254,2023-04-10 15:21:44,2023-02-23 19:41:32,317699,outbound,4382bb696d0c4d5b2cc151661aec535ee417ca0db7a817683fff8539b29fc457
705,bc1qz6lks9udfn78vx3cju9uyc6kqk6739hndak4ct,937,565598,565598,2022-12-30 21:11:44,2022-12-24 17:44:10,0,inbound,4382bb696d0c4d5b2cc151661aec535ee417ca0db7a817683fff8539b29fc457
706,bc1qz6lks9udfn78vx3cju9uyc6kqk6739hndak4ct,938,189329640,189329640,2022-12-24 18:25:09,2022-12-24 17:44:10,0,inbound,4382bb696d0c4d5b2cc151661aec535ee417ca0db7a817683fff8539b29fc457
707,bc1qz6lks9udfn78vx3cju9uyc6kqk6739hndak4ct,939,70295185,70295185,2023-04-09 03:50:53,2022-10-19 23:50:44,0,inbound,4382bb696d0c4d5b2cc151661aec535ee417ca0db7a817683fff8539b29fc457
708,bc1qz6lks9udfn78vx3cju9uyc6kqk6739hndak4ct,940,3730949,3705377,2023-03-20 07:42:45,2021-04-28 01:37:39,25572,inbound,4382bb696d0c4d5b2cc151661aec535ee417ca0db7a817683fff8539b29fc457
709,bc1qz6lks9udfn78vx3cju9uyc6kqk6739hndak4ct,941,5657413,5657413,2022-12-23 13:09:23,2022-12-23 12:52:47,0,inbound,4382bb696d0c4d5b2cc151661aec535ee417ca0db7a817683fff8539b29fc457
710,bc1qz6lks9udfn78vx3cju9uyc6kqk6739hndak4ct,942,5176657,0,2023-03-05 12:26:59,2022-07-02 08:54:41,5176657,inbound,4382bb696d0c4d5b2cc151661aec535ee417ca0db7a817683fff8539b29fc457
711,bc1qz6lks9udfn78vx3cju9uyc6kqk6739hndak4ct,943,391000,391000,2022-12-25 01:34:08,2022-12-23 12:52:47,0,inbound,4382bb696d0c4d5b2cc151661aec535ee417ca0db7a817683fff8539b29fc457
712,bc1qz6lks9udfn78vx3cju9uyc6kqk6739hndak4ct,944,214000,214000,2022-12-31 00:47:14,2022-12-23 12:52:47,0,inbound,4382bb696d0c4d5b2cc151661aec535ee417ca0db7a817683fff8539b29fc457
713,bc1qz6lks9udfn78vx3cju9uyc6kqk6739hndak4ct,945,3760336,3760336,2022-12-26 06:39:06,2022-12-23 12:52:47,0,inbound,4382bb696d0c4d5b2cc151661aec535ee417ca0db7a817683fff8539b29fc457
714,bc1qz6lks9udfn78vx3cju9uyc6kqk6739hndak4ct,946,57195898,57195898,2023-04-10 09:42:52,2022-07-04 07:49:29,0,outbound,4382bb696d0c4d5b2cc151661aec535ee417ca0db7a817683fff8539b29fc457
715,bc1qz6lks9udfn78vx3cju9uyc6kqk6739hndak4ct,947,1653218,0,2022-12-23 12:52:47,2022-12-23 12:52:47,1653218,inbound,4382bb696d0c4d5b2cc151661aec535ee417ca0db7a817683fff8539b29fc457
716,bc1qz6lks9udfn78vx3cju9uyc6kqk6739hndak4ct,1211,14313113,14313113,2023-03-04 14:47:40,2022-12-01 09:06:15,0,inbound,4382bb696d0c4d5b2cc151661aec535ee417ca0db7a817683fff8539b29fc457
717,bc1qz6lks9udfn78vx3cju9uyc6kqk6739hndak4ct,1212,151739300,147088181,2023-04-08 23:00:51,2023-02-02 16:09:20,4651119,inbound,4382bb696d0c4d5b2cc151661aec535ee417ca0db7a817683fff8539b29fc457
718,bc1qz6lks9udfn78vx3cju9uyc6kqk6739hndak4ct,1213,169861,169861,2022-12-22 18:03:03,2022-12-22 13:42:07,0,inbound,4382bb696d0c4d5b2cc151661aec535ee417ca0db7a817683fff8539b29fc457
719,bc1qz6lks9udfn78vx3cju9uyc6kqk6739hndak4ct,1214,232006,232006,2022-12-27 10:28:30,2022-12-22 13:42:07,0,inbound,4382bb696d0c4d5b2cc151661aec535ee417ca0db7a817683fff8539b29fc457
720,bc1qz6lks9udfn78vx3cju9uyc6kqk6739hndak4ct,1215,5273700,5273700,2023-02-15 20:57:31,2022-12-22 13:26:53,0,inbound,4382bb696d0c4d5b2cc151661aec535ee417ca0db7a817683fff8539b29fc457
721,bc1qz6lks9udfn78vx3cju9uyc6kqk6739hndak4ct,1216,272024,0,2022-12-22 13:42:07,2022-12-22 13:42:07,272024,inbound,4382bb696d0c4d5b2cc151661aec535ee417ca0db7a817683fff8539b29fc457
722,bc1qz6lks9udfn78vx3cju9uyc6kqk6739hndak4ct,1217,43320232,43320232,2023-01-17 10:48:41,2022-11-13 21:37:29,0,inbound,4382bb696d0c4d5b2cc151661aec535ee417ca0db7a817683fff8539b29fc457
723,bc1qz6lks9udfn78vx3cju9uyc6kqk6739hndak4ct,1218,2678837,2678837,2022-12-22 16:06:00,2022-12-22 13:42:07,0,inbound,4382bb696d0c4d5b2cc151661aec535ee417ca0db7a817683fff8539b29fc457
724,bc1qz6lks9udfn78vx3cju9uyc6kqk6739hndak4ct,1219,384790259865257,384760430394978,2023-04-10 16:33:24,2023-04-09 18:24:52,29829470279,outbound,4382bb696d0c4d5b2cc151661aec535ee417ca0db7a817683fff8539b29fc457
725,bc1qz6lks9udfn78vx3cju9uyc6kqk6739hndak4ct,1220,713941598850259,713919115880084,2023-04-10 16:35:27,2023-04-10 13:22:11,22482970175,outbound,4382bb696d0c4d5b2cc151661aec535ee417ca0db7a817683fff8539b29fc457
726,bc1qz6lks9udfn78vx3cju9uyc6kqk6739hndak4ct,1221,25962179,25962179,2023-01-06 23:12:27,2022-12-21 11:54:34,0,inbound,4382bb696d0c4d5b2cc151661aec535ee417ca0db7a817683fff8539b29fc457
727,bc1qz6lks9udfn78vx3cju9uyc6kqk6739hndak4ct,1222,3667113,3667113,2023-02-19 02:49:45,2022-12-20 17:35:19,0,inbound,4382bb696d0c4d5b2cc151661aec535ee417ca0db7a817683fff8539b29fc457
728,bc1qz6lks9udfn78vx3cju9uyc6kqk6739hndak4ct,1223,36062,0,2022-12-20 01:13:39,2022-12-20 01:13:39,36062,inbound,4382bb696d0c4d5b2cc151661aec535ee417ca0db7a817683fff8539b29fc457
729,bc1qz6lks9udfn78vx3cju9uyc6kqk6739hndak4ct,1224,410000,410000,2022-12-19 05:01:34,2022-12-18 18:56:48,0,inbound,4382bb696d0c4d5b2cc151661aec535ee417ca0db7a817683fff8539b29fc457
730,bc1qz6lks9udfn78vx3cju9uyc6kqk6739hndak4ct,1225,10099444,10099444,2023-01-06 03:06:06,2022-03-21 03:43:57,0,inbound,4382bb696d0c4d5b2cc151661aec535ee417ca0db7a817683fff8539b29fc457
731,bc1qz6lks9udfn78vx3cju9uyc6kqk6739hndak4ct,1226,8519604,8519604,2023-01-06 19:26:06,2022-07-18 05:02:40,0,inbound,4382bb696d0c4d5b2cc151661aec535ee417ca0db7a817683fff8539b29fc457
732,bc1qz6lks9udfn78vx3cju9uyc6kqk6739hndak4ct,1227,21398000,0,2023-03-07 07:39:20,2022-10-08 06:50:44,21398000,inbound,4382bb696d0c4d5b2cc151661aec535ee417ca0db7a817683fff8539b29fc457
733,bc1qz6lks9udfn78vx3cju9uyc6kqk6739hndak4ct,1228,217205,217205,2022-12-29 15:36:04,2022-12-18 18:56:48,0,inbound,4382bb696d0c4d5b2cc151661aec535ee417ca0db7a817683fff8539b29fc457
734,bc1qz6lks9udfn78vx3cju9uyc6kqk6739hndak4ct,1229,2580425,0,2022-12-18 18:56:48,2022-12-18 18:56:48,2580425,inbound,4382bb696d0c4d5b2cc151661aec535ee417ca0db7a817683fff8539b29fc457
735,bc1qz6lks9udfn78vx3cju9uyc6kqk6739hndak4ct,1230,6766900,1354000,2022-12-18 18:56:48,2022-12-15 17:42:50,5412900,inbound,4382bb696d0c4d5b2cc151661aec535ee417ca0db7a817683fff8539b29fc457
736,bc1qz6lks9udfn78vx3cju9uyc6kqk6739hndak4ct,1231,1347430157,1344523981,2023-04-04 04:19:54,2023-01-05 05:43:51,2906176,outbound,4382bb696d0c4d5b2cc151661aec535ee417ca0db7a817683fff8539b29fc457
737,bc1qz6lks9udfn78vx3cju9uyc6kqk6739hndak4ct,1232,330439,0,2022-12-18 18:56:48,2022-12-18 18:56:48,330439,inbound,4382bb696d0c4d5b2cc151661aec535ee417ca0db7a817683fff8539b29fc457
738,bc1qz6lks9udfn78vx3cju9uyc6kqk6739hndak4ct,1233,6738060,6738060,2023-02-26 17:30:52,2022-12-18 17:22:46,0,inbound,4382bb696d0c4d5b2cc151661aec535ee417ca0db7a817683fff8539b29fc457
739,bc1qz6lks9udfn78vx3cju9uyc6kqk6739hndak4ct,1234,80501118,80501118,2022-12-20 13:20:23,2022-05-11 09:44:39,0,inbound,4382bb696d0c4d5b2cc151661aec535ee417ca0db7a817683fff8539b29fc457
740,bc1qz6lks9udfn78vx3cju9uyc6kqk6739hndak4ct,1235,1657310,1657310,2022-12-18 22:05:08,2022-12-18 18:56:48,0,inbound,4382bb696d0c4d5b2cc151661aec535ee417ca0db7a817683fff8539b29fc457
741,bc1qz6lks9udfn78vx3cju9uyc6kqk6739hndak4ct,1236,80000,0,2022-12-18 18:56:48,2022-12-18 18:56:48,80000,inbound,4382bb696d0c4d5b2cc151661aec535ee417ca0db7a817683fff8539b29fc457
742,bc1qz6lks9udfn78vx3cju9uyc6kqk6739hndak4ct,1237,116927369,116909668,2023-03-29 07:40:39,2022-10-03 01:20:43,17701,inbound,4382bb696d0c4d5b2cc151661aec535ee417ca0db7a817683fff8539b29fc457
743,bc1qz6lks9udfn78vx3cju9uyc6kqk6739hndak4ct,1238,25227732878,25127752878,2023-04-10 06:13:49,2022-01-06 08:30:19,99980000,outbound,4382bb696d0c4d5b2cc151661aec535ee417ca0db7a817683fff8539b29fc457
744,bc1qz6lks9udfn78vx3cju9uyc6kqk6739hndak4ct,1239,332530,332530,2022-12-18 21:13:37,2022-12-18 18:56:48,0,inbound,4382bb696d0c4d5b2cc151661aec535ee417ca0db7a817683fff8539b29fc457
745,bc1qz6lks9udfn78vx3cju9uyc6kqk6739hndak4ct,1240,30358494,0,2022-12-18 18:56:48,2022-12-18 19:18:48,30358494,inbound,4382bb696d0c4d5b2cc151661aec535ee417ca0db7a817683fff8539b29fc457
746,bc1qz6lks9udfn78vx3cju9uyc6kqk6739hndak4ct,1241,487004,0,2022-12-18 18:56:48,2022-12-18 18:56:48,487004,inbound,4382bb696d0c4d5b2cc151661aec535ee417ca0db7a817683fff8539b29fc457
747,bc1qz6lks9udfn78vx3cju9uyc6kqk6739hndak4ct,1242,608694,608694,2022-12-18 19:11:06,2022-12-18 18:56:48,0,inbound,4382bb696d0c4d5b2cc151661aec535ee417ca0db7a817683fff8539b29fc457
748,bc1qz6lks9udfn78vx3cju9uyc6kqk6739hndak4ct,1243,17872000,17872000,2022-12-18 20:20:32,2022-12-18 18:56:48,0,inbound,4382bb696d0c4d5b2cc151661aec535ee417ca0db7a817683fff8539b29fc457
749,bc1qz6lks9udfn78vx3cju9uyc6kqk6739hndak4ct,1244,696267,696267,2022-12-19 02:22:39,2022-05-11 19:34:52,0,inbound,4382bb696d0c4d5b2cc151661aec535ee417ca0db7a817683fff8539b29fc457
750,bc1qz6lks9udfn78vx3cju9uyc6kqk6739hndak4ct,1245,239131,0,2022-12-18 18:56:48,2022-09-24 09:16:43,239131,inbound,4382bb696d0c4d5b2cc151661aec535ee417ca0db7a817683fff8539b29fc457
751,bc1qz6lks9udfn78vx3cju9uyc6kqk6739hndak4ct,1246,1567437,0,2022-12-18 18:56:48,2022-12-18 18:56:48,1567437,inbound,4382bb696d0c4d5b2cc151661aec535ee417ca0db7a817683fff8539b29fc457
752,bc1qz6lks9udfn78vx3cju9uyc6kqk6739hndak4ct,1247,16520759,16520759,2022-12-18 19:49:05,2022-12-18 18:56:48,0,inbound,4382bb696d0c4d5b2cc151661aec535ee417ca0db7a817683fff8539b29fc457
753,bc1qz6lks9udfn78vx3cju9uyc6kqk6739hndak4ct,1248,5433830,0,2022-12-21 19:31:17,2022-12-18 18:56:48,5433830,inbound,4382bb696d0c4d5b2cc151661aec535ee417ca0db7a817683fff8539b29fc457
754,bc1qz6lks9udfn78vx3cju9uyc6kqk6739hndak4ct,1249,4950947,4950947,2023-02-05 02:50:30,2022-12-17 04:52:46,0,inbound,4382bb696d0c4d5b2cc151661aec535ee417ca0db7a817683fff8539b29fc457
755,bc1qz6lks9udfn78vx3cju9uyc6kqk6739hndak4ct,1698,2019205,2019205,2022-12-12 10:05:59,2022-12-11 12:36:49,0,inbound,4382bb696d0c4d5b2cc151661aec535ee417ca0db7a817683fff8539b29fc457
756,bc1qz6lks9udfn78vx3cju9uyc6kqk6739hndak4ct,1699,253199994,252173371,2023-04-09 10:24:11,2023-02-11 06:57:15,1026623,outbound,4382bb696d0c4d5b2cc151661aec535ee417ca0db7a817683fff8539b29fc457
757,bc1qz6lks9udfn78vx3cju9uyc6kqk6739hndak4ct,1700,1649875220,1649875220,2023-03-25 00:58:42,2022-12-03 13:04:46,0,inbound,4382bb696d0c4d5b2cc151661aec535ee417ca0db7a817683fff8539b29fc457
758,bc1qz6lks9udfn78vx3cju9uyc6kqk6739hndak4ct,1701,5296666,0,2022-12-11 12:36:49,2022-12-11 12:36:49,5296666,inbound,4382bb696d0c4d5b2cc151661aec535ee417ca0db7a817683fff8539b29fc457
759,bc1qz6lks9udfn78vx3cju9uyc6kqk6739hndak4ct,1702,172000,172000,2023-01-14 16:14:10,2022-12-11 12:36:49,0,inbound,4382bb696d0c4d5b2cc151661aec535ee417ca0db7a817683fff8539b29fc457
760,bc1qz6lks9udfn78vx3cju9uyc6kqk6739hndak4ct,1703,1087576,1087576,2022-12-16 08:00:09,2022-12-11 12:36:49,0,inbound,4382bb696d0c4d5b2cc151661aec535ee417ca0db7a817683fff8539b29fc457
761,bc1qz6lks9udfn78vx3cju9uyc6kqk6739hndak4ct,1704,3492440,3492440,2023-02-22 18:18:34,2022-12-09 08:44:48,0,inbound,4382bb696d0c4d5b2cc151661aec535ee417ca0db7a817683fff8539b29fc457
762,bc1qz6lks9udfn78vx3cju9uyc6kqk6739hndak4ct,1705,2690063,0,2022-12-11 12:36:49,2022-12-11 12:36:49,2690063,inbound,4382bb696d0c4d5b2cc151661aec535ee417ca0db7a817683fff8539b29fc457
763,bc1qz6lks9udfn78vx3cju9uyc6kqk6739hndak4ct,1706,2353000,2353000,2023-03-16 13:18:17,2022-09-21 12:59:15,0,inbound,4382bb696d0c4d5b2cc151661aec535ee417ca0db7a817683fff8539b29fc457
764,bc1qz6lks9udfn78vx3cju9uyc6kqk6739hndak4ct,1707,16590147,16590147,2022-12-21 03:34:41,2022-05-14 21:46:14,0,outbound,4382bb696d0c4d5b2cc151661aec535ee417ca0db7a817683fff8539b29fc457
765,bc1qz6lks9udfn78vx3cju9uyc6kqk6739hndak4ct,1708,4507439,4507439,2022-12-18 01:13:51,2021-07-28 06:21:21,0,inbound,4382bb696d0c4d5b2cc151661aec535ee417ca0db7a817683fff8539b29fc457
766,bc1qz6lks9udfn78vx3cju9uyc6kqk6739hndak4ct,1709,22956000,22956000,2023-02-20 19:03:33,2022-12-14 18:55:15,0,inbound,4382bb696d0c4d5b2cc151661aec535ee417ca0db7a817683fff8539b29fc457
767,bc1qz6lks9udfn78vx3cju9uyc6kqk6739hndak4ct,1710,6253419,6253419,2022-12-19 10:45:18,2021-12-02 21:43:34,0,inbound,4382bb696d0c4d5b2cc151661aec535ee417ca0db7a817683fff8539b29fc457
768,bc1qz6lks9udfn78vx3cju9uyc6kqk6739hndak4ct,1711,9468935,9468935,2023-04-07 11:18:53,2022-10-15 05:39:44,0,inbound,4382bb696d0c4d5b2cc151661aec535ee417ca0db7a817683fff8539b29fc457
769,bc1qz6lks9udfn78vx3cju9uyc6kqk6739hndak4ct,1712,4208841,4208841,2023-03-14 21:15:48,2022-10-19 22:43:14,0,inbound,4382bb696d0c4d5b2cc151661aec535ee417ca0db7a817683fff8539b29fc457
770,bc1qz6lks9udfn78vx3cju9uyc6kqk6739hndak4ct,1713,248209838,248209838,2023-03-03 16:08:09,2023-01-12 12:46:22,0,inbound,4382bb696d0c4d5b2cc151661aec535ee417ca0db7a817683fff8539b29fc457
771,bc1qz6lks9udfn78vx3cju9uyc6kqk6739hndak4ct,1714,559000,559000,2022-12-11 13:40:15,2022-12-11 12:24:09,0,inbound,4382bb696d0c4d5b2cc151661aec535ee417ca0db7a817683fff8539b29fc457
772,bc1qz6lks9udfn78vx3cju9uyc6kqk6739hndak4ct,1715,28799964,28787804,2023-03-14 09:33:08,2022-11-03 10:48:44,12160,outbound,4382bb696d0c4d5b2cc151661aec535ee417ca0db7a817683fff8539b29fc457
773,bc1qz6lks9udfn78vx3cju9uyc6kqk6739hndak4ct,1716,328650,328650,2022-12-20 17:23:05,2022-12-11 12:24:09,0,inbound,4382bb696d0c4d5b2cc151661aec535ee417ca0db7a817683fff8539b29fc457
774,bc1qz6lks9udfn78vx3cju9uyc6kqk6739hndak4ct,1717,357000,357000,2022-12-11 18:15:45,2022-12-11 12:24:09,0,inbound,4382bb696d0c4d5b2cc151661aec535ee417ca0db7a817683fff8539b29fc457
775,bc1qz6lks9udfn78vx3cju9uyc6kqk6739hndak4ct,1718,363000,363000,2022-12-11 12:30:42,2022-12-11 12:24:09,0,inbound,4382bb696d0c4d5b2cc151661aec535ee417ca0db7a817683fff8539b29fc457
776,bc1qz6lks9udfn78vx3cju9uyc6kqk6739hndak4ct,1719,771129,770122,2022-12-26 11:59:22,2022-12-11 12:24:09,1007,inbound,4382bb696d0c4d5b2cc151661aec535ee417ca0db7a817683fff8539b29fc457
777,bc1qz6lks9udfn78vx3cju9uyc6kqk6739hndak4ct,1720,400000,0,2022-12-11 12:24:09,2022-12-11 12:24:09,400000,inbound,4382bb696d0c4d5b2cc151661aec535ee417ca0db7a817683fff8539b29fc457
778,bc1qz6lks9udfn78vx3cju9uyc6kqk6739hndak4ct,1721,41872076,41869884,2023-01-12 23:27:39,2022-09-09 14:10:38,2192,inbound,4382bb696d0c4d5b2cc151661aec535ee417ca0db7a817683fff8539b29fc457
779,bc1qz6lks9udfn78vx3cju9uyc6kqk6739hndak4ct,1722,26899831,26624831,2023-04-10 06:12:16,2023-01-08 19:37:19,275000,outbound,4382bb696d0c4d5b2cc151661aec535ee417ca0db7a817683fff8539b29fc457
780,bc1qz6lks9udfn78vx3cju9uyc6kqk6739hndak4ct,1723,522044001,522044001,2023-04-09 21:36:54,2023-02-01 17:14:10,0,outbound,4382bb696d0c4d5b2cc151661aec535ee417ca0db7a817683fff8539b29fc457
781,bc1qz6lks9udfn78vx3cju9uyc6kqk6739hndak4ct,1724,6227000,6227000,2022-12-11 15:06:49,2022-12-11 12:00:48,0,inbound,4382bb696d0c4d5b2cc151661aec535ee417ca0db7a817683fff8539b29fc457
782,bc1qz6lks9udfn78vx3cju9uyc6kqk6739hndak4ct,1725,25194000,25194000,2022-12-30 00:41:35,2022-10-08 18:19:00,0,inbound,4382bb696d0c4d5b2cc151661aec535ee417ca0db7a817683fff8539b29fc457
783,bc1qz6lks9udfn78vx3cju9uyc6kqk6739hndak4ct,1726,560300,560300,2022-12-11 12:37:51,2022-12-11 12:24:09,0,inbound,4382bb696d0c4d5b2cc151661aec535ee417ca0db7a817683fff8539b29fc457
784,bc1qz6lks9udfn78vx3cju9uyc6kqk6739hndak4ct,1727,773154,562000,2022-12-11 15:23:14,2022-12-11 12:24:09,211154,inbound,4382bb696d0c4d5b2cc151661aec535ee417ca0db7a817683fff8539b29fc457
785,bc1qz6lks9udfn78vx3cju9uyc6kqk6739hndak4ct,1728,588000,588000,2022-12-11 12:27:01,2022-12-11 12:24:09,0,inbound,4382bb696d0c4d5b2cc151661aec535ee417ca0db7a817683fff8539b29fc457
786,bc1qz6lks9udfn78vx3cju9uyc6kqk6739hndak4ct,1729,79282805,79282805,2022-12-11 12:38:11,2022-09-14 00:02:07,0,inbound,4382bb696d0c4d5b2cc151661aec535ee417ca0db7a817683fff8539b29fc457
787,bc1qz6lks9udfn78vx3cju9uyc6kqk6739hndak4ct,1730,2796830,2796830,2023-01-29 17:52:14,2022-09-28 06:12:39,0,inbound,4382bb696d0c4d5b2cc151661aec535ee417ca0db7a817683fff8539b29fc457
788,bc1qz6lks9udfn78vx3cju9uyc6kqk6739hndak4ct,1731,4093363,4093363,2022-12-13 23:09:40,2022-12-08 18:43:37,0,inbound,4382bb696d0c4d5b2cc151661aec535ee417ca0db7a817683fff8539b29fc457
789,bc1qz6lks9udfn78vx3cju9uyc6kqk6739hndak4ct,1732,619000,619000,2022-12-13 11:26:29,2022-12-11 12:24:09,0,inbound,4382bb696d0c4d5b2cc151661aec535ee417ca0db7a817683fff8539b29fc457
790,bc1qz6lks9udfn78vx3cju9uyc6kqk6739hndak4ct,1733,681000,0,2022-12-11 12:24:09,2022-12-11 12:24:09,681000,inbound,4382bb696d0c4d5b2cc151661aec535ee417ca0db7a817683fff8539b29fc457
791,bc1qz6lks9udfn78vx3cju9uyc6kqk6739hndak4ct,1734,738000,0,2022-12-11 12:24:09,2022-12-11 12:24:09,738000,inbound,4382bb696d0c4d5b2cc151661aec535ee417ca0db7a817683fff8539b29fc457
792,bc1qz6lks9udfn78vx3cju9uyc6kqk6739hndak4ct,1735,2713366,2545741,2022-12-23 13:15:28,2022-03-27 21:36:47,167625,inbound,4382bb696d0c4d5b2cc151661aec535ee417ca0db7a817683fff8539b29fc457
793,bc1qz6lks9udfn78vx3cju9uyc6kqk6739hndak4ct,1736,1071000,1071000,2022-12-11 13:01:09,2022-12-11 12:24:09,0,inbound,4382bb696d0c4d5b2cc151661aec535ee417ca0db7a817683fff8539b29fc457
794,bc1qz6lks9udfn78vx3cju9uyc6kqk6739hndak4ct,86,38854,38854,2023-03-04 17:30:36,2023-01-26 01:25:03,0,inbound,dce574f2f8283a45c76d37773fe49bf2c04320cf91af3d9917bfd47926340c4f
795,bc1qz6lks9udfn78vx3cju9uyc6kqk6739hndak4ct,390,400800,400800,2022-12-30 04:47:56,2022-12-30 01:36:46,0,inbound,dce574f2f8283a45c76d37773fe49bf2c04320cf91af3d9917bfd47926340c4f
796,bc1qz6lks9udfn78vx3cju9uyc6kqk6739hndak4ct,553,24908902,24908902,2023-03-23 23:22:19,2022-02-16 09:48:49,0,inbound,dce574f2f8283a45c76d37773fe49bf2c04320cf91af3d9917bfd47926340c4f
797,bc1qz6lks9udfn78vx3cju9uyc6kqk6739hndak4ct,784,783749,783749,2022-12-26 20:55:08,2022-12-26 19:27:29,0,inbound,dce574f2f8283a45c76d37773fe49bf2c04320cf91af3d9917bfd47926340c4f
798,bc1qz6lks9udfn78vx3cju9uyc6kqk6739hndak4ct,948,402777,0,2022-12-23 12:52:47,2022-12-23 12:52:47,402777,inbound,dce574f2f8283a45c76d37773fe49bf2c04320cf91af3d9917bfd47926340c4f
799,bc1qz6lks9udfn78vx3cju9uyc6kqk6739hndak4ct,1250,3118000,3118000,2022-12-19 00:54:41,2022-12-18 18:56:48,0,inbound,dce574f2f8283a45c76d37773fe49bf2c04320cf91af3d9917bfd47926340c4f
800,bc1qz6lks9udfn78vx3cju9uyc6kqk6739hndak4ct,1737,16174000,16174000,2022-12-22 20:22:55,2022-11-23 23:35:06,0,inbound,dce574f2f8283a45c76d37773fe49bf2c04320cf91af3d9917bfd47926340c4f
801,bc1qz6lks9udfn78vx3cju9uyc6kqk6739hndak4ct,87,119439,119439,2023-01-26 03:37:50,2023-01-26 01:25:02,0,inbound,95818e024a3165fc2b8ddaed0e2a269bd3bbb192aba98b38d823f75c484feff6
802,bc1qz6lks9udfn78vx3cju9uyc6kqk6739hndak4ct,88,3817355,3817355,2023-03-20 03:31:44,2023-01-24 04:52:42,0,inbound,95818e024a3165fc2b8ddaed0e2a269bd3bbb192aba98b38d823f75c484feff6
803,bc1qz6lks9udfn78vx3cju9uyc6kqk6739hndak4ct,89,7336497,7336497,2023-01-26 05:36:48,2023-01-26 01:25:02,0,inbound,95818e024a3165fc2b8ddaed0e2a269bd3bbb192aba98b38d823f75c484feff6
804,bc1qz6lks9udfn78vx3cju9uyc6kqk6739hndak4ct,90,47339701,47339701,2023-01-26 02:48:25,2023-01-26 01:25:02,0,inbound,95818e024a3165fc2b8ddaed0e2a269bd3bbb192aba98b38d823f75c484feff6
805,bc1qz6lks9udfn78vx3cju9uyc6kqk6739hndak4ct,91,1663075,1663075,2023-02-01 15:13:41,2023-01-22 17:57:11,0,inbound,95818e024a3165fc2b8ddaed0e2a269bd3bbb192aba98b38d823f75c484feff6
806,bc1qz6lks9udfn78vx3cju9uyc6kqk6739hndak4ct,391,3131511533,3131511533,2023-01-10 18:16:19,2021-06-03 18:49:04,0,inbound,95818e024a3165fc2b8ddaed0e2a269bd3bbb192aba98b38d823f75c484feff6
807,bc1qz6lks9udfn78vx3cju9uyc6kqk6739hndak4ct,392,11506390000,11506390000,2022-12-30 21:49:14,2022-12-28 14:42:47,0,inbound,95818e024a3165fc2b8ddaed0e2a269bd3bbb192aba98b38d823f75c484feff6
808,bc1qz6lks9udfn78vx3cju9uyc6kqk6739hndak4ct,393,30519282,30519282,2023-04-04 17:50:17,2022-10-15 02:40:43,0,inbound,95818e024a3165fc2b8ddaed0e2a269bd3bbb192aba98b38d823f75c484feff6
809,bc1qz6lks9udfn78vx3cju9uyc6kqk6739hndak4ct,394,1730000,1730000,2023-01-03 11:12:45,2022-12-30 01:36:46,0,inbound,95818e024a3165fc2b8ddaed0e2a269bd3bbb192aba98b38d823f75c484feff6
810,bc1qz6lks9udfn78vx3cju9uyc6kqk6739hndak4ct,395,980000,0,2022-12-29 23:00:35,2022-12-29 23:00:35,980000,inbound,95818e024a3165fc2b8ddaed0e2a269bd3bbb192aba98b38d823f75c484feff6
811,bc1qz6lks9udfn78vx3cju9uyc6kqk6739hndak4ct,554,175933,175933,2022-12-28 22:05:29,2022-12-28 21:55:38,0,inbound,95818e024a3165fc2b8ddaed0e2a269bd3bbb192aba98b38d823f75c484feff6
812,bc1qz6lks9udfn78vx3cju9uyc6kqk6739hndak4ct,555,159761943,158038547,2023-04-07 20:45:30,2022-11-29 21:06:32,1723396,inbound,95818e024a3165fc2b8ddaed0e2a269bd3bbb192aba98b38d823f75c484feff6
813,bc1qz6lks9udfn78vx3cju9uyc6kqk6739hndak4ct,556,3517448,3517448,2022-12-29 18:43:46,2022-12-28 21:55:38,0,inbound,95818e024a3165fc2b8ddaed0e2a269bd3bbb192aba98b38d823f75c484feff6
814,bc1qz6lks9udfn78vx3cju9uyc6kqk6739hndak4ct,557,54760892,54760892,2023-04-07 20:51:56,2023-02-12 20:31:23,0,outbound,95818e024a3165fc2b8ddaed0e2a269bd3bbb192aba98b38d823f75c484feff6
815,bc1qz6lks9udfn78vx3cju9uyc6kqk6739hndak4ct,558,150955156,150955156,2023-02-12 02:47:16,2023-01-07 19:13:19,0,inbound,95818e024a3165fc2b8ddaed0e2a269bd3bbb192aba98b38d823f75c484feff6
816,bc1qz6lks9udfn78vx3cju9uyc6kqk6739hndak4ct,785,1005043,1005043,2022-12-28 20:07:26,2022-12-26 19:27:29,0,inbound,95818e024a3165fc2b8ddaed0e2a269bd3bbb192aba98b38d823f75c484feff6
817,bc1qz6lks9udfn78vx3cju9uyc6kqk6739hndak4ct,786,1424916,1424916,2022-12-27 14:26:58,2022-12-26 19:27:29,0,inbound,95818e024a3165fc2b8ddaed0e2a269bd3bbb192aba98b38d823f75c484feff6
818,bc1qz6lks9udfn78vx3cju9uyc6kqk6739hndak4ct,787,277069,277069,2022-12-27 18:02:25,2022-12-26 19:27:29,0,inbound,95818e024a3165fc2b8ddaed0e2a269bd3bbb192aba98b38d823f75c484feff6
819,bc1qz6lks9udfn78vx3cju9uyc6kqk6739hndak4ct,788,19800711,19292776,2023-03-31 05:11:43,2023-02-02 06:02:23,507935,outbound,95818e024a3165fc2b8ddaed0e2a269bd3bbb192aba98b38d823f75c484feff6
820,bc1qz6lks9udfn78vx3cju9uyc6kqk6739hndak4ct,789,57400457,57400457,2023-03-31 16:03:19,2021-12-11 01:41:54,0,inbound,95818e024a3165fc2b8ddaed0e2a269bd3bbb192aba98b38d823f75c484feff6
821,bc1qz6lks9udfn78vx3cju9uyc6kqk6739hndak4ct,949,8162176,8162176,2022-12-25 15:15:01,2022-12-23 12:52:47,0,inbound,95818e024a3165fc2b8ddaed0e2a269bd3bbb192aba98b38d823f75c484feff6
822,bc1qz6lks9udfn78vx3cju9uyc6kqk6739hndak4ct,950,225886638,225880543,2023-04-10 13:47:39,2023-01-14 02:22:11,6095,inbound,95818e024a3165fc2b8ddaed0e2a269bd3bbb192aba98b38d823f75c484feff6
823,bc1qz6lks9udfn78vx3cju9uyc6kqk6739hndak4ct,951,44825682065422,44822100825422,2023-04-10 16:10:31,2023-04-08 00:41:47,3581240000,outbound,95818e024a3165fc2b8ddaed0e2a269bd3bbb192aba98b38d823f75c484feff6
824,bc1qz6lks9udfn78vx3cju9uyc6kqk6739hndak4ct,952,49621838,49621838,2022-12-27 15:38:48,2022-12-23 12:52:47,0,inbound,95818e024a3165fc2b8ddaed0e2a269bd3bbb192aba98b38d823f75c484feff6
825,bc1qz6lks9udfn78vx3cju9uyc6kqk6739hndak4ct,953,54016864,0,2022-12-23 12:52:47,2022-12-23 12:52:47,54016864,inbound,95818e024a3165fc2b8ddaed0e2a269bd3bbb192aba98b38d823f75c484feff6
826,bc1qz6lks9udfn78vx3cju9uyc6kqk6739hndak4ct,1251,3817300,0,2022-12-18 18:56:48,2022-12-18 18:56:48,3817300,inbound,95818e024a3165fc2b8ddaed0e2a269bd3bbb192aba98b38d823f75c484feff6
827,bc1qz6lks9udfn78vx3cju9uyc6kqk6739hndak4ct,1252,38092801,38092801,2023-03-28 19:29:17,2022-10-05 13:22:44,0,inbound,95818e024a3165fc2b8ddaed0e2a269bd3bbb192aba98b38d823f75c484feff6
828,bc1qz6lks9udfn78vx3cju9uyc6kqk6739hndak4ct,1253,6445745,0,2023-02-13 12:40:58,2022-12-18 18:59:57,6445745,inbound,95818e024a3165fc2b8ddaed0e2a269bd3bbb192aba98b38d823f75c484feff6
829,bc1qz6lks9udfn78vx3cju9uyc6kqk6739hndak4ct,1254,1867801,1867801,2022-12-21 11:15:47,2022-12-18 18:56:48,0,inbound,95818e024a3165fc2b8ddaed0e2a269bd3bbb192aba98b38d823f75c484feff6
830,bc1qz6lks9udfn78vx3cju9uyc6kqk6739hndak4ct,1255,3095484,0,2022-12-18 18:56:48,2022-12-18 18:56:48,3095484,inbound,95818e024a3165fc2b8ddaed0e2a269bd3bbb192aba98b38d823f75c484feff6
831,bc1qz6lks9udfn78vx3cju9uyc6kqk6739hndak4ct,1738,1127000,1127000,2022-12-11 12:28:36,2022-12-11 12:24:09,0,inbound,95818e024a3165fc2b8ddaed0e2a269bd3bbb192aba98b38d823f75c484feff6
832,bc1qz6lks9udfn78vx3cju9uyc6kqk6739hndak4ct,1739,12794096,12782200,2023-03-13 20:09:26,2022-08-28 14:51:06,11896,inbound,95818e024a3165fc2b8ddaed0e2a269bd3bbb192aba98b38d823f75c484feff6
833,bc1qz6lks9udfn78vx3cju9uyc6kqk6739hndak4ct,1740,28309119,28309119,2023-01-28 17:58:31,2022-09-23 11:27:50,0,inbound,95818e024a3165fc2b8ddaed0e2a269bd3bbb192aba98b38d823f75c484feff6
834,bc1qz6lks9udfn78vx3cju9uyc6kqk6739hndak4ct,1741,126119030,126119030,2023-02-19 12:31:09,2022-10-19 02:37:00,0,inbound,95818e024a3165fc2b8ddaed0e2a269bd3bbb192aba98b38d823f75c484feff6
835,bc1qz6lks9udfn78vx3cju9uyc6kqk6739hndak4ct,1742,158565123,158565123,2023-01-13 10:07:01,2022-11-16 07:00:16,0,inbound,95818e024a3165fc2b8ddaed0e2a269bd3bbb192aba98b38d823f75c484feff6
836,bc1qz6lks9udfn78vx3cju9uyc6kqk6739hndak4ct,92,470804509,470804509,2023-02-11 17:58:02,2023-02-01 17:02:09,0,inbound,67af70604a7ba416de056a38623ff4eb8ab7c283462242468b05f8aff3cf2cf1
837,bc1qz6lks9udfn78vx3cju9uyc6kqk6739hndak4ct,93,406075,406075,2023-01-24 09:50:34,2023-01-22 17:57:11,0,inbound,67af70604a7ba416de056a38623ff4eb8ab7c283462242468b05f8aff3cf2cf1
838,bc1qz6lks9udfn78vx3cju9uyc6kqk6739hndak4ct,94,11981129,11981129,2023-03-30 23:08:44,2022-11-19 03:01:08,0,inbound,67af70604a7ba416de056a38623ff4eb8ab7c283462242468b05f8aff3cf2cf1
839,bc1qz6lks9udfn78vx3cju9uyc6kqk6739hndak4ct,95,168626258,158995131,2023-04-09 14:02:59,2023-04-10 00:50:08,9631127,inbound,67af70604a7ba416de056a38623ff4eb8ab7c283462242468b05f8aff3cf2cf1
840,bc1qz6lks9udfn78vx3cju9uyc6kqk6739hndak4ct,96,153569,153569,2023-01-31 00:51:39,2023-01-22 17:57:11,0,inbound,67af70604a7ba416de056a38623ff4eb8ab7c283462242468b05f8aff3cf2cf1
841,bc1qz6lks9udfn78vx3cju9uyc6kqk6739hndak4ct,97,242326,242326,2023-02-10 16:11:38,2023-01-22 17:57:11,0,inbound,67af70604a7ba416de056a38623ff4eb8ab7c283462242468b05f8aff3cf2cf1
842,bc1qz6lks9udfn78vx3cju9uyc6kqk6739hndak4ct,98,188426607,188426607,2023-04-06 18:02:16,2022-11-13 00:01:44,0,outbound,67af70604a7ba416de056a38623ff4eb8ab7c283462242468b05f8aff3cf2cf1
843,bc1qz6lks9udfn78vx3cju9uyc6kqk6739hndak4ct,99,647511898,647511898,2023-04-09 06:11:13,2022-04-15 14:48:10,0,outbound,67af70604a7ba416de056a38623ff4eb8ab7c283462242468b05f8aff3cf2cf1
844,bc1qz6lks9udfn78vx3cju9uyc6kqk6739hndak4ct,100,547571909,547571909,2023-04-08 02:09:17,2023-03-17 07:32:06,0,inbound,67af70604a7ba416de056a38623ff4eb8ab7c283462242468b05f8aff3cf2cf1
845,bc1qz6lks9udfn78vx3cju9uyc6kqk6739hndak4ct,101,312651,312651,2023-01-23 00:03:32,2023-01-22 17:57:11,0,inbound,67af70604a7ba416de056a38623ff4eb8ab7c283462242468b05f8aff3cf2cf1
846,bc1qz6lks9udfn78vx3cju9uyc6kqk6739hndak4ct,102,653108,653108,2023-01-22 23:04:34,2023-01-07 11:44:11,0,inbound,67af70604a7ba416de056a38623ff4eb8ab7c283462242468b05f8aff3cf2cf1
847,bc1qz6lks9udfn78vx3cju9uyc6kqk6739hndak4ct,103,65124,65124,2023-02-20 21:17:15,2023-01-22 17:57:11,0,inbound,67af70604a7ba416de056a38623ff4eb8ab7c283462242468b05f8aff3cf2cf1
848,bc1qz6lks9udfn78vx3cju9uyc6kqk6739hndak4ct,104,1243254,1243254,2023-01-23 00:03:34,2023-01-22 17:57:11,0,inbound,67af70604a7ba416de056a38623ff4eb8ab7c283462242468b05f8aff3cf2cf1
849,bc1qz6lks9udfn78vx3cju9uyc6kqk6739hndak4ct,105,108389,108389,2023-01-22 18:00:38,2023-01-22 17:57:11,0,inbound,67af70604a7ba416de056a38623ff4eb8ab7c283462242468b05f8aff3cf2cf1
850,bc1qz6lks9udfn78vx3cju9uyc6kqk6739hndak4ct,106,774466,774466,2023-01-22 18:24:53,2023-01-22 17:57:11,0,inbound,67af70604a7ba416de056a38623ff4eb8ab7c283462242468b05f8aff3cf2cf1
851,bc1qz6lks9udfn78vx3cju9uyc6kqk6739hndak4ct,107,1433387,0,2023-01-22 17:57:11,2023-01-22 17:57:11,1433387,inbound,67af70604a7ba416de056a38623ff4eb8ab7c283462242468b05f8aff3cf2cf1
852,bc1qz6lks9udfn78vx3cju9uyc6kqk6739hndak4ct,108,620675,620675,2023-01-24 09:07:59,2023-01-22 17:57:11,0,inbound,67af70604a7ba416de056a38623ff4eb8ab7c283462242468b05f8aff3cf2cf1
853,bc1qz6lks9udfn78vx3cju9uyc6kqk6739hndak4ct,109,337569,337569,2023-01-22 18:03:49,2023-01-22 17:57:11,0,inbound,67af70604a7ba416de056a38623ff4eb8ab7c283462242468b05f8aff3cf2cf1
854,bc1qz6lks9udfn78vx3cju9uyc6kqk6739hndak4ct,110,487006369,487006369,2023-01-25 13:31:40,2022-09-20 02:09:08,0,inbound,67af70604a7ba416de056a38623ff4eb8ab7c283462242468b05f8aff3cf2cf1
855,bc1qz6lks9udfn78vx3cju9uyc6kqk6739hndak4ct,111,38500582,38500582,2023-02-09 18:02:28,2022-12-06 06:39:19,0,inbound,67af70604a7ba416de056a38623ff4eb8ab7c283462242468b05f8aff3cf2cf1
856,bc1qz6lks9udfn78vx3cju9uyc6kqk6739hndak4ct,112,131996,131996,2023-01-27 18:02:30,2023-01-22 17:57:11,0,inbound,67af70604a7ba416de056a38623ff4eb8ab7c283462242468b05f8aff3cf2cf1
857,bc1qz6lks9udfn78vx3cju9uyc6kqk6739hndak4ct,113,479875,479875,2023-01-24 09:08:08,2023-01-22 17:57:11,0,inbound,67af70604a7ba416de056a38623ff4eb8ab7c283462242468b05f8aff3cf2cf1
858,bc1qz6lks9udfn78vx3cju9uyc6kqk6739hndak4ct,114,436000,436000,2023-01-30 23:12:42,2023-01-22 17:57:11,0,inbound,67af70604a7ba416de056a38623ff4eb8ab7c283462242468b05f8aff3cf2cf1
859,bc1qz6lks9udfn78vx3cju9uyc6kqk6739hndak4ct,115,392336,392336,2023-01-23 18:27:31,2023-01-22 17:57:11,0,inbound,67af70604a7ba416de056a38623ff4eb8ab7c283462242468b05f8aff3cf2cf1
860,bc1qz6lks9udfn78vx3cju9uyc6kqk6739hndak4ct,116,99996350,0,2023-01-22 17:57:11,2023-01-22 17:57:11,99996350,inbound,67af70604a7ba416de056a38623ff4eb8ab7c283462242468b05f8aff3cf2cf1
861,bc1qz6lks9udfn78vx3cju9uyc6kqk6739hndak4ct,117,1291396,1291396,2023-02-18 11:20:43,2023-01-22 17:57:11,0,inbound,67af70604a7ba416de056a38623ff4eb8ab7c283462242468b05f8aff3cf2cf1
862,bc1qz6lks9udfn78vx3cju9uyc6kqk6739hndak4ct,118,487947,487947,2023-01-24 09:08:03,2023-01-22 17:57:11,0,inbound,67af70604a7ba416de056a38623ff4eb8ab7c283462242468b05f8aff3cf2cf1
863,bc1qz6lks9udfn78vx3cju9uyc6kqk6739hndak4ct,119,20106073,20106073,2023-04-07 11:24:17,2022-11-11 12:07:08,0,inbound,67af70604a7ba416de056a38623ff4eb8ab7c283462242468b05f8aff3cf2cf1
864,bc1qz6lks9udfn78vx3cju9uyc6kqk6739hndak4ct,120,38334,0,2023-01-22 17:57:11,2023-01-22 17:57:11,38334,inbound,67af70604a7ba416de056a38623ff4eb8ab7c283462242468b05f8aff3cf2cf1
865,bc1qz6lks9udfn78vx3cju9uyc6kqk6739hndak4ct,121,1338002,1338002,2023-01-23 14:17:37,2023-01-20 19:40:10,0,inbound,67af70604a7ba416de056a38623ff4eb8ab7c283462242468b05f8aff3cf2cf1
866,bc1qz6lks9udfn78vx3cju9uyc6kqk6739hndak4ct,122,286863455,286327101,2023-04-05 13:24:09,2022-04-14 09:52:56,536354,inbound,67af70604a7ba416de056a38623ff4eb8ab7c283462242468b05f8aff3cf2cf1
867,bc1qz6lks9udfn78vx3cju9uyc6kqk6739hndak4ct,123,222654,222654,2023-01-23 00:03:31,2023-01-22 17:57:11,0,inbound,67af70604a7ba416de056a38623ff4eb8ab7c283462242468b05f8aff3cf2cf1
868,bc1qz6lks9udfn78vx3cju9uyc6kqk6739hndak4ct,124,135167,135167,2023-01-23 00:03:30,2023-01-22 17:57:11,0,inbound,67af70604a7ba416de056a38623ff4eb8ab7c283462242468b05f8aff3cf2cf1
869,bc1qz6lks9udfn78vx3cju9uyc6kqk6739hndak4ct,125,155272,155272,2023-01-23 07:12:37,2023-01-22 17:57:11,0,inbound,67af70604a7ba416de056a38623ff4eb8ab7c283462242468b05f8aff3cf2cf1
870,bc1qz6lks9udfn78vx3cju9uyc6kqk6739hndak4ct,126,1243248,1218170,2023-04-01 10:53:21,2023-01-22 17:57:11,25078,inbound,67af70604a7ba416de056a38623ff4eb8ab7c283462242468b05f8aff3cf2cf1
871,bc1qz6lks9udfn78vx3cju9uyc6kqk6739hndak4ct,127,1336324,1336324,2023-01-26 03:20:41,2023-01-22 17:57:11,0,inbound,67af70604a7ba416de056a38623ff4eb8ab7c283462242468b05f8aff3cf2cf1
872,bc1qz6lks9udfn78vx3cju9uyc6kqk6739hndak4ct,128,7090178,7090178,2023-03-13 07:45:42,2022-12-16 06:05:08,0,inbound,67af70604a7ba416de056a38623ff4eb8ab7c283462242468b05f8aff3cf2cf1
873,bc1qz6lks9udfn78vx3cju9uyc6kqk6739hndak4ct,129,5321907,5321907,2023-02-13 04:52:26,2022-12-20 23:28:09,0,inbound,67af70604a7ba416de056a38623ff4eb8ab7c283462242468b05f8aff3cf2cf1
874,bc1qz6lks9udfn78vx3cju9uyc6kqk6739hndak4ct,130,36617871,0,2023-01-22 17:57:11,2023-01-19 17:40:09,36617871,inbound,67af70604a7ba416de056a38623ff4eb8ab7c283462242468b05f8aff3cf2cf1
875,bc1qz6lks9udfn78vx3cju9uyc6kqk6739hndak4ct,131,471936,471936,2023-01-23 15:03:40,2023-01-22 17:57:11,0,inbound,67af70604a7ba416de056a38623ff4eb8ab7c283462242468b05f8aff3cf2cf1
876,bc1qz6lks9udfn78vx3cju9uyc6kqk6739hndak4ct,132,282716,282716,2023-01-23 03:18:19,2023-01-22 17:57:11,0,inbound,67af70604a7ba416de056a38623ff4eb8ab7c283462242468b05f8aff3cf2cf1
877,bc1qz6lks9udfn78vx3cju9uyc6kqk6739hndak4ct,133,915929,915929,2023-01-22 18:35:14,2023-01-22 17:57:11,0,inbound,67af70604a7ba416de056a38623ff4eb8ab7c283462242468b05f8aff3cf2cf1
878,bc1qz6lks9udfn78vx3cju9uyc6kqk6739hndak4ct,134,4237347,4237347,2023-01-23 00:00:44,2020-05-11 03:13:42,0,inbound,67af70604a7ba416de056a38623ff4eb8ab7c283462242468b05f8aff3cf2cf1
879,bc1qz6lks9udfn78vx3cju9uyc6kqk6739hndak4ct,135,770375,770375,2023-04-01 10:09:10,2023-01-22 17:57:11,0,inbound,67af70604a7ba416de056a38623ff4eb8ab7c283462242468b05f8aff3cf2cf1
880,bc1qz6lks9udfn78vx3cju9uyc6kqk6739hndak4ct,136,9637292,0,2023-01-22 17:57:11,2023-01-22 17:57:11,9637292,inbound,67af70604a7ba416de056a38623ff4eb8ab7c283462242468b05f8aff3cf2cf1
881,bc1qz6lks9udfn78vx3cju9uyc6kqk6739hndak4ct,137,574010,574010,2023-01-23 00:03:24,2022-03-27 21:10:08,0,inbound,67af70604a7ba416de056a38623ff4eb8ab7c283462242468b05f8aff3cf2cf1
882,bc1qz6lks9udfn78vx3cju9uyc6kqk6739hndak4ct,138,2460758,2460758,2023-04-04 12:04:36,2022-10-19 21:20:31,0,inbound,67af70604a7ba416de056a38623ff4eb8ab7c283462242468b05f8aff3cf2cf1
883,bc1qz6lks9udfn78vx3cju9uyc6kqk6739hndak4ct,139,164612,152840,2023-03-21 12:00:49,2023-01-17 02:52:26,11772,inbound,67af70604a7ba416de056a38623ff4eb8ab7c283462242468b05f8aff3cf2cf1
884,bc1qz6lks9udfn78vx3cju9uyc6kqk6739hndak4ct,140,149984,149984,2023-01-24 01:29:29,2023-01-22 17:57:11,0,inbound,67af70604a7ba416de056a38623ff4eb8ab7c283462242468b05f8aff3cf2cf1
885,bc1qz6lks9udfn78vx3cju9uyc6kqk6739hndak4ct,141,165794,165794,2023-01-27 18:02:41,2023-01-22 17:57:11,0,inbound,67af70604a7ba416de056a38623ff4eb8ab7c283462242468b05f8aff3cf2cf1
886,bc1qz6lks9udfn78vx3cju9uyc6kqk6739hndak4ct,142,662186,662186,2023-01-23 00:03:34,2023-01-22 17:57:11,0,inbound,67af70604a7ba416de056a38623ff4eb8ab7c283462242468b05f8aff3cf2cf1
887,bc1qz6lks9udfn78vx3cju9uyc6kqk6739hndak4ct,143,2604269,2604269,2023-01-23 01:20:36,2023-01-09 17:18:18,0,inbound,67af70604a7ba416de056a38623ff4eb8ab7c283462242468b05f8aff3cf2cf1
888,bc1qz6lks9udfn78vx3cju9uyc6kqk6739hndak4ct,144,45065346,44148791,2023-04-09 14:00:07,2023-02-25 03:08:07,916555,inbound,67af70604a7ba416de056a38623ff4eb8ab7c283462242468b05f8aff3cf2cf1
889,bc1qz6lks9udfn78vx3cju9uyc6kqk6739hndak4ct,145,52210,0,2023-01-22 17:57:11,2023-01-22 17:57:11,52210,inbound,67af70604a7ba416de056a38623ff4eb8ab7c283462242468b05f8aff3cf2cf1
890,bc1qz6lks9udfn78vx3cju9uyc6kqk6739hndak4ct,146,2036595,2036595,2023-02-01 15:13:41,2023-01-22 17:57:11,0,inbound,67af70604a7ba416de056a38623ff4eb8ab7c283462242468b05f8aff3cf2cf1
891,bc1qz6lks9udfn78vx3cju9uyc6kqk6739hndak4ct,147,38294053,38294053,2023-02-19 08:43:59,2022-12-30 02:57:07,0,inbound,67af70604a7ba416de056a38623ff4eb8ab7c283462242468b05f8aff3cf2cf1
892,bc1qz6lks9udfn78vx3cju9uyc6kqk6739hndak4ct,148,222704,222704,2023-01-23 03:56:51,2023-01-22 17:57:11,0,inbound,67af70604a7ba416de056a38623ff4eb8ab7c283462242468b05f8aff3cf2cf1
893,bc1qz6lks9udfn78vx3cju9uyc6kqk6739hndak4ct,149,1052226,1052226,2023-01-22 20:00:12,2023-01-22 17:57:11,0,inbound,67af70604a7ba416de056a38623ff4eb8ab7c283462242468b05f8aff3cf2cf1
894,bc1qz6lks9udfn78vx3cju9uyc6kqk6739hndak4ct,150,2147087,2147087,2023-02-09 11:11:37,2023-01-13 17:24:46,0,inbound,67af70604a7ba416de056a38623ff4eb8ab7c283462242468b05f8aff3cf2cf1
895,bc1qz6lks9udfn78vx3cju9uyc6kqk6739hndak4ct,396,1027335,1027335,2022-12-29 23:05:14,2022-12-29 23:00:35,0,inbound,67af70604a7ba416de056a38623ff4eb8ab7c283462242468b05f8aff3cf2cf1
896,bc1qz6lks9udfn78vx3cju9uyc6kqk6739hndak4ct,397,14630061,2218269,2023-03-13 17:43:39,2022-11-27 19:47:08,12411792,inbound,67af70604a7ba416de056a38623ff4eb8ab7c283462242468b05f8aff3cf2cf1
897,bc1qz6lks9udfn78vx3cju9uyc6kqk6739hndak4ct,398,800880,800880,2022-12-29 00:02:19,2022-10-18 20:54:25,0,inbound,67af70604a7ba416de056a38623ff4eb8ab7c283462242468b05f8aff3cf2cf1
898,bc1qz6lks9udfn78vx3cju9uyc6kqk6739hndak4ct,399,21569439,2974660,2023-03-24 07:33:11,2022-11-13 22:11:51,18594779,inbound,67af70604a7ba416de056a38623ff4eb8ab7c283462242468b05f8aff3cf2cf1
899,bc1qz6lks9udfn78vx3cju9uyc6kqk6739hndak4ct,400,189592843,189592843,2023-03-30 22:02:31,2022-07-12 21:53:41,0,inbound,67af70604a7ba416de056a38623ff4eb8ab7c283462242468b05f8aff3cf2cf1
900,bc1qz6lks9udfn78vx3cju9uyc6kqk6739hndak4ct,401,1269505605015524,1269367624567490,2023-04-10 04:01:25,2023-04-10 02:35:25,137980448034,outbound,67af70604a7ba416de056a38623ff4eb8ab7c283462242468b05f8aff3cf2cf1
901,bc1qz6lks9udfn78vx3cju9uyc6kqk6739hndak4ct,402,149002,149002,2023-01-03 18:57:47,2022-12-28 21:55:38,0,inbound,67af70604a7ba416de056a38623ff4eb8ab7c283462242468b05f8aff3cf2cf1
902,bc1qz6lks9udfn78vx3cju9uyc6kqk6739hndak4ct,403,51262080,50822080,2023-04-10 00:49:28,2023-01-17 09:04:23,440000,outbound,67af70604a7ba416de056a38623ff4eb8ab7c283462242468b05f8aff3cf2cf1
903,bc1qz6lks9udfn78vx3cju9uyc6kqk6739hndak4ct,404,84250368,84250368,2023-04-05 22:22:10,2022-11-09 21:15:37,0,inbound,67af70604a7ba416de056a38623ff4eb8ab7c283462242468b05f8aff3cf2cf1
904,bc1qz6lks9udfn78vx3cju9uyc6kqk6739hndak4ct,405,63473,63473,2022-12-29 00:02:13,2022-12-28 21:55:38,0,inbound,67af70604a7ba416de056a38623ff4eb8ab7c283462242468b05f8aff3cf2cf1
905,bc1qz6lks9udfn78vx3cju9uyc6kqk6739hndak4ct,406,151465,151465,2022-12-29 08:56:16,2022-12-28 21:55:38,0,inbound,67af70604a7ba416de056a38623ff4eb8ab7c283462242468b05f8aff3cf2cf1
906,bc1qz6lks9udfn78vx3cju9uyc6kqk6739hndak4ct,407,847252,847252,2022-12-29 00:10:17,2022-12-28 21:55:38,0,inbound,67af70604a7ba416de056a38623ff4eb8ab7c283462242468b05f8aff3cf2cf1
907,bc1qz6lks9udfn78vx3cju9uyc6kqk6739hndak4ct,408,484557,484557,2022-12-29 04:14:57,2022-12-28 21:55:38,0,inbound,67af70604a7ba416de056a38623ff4eb8ab7c283462242468b05f8aff3cf2cf1
908,bc1qz6lks9udfn78vx3cju9uyc6kqk6739hndak4ct,409,87068,87068,2022-12-29 00:00:48,2022-12-28 21:55:38,0,inbound,67af70604a7ba416de056a38623ff4eb8ab7c283462242468b05f8aff3cf2cf1
909,bc1qz6lks9udfn78vx3cju9uyc6kqk6739hndak4ct,410,38936,38936,2022-12-29 01:51:16,2022-12-28 21:55:38,0,inbound,67af70604a7ba416de056a38623ff4eb8ab7c283462242468b05f8aff3cf2cf1
910,bc1qz6lks9udfn78vx3cju9uyc6kqk6739hndak4ct,411,282519,282519,2022-12-29 00:02:20,2022-12-28 21:55:38,0,inbound,67af70604a7ba416de056a38623ff4eb8ab7c283462242468b05f8aff3cf2cf1
911,bc1qz6lks9udfn78vx3cju9uyc6kqk6739hndak4ct,412,698775,698775,2022-12-31 22:00:25,2022-12-28 21:55:38,0,inbound,67af70604a7ba416de056a38623ff4eb8ab7c283462242468b05f8aff3cf2cf1
912,bc1qz6lks9udfn78vx3cju9uyc6kqk6739hndak4ct,413,63454,63454,2022-12-29 00:02:58,2022-12-28 21:55:38,0,inbound,67af70604a7ba416de056a38623ff4eb8ab7c283462242468b05f8aff3cf2cf1
913,bc1qz6lks9udfn78vx3cju9uyc6kqk6739hndak4ct,414,312113,312113,2022-12-29 05:01:37,2022-12-28 21:55:38,0,inbound,67af70604a7ba416de056a38623ff4eb8ab7c283462242468b05f8aff3cf2cf1
914,bc1qz6lks9udfn78vx3cju9uyc6kqk6739hndak4ct,415,163578,163578,2023-01-07 22:43:28,2022-12-28 21:55:38,0,inbound,67af70604a7ba416de056a38623ff4eb8ab7c283462242468b05f8aff3cf2cf1
915,bc1qz6lks9udfn78vx3cju9uyc6kqk6739hndak4ct,416,282610,282610,2022-12-29 03:34:15,2022-12-28 21:55:38,0,inbound,67af70604a7ba416de056a38623ff4eb8ab7c283462242468b05f8aff3cf2cf1
916,bc1qz6lks9udfn78vx3cju9uyc6kqk6739hndak4ct,417,732250282,732229922,2023-04-06 13:26:17,2022-12-12 22:44:31,20360,inbound,67af70604a7ba416de056a38623ff4eb8ab7c283462242468b05f8aff3cf2cf1
917,bc1qz6lks9udfn78vx3cju9uyc6kqk6739hndak4ct,418,1173567,1173567,2022-12-31 22:00:25,2022-12-28 21:55:38,0,inbound,67af70604a7ba416de056a38623ff4eb8ab7c283462242468b05f8aff3cf2cf1
918,bc1qz6lks9udfn78vx3cju9uyc6kqk6739hndak4ct,419,88289091,88264218,2023-04-09 19:41:35,2023-02-06 05:20:54,24873,outbound,67af70604a7ba416de056a38623ff4eb8ab7c283462242468b05f8aff3cf2cf1
919,bc1qz6lks9udfn78vx3cju9uyc6kqk6739hndak4ct,420,1766170,1766170,2022-12-29 07:40:05,2022-12-28 21:55:38,0,inbound,67af70604a7ba416de056a38623ff4eb8ab7c283462242468b05f8aff3cf2cf1
920,bc1qz6lks9udfn78vx3cju9uyc6kqk6739hndak4ct,421,524940461,524940461,2023-03-13 09:08:19,2023-02-21 21:15:03,0,outbound,67af70604a7ba416de056a38623ff4eb8ab7c283462242468b05f8aff3cf2cf1
921,bc1qz6lks9udfn78vx3cju9uyc6kqk6739hndak4ct,422,14178915,14178915,2023-03-30 14:03:34,2023-01-06 21:22:11,0,outbound,67af70604a7ba416de056a38623ff4eb8ab7c283462242468b05f8aff3cf2cf1
922,bc1qz6lks9udfn78vx3cju9uyc6kqk6739hndak4ct,423,183682989,129839376,2023-04-05 16:30:23,2022-05-09 12:28:14,53843613,inbound,67af70604a7ba416de056a38623ff4eb8ab7c283462242468b05f8aff3cf2cf1
923,bc1qz6lks9udfn78vx3cju9uyc6kqk6739hndak4ct,559,227017753,227017753,2022-12-29 01:54:59,2022-12-28 21:55:38,0,inbound,67af70604a7ba416de056a38623ff4eb8ab7c283462242468b05f8aff3cf2cf1
924,bc1qz6lks9udfn78vx3cju9uyc6kqk6739hndak4ct,560,41226661,40900569,2023-04-10 08:26:00,2023-01-02 09:32:52,326092,inbound,67af70604a7ba416de056a38623ff4eb8ab7c283462242468b05f8aff3cf2cf1
925,bc1qz6lks9udfn78vx3cju9uyc6kqk6739hndak4ct,561,787763,787763,2022-12-28 23:13:19,2022-12-28 21:55:38,0,inbound,67af70604a7ba416de056a38623ff4eb8ab7c283462242468b05f8aff3cf2cf1
926,bc1qz6lks9udfn78vx3cju9uyc6kqk6739hndak4ct,562,575434,575434,2022-12-29 06:00:37,2022-12-28 21:55:38,0,inbound,67af70604a7ba416de056a38623ff4eb8ab7c283462242468b05f8aff3cf2cf1
927,bc1qz6lks9udfn78vx3cju9uyc6kqk6739hndak4ct,563,17996018,17996018,2023-04-09 18:01:35,2022-11-12 21:30:36,0,inbound,67af70604a7ba416de056a38623ff4eb8ab7c283462242468b05f8aff3cf2cf1
928,bc1qz6lks9udfn78vx3cju9uyc6kqk6739hndak4ct,564,171593586,171554473,2023-04-10 08:25:59,2022-12-28 21:55:38,39113,inbound,67af70604a7ba416de056a38623ff4eb8ab7c283462242468b05f8aff3cf2cf1
929,bc1qz6lks9udfn78vx3cju9uyc6kqk6739hndak4ct,565,2690781,2690781,2023-01-18 21:01:33,2022-12-28 21:55:38,0,inbound,67af70604a7ba416de056a38623ff4eb8ab7c283462242468b05f8aff3cf2cf1
930,bc1qz6lks9udfn78vx3cju9uyc6kqk6739hndak4ct,566,140200,140200,2022-12-29 00:05:10,2022-12-28 21:55:38,0,inbound,67af70604a7ba416de056a38623ff4eb8ab7c283462242468b05f8aff3cf2cf1
931,bc1qz6lks9udfn78vx3cju9uyc6kqk6739hndak4ct,567,28144044,27818253,2023-02-19 03:01:20,2021-08-20 07:42:39,325791,outbound,67af70604a7ba416de056a38623ff4eb8ab7c283462242468b05f8aff3cf2cf1
932,bc1qz6lks9udfn78vx3cju9uyc6kqk6739hndak4ct,568,12275063,12275063,2023-02-18 08:06:13,2022-12-28 21:55:38,0,inbound,67af70604a7ba416de056a38623ff4eb8ab7c283462242468b05f8aff3cf2cf1
933,bc1qz6lks9udfn78vx3cju9uyc6kqk6739hndak4ct,569,1306363147,1306363147,2023-04-10 06:29:18,2023-03-13 04:06:04,0,inbound,67af70604a7ba416de056a38623ff4eb8ab7c283462242468b05f8aff3cf2cf1
934,bc1qz6lks9udfn78vx3cju9uyc6kqk6739hndak4ct,570,51599,51599,2022-12-29 16:19:46,2022-12-28 21:55:38,0,inbound,67af70604a7ba416de056a38623ff4eb8ab7c283462242468b05f8aff3cf2cf1
935,bc1qz6lks9udfn78vx3cju9uyc6kqk6739hndak4ct,571,10799570,10799570,2022-12-28 22:16:07,2022-12-28 21:44:05,0,inbound,67af70604a7ba416de056a38623ff4eb8ab7c283462242468b05f8aff3cf2cf1
936,bc1qz6lks9udfn78vx3cju9uyc6kqk6739hndak4ct,572,17912,17912,2022-12-29 03:39:16,2022-12-28 21:55:38,0,inbound,67af70604a7ba416de056a38623ff4eb8ab7c283462242468b05f8aff3cf2cf1
937,bc1qz6lks9udfn78vx3cju9uyc6kqk6739hndak4ct,573,163547,163547,2022-12-29 00:30:43,2022-12-28 21:55:38,0,inbound,67af70604a7ba416de056a38623ff4eb8ab7c283462242468b05f8aff3cf2cf1
938,bc1qz6lks9udfn78vx3cju9uyc6kqk6739hndak4ct,574,208872650,208872650,2023-03-29 07:10:11,2023-02-03 06:03:17,0,outbound,67af70604a7ba416de056a38623ff4eb8ab7c283462242468b05f8aff3cf2cf1
939,bc1qz6lks9udfn78vx3cju9uyc6kqk6739hndak4ct,575,622194097,622194097,2023-04-08 00:01:59,2023-03-22 02:19:36,0,inbound,67af70604a7ba416de056a38623ff4eb8ab7c283462242468b05f8aff3cf2cf1
940,bc1qz6lks9udfn78vx3cju9uyc6kqk6739hndak4ct,576,121235,121235,2023-02-23 10:56:19,2022-12-28 21:55:38,0,inbound,67af70604a7ba416de056a38623ff4eb8ab7c283462242468b05f8aff3cf2cf1
941,bc1qz6lks9udfn78vx3cju9uyc6kqk6739hndak4ct,577,2422453,2422453,2022-12-29 01:26:04,2022-12-28 21:55:38,0,inbound,67af70604a7ba416de056a38623ff4eb8ab7c283462242468b05f8aff3cf2cf1
942,bc1qz6lks9udfn78vx3cju9uyc6kqk6739hndak4ct,578,1029761,1029761,2022-12-30 19:57:39,2022-12-28 21:55:38,0,inbound,67af70604a7ba416de056a38623ff4eb8ab7c283462242468b05f8aff3cf2cf1
943,bc1qz6lks9udfn78vx3cju9uyc6kqk6739hndak4ct,579,605157,605157,2023-02-26 15:50:49,2022-09-14 17:43:25,0,inbound,67af70604a7ba416de056a38623ff4eb8ab7c283462242468b05f8aff3cf2cf1
944,bc1qz6lks9udfn78vx3cju9uyc6kqk6739hndak4ct,580,181869,181869,2022-12-31 22:00:25,2022-12-28 21:55:38,0,inbound,67af70604a7ba416de056a38623ff4eb8ab7c283462242468b05f8aff3cf2cf1
945,bc1qz6lks9udfn78vx3cju9uyc6kqk6739hndak4ct,581,1458333,1458333,2022-12-29 06:37:38,2022-12-28 21:55:38,0,inbound,67af70604a7ba416de056a38623ff4eb8ab7c283462242468b05f8aff3cf2cf1
946,bc1qz6lks9udfn78vx3cju9uyc6kqk6739hndak4ct,582,2896817,2896817,2022-12-28 23:08:23,2022-12-28 21:55:38,0,inbound,67af70604a7ba416de056a38623ff4eb8ab7c283462242468b05f8aff3cf2cf1
947,bc1qz6lks9udfn78vx3cju9uyc6kqk6739hndak4ct,583,18981136,18981136,2023-01-20 09:05:18,2022-12-09 03:10:34,0,outbound,67af70604a7ba416de056a38623ff4eb8ab7c283462242468b05f8aff3cf2cf1
948,bc1qz6lks9udfn78vx3cju9uyc6kqk6739hndak4ct,584,13241894,11901820,2023-04-10 08:25:53,2023-02-09 10:10:57,1340074,inbound,67af70604a7ba416de056a38623ff4eb8ab7c283462242468b05f8aff3cf2cf1
949,bc1qz6lks9udfn78vx3cju9uyc6kqk6739hndak4ct,585,51587,51587,2022-12-29 00:00:48,2022-12-28 21:55:38,0,inbound,67af70604a7ba416de056a38623ff4eb8ab7c283462242468b05f8aff3cf2cf1
950,bc1qz6lks9udfn78vx3cju9uyc6kqk6739hndak4ct,586,854211,854211,2022-12-29 11:23:53,2022-12-28 21:55:38,0,inbound,67af70604a7ba416de056a38623ff4eb8ab7c283462242468b05f8aff3cf2cf1
951,bc1qz6lks9udfn78vx3cju9uyc6kqk6739hndak4ct,587,333564033,333088962,2023-03-01 00:02:19,2023-03-12 08:02:04,475071,outbound,67af70604a7ba416de056a38623ff4eb8ab7c283462242468b05f8aff3cf2cf1
952,bc1qz6lks9udfn78vx3cju9uyc6kqk6739hndak4ct,588,496260422,496260422,2023-04-10 12:02:17,2023-02-03 16:44:52,0,inbound,67af70604a7ba416de056a38623ff4eb8ab7c283462242468b05f8aff3cf2cf1
953,bc1qz6lks9udfn78vx3cju9uyc6kqk6739hndak4ct,589,3839390,3839390,2023-03-11 18:01:42,2022-12-24 20:50:14,0,inbound,67af70604a7ba416de056a38623ff4eb8ab7c283462242468b05f8aff3cf2cf1
954,bc1qz6lks9udfn78vx3cju9uyc6kqk6739hndak4ct,590,21993332,21993332,2023-03-30 13:53:43,2022-11-22 12:01:19,0,outbound,67af70604a7ba416de056a38623ff4eb8ab7c283462242468b05f8aff3cf2cf1
955,bc1qz6lks9udfn78vx3cju9uyc6kqk6739hndak4ct,591,105258,105258,2022-12-28 23:22:35,2022-12-28 21:55:38,0,inbound,67af70604a7ba416de056a38623ff4eb8ab7c283462242468b05f8aff3cf2cf1
956,bc1qz6lks9udfn78vx3cju9uyc6kqk6739hndak4ct,592,1474027,1474027,2022-12-31 22:00:25,2022-12-28 21:55:38,0,inbound,67af70604a7ba416de056a38623ff4eb8ab7c283462242468b05f8aff3cf2cf1
957,bc1qz6lks9udfn78vx3cju9uyc6kqk6739hndak4ct,593,64626923,64616221,2023-01-20 06:08:12,2022-11-19 04:42:42,10702,outbound,67af70604a7ba416de056a38623ff4eb8ab7c283462242468b05f8aff3cf2cf1
958,bc1qz6lks9udfn78vx3cju9uyc6kqk6739hndak4ct,594,44267,0,2022-12-28 21:55:38,2022-12-28 21:55:38,44267,inbound,67af70604a7ba416de056a38623ff4eb8ab7c283462242468b05f8aff3cf2cf1
959,bc1qz6lks9udfn78vx3cju9uyc6kqk6739hndak4ct,595,1156075,1156075,2023-01-08 06:58:52,2022-12-28 21:55:38,0,inbound,67af70604a7ba416de056a38623ff4eb8ab7c283462242468b05f8aff3cf2cf1
960,bc1qz6lks9udfn78vx3cju9uyc6kqk6739hndak4ct,596,181924,181924,2022-12-31 22:00:25,2022-12-28 21:55:38,0,inbound,67af70604a7ba416de056a38623ff4eb8ab7c283462242468b05f8aff3cf2cf1
961,bc1qz6lks9udfn78vx3cju9uyc6kqk6739hndak4ct,597,505830977,505830977,2023-04-10 06:07:23,2023-03-12 07:43:15,0,inbound,67af70604a7ba416de056a38623ff4eb8ab7c283462242468b05f8aff3cf2cf1
962,bc1qz6lks9udfn78vx3cju9uyc6kqk6739hndak4ct,598,247026,247026,2022-12-29 05:01:35,2022-12-28 21:55:38,0,inbound,67af70604a7ba416de056a38623ff4eb8ab7c283462242468b05f8aff3cf2cf1
963,bc1qz6lks9udfn78vx3cju9uyc6kqk6739hndak4ct,599,1242852,1242852,2023-03-02 11:04:02,2022-12-04 04:03:26,0,inbound,67af70604a7ba416de056a38623ff4eb8ab7c283462242468b05f8aff3cf2cf1
964,bc1qz6lks9udfn78vx3cju9uyc6kqk6739hndak4ct,600,104886,104886,2022-12-29 00:02:02,2022-12-28 21:55:38,0,inbound,67af70604a7ba416de056a38623ff4eb8ab7c283462242468b05f8aff3cf2cf1
965,bc1qz6lks9udfn78vx3cju9uyc6kqk6739hndak4ct,601,57468,57468,2023-01-30 13:52:14,2022-12-28 21:55:38,0,inbound,67af70604a7ba416de056a38623ff4eb8ab7c283462242468b05f8aff3cf2cf1
966,bc1qz6lks9udfn78vx3cju9uyc6kqk6739hndak4ct,602,63460,63460,2022-12-29 00:02:13,2022-12-28 21:55:38,0,inbound,67af70604a7ba416de056a38623ff4eb8ab7c283462242468b05f8aff3cf2cf1
967,bc1qz6lks9udfn78vx3cju9uyc6kqk6739hndak4ct,603,2333779,2333779,2023-01-18 21:01:33,2022-12-28 21:53:21,0,inbound,67af70604a7ba416de056a38623ff4eb8ab7c283462242468b05f8aff3cf2cf1
968,bc1qz6lks9udfn78vx3cju9uyc6kqk6739hndak4ct,604,147204831,147204831,2023-04-10 00:08:08,2023-01-11 22:52:32,0,inbound,67af70604a7ba416de056a38623ff4eb8ab7c283462242468b05f8aff3cf2cf1
969,bc1qz6lks9udfn78vx3cju9uyc6kqk6739hndak4ct,605,205572,205572,2022-12-29 01:28:10,2022-12-28 21:55:38,0,inbound,67af70604a7ba416de056a38623ff4eb8ab7c283462242468b05f8aff3cf2cf1
970,bc1qz6lks9udfn78vx3cju9uyc6kqk6739hndak4ct,606,1131938,1131938,2022-12-29 07:40:02,2022-12-28 21:55:38,0,inbound,67af70604a7ba416de056a38623ff4eb8ab7c283462242468b05f8aff3cf2cf1
971,bc1qz6lks9udfn78vx3cju9uyc6kqk6739hndak4ct,607,737755258,737355462,2023-04-09 14:00:08,2023-03-09 11:20:47,399796,inbound,67af70604a7ba416de056a38623ff4eb8ab7c283462242468b05f8aff3cf2cf1
972,bc1qz6lks9udfn78vx3cju9uyc6kqk6739hndak4ct,608,203116466,203116466,2023-01-28 11:19:22,2022-11-01 17:23:52,0,outbound,67af70604a7ba416de056a38623ff4eb8ab7c283462242468b05f8aff3cf2cf1
973,bc1qz6lks9udfn78vx3cju9uyc6kqk6739hndak4ct,609,56538055,53960347,2023-04-10 08:26:13,2023-03-27 20:15:45,2577708,inbound,67af70604a7ba416de056a38623ff4eb8ab7c283462242468b05f8aff3cf2cf1
974,bc1qz6lks9udfn78vx3cju9uyc6kqk6739hndak4ct,610,422869593,422869593,2023-04-08 01:22:03,2023-01-10 00:51:35,0,inbound,67af70604a7ba416de056a38623ff4eb8ab7c283462242468b05f8aff3cf2cf1
975,bc1qz6lks9udfn78vx3cju9uyc6kqk6739hndak4ct,611,242307,242307,2023-01-07 02:31:45,2022-12-28 21:55:38,0,inbound,67af70604a7ba416de056a38623ff4eb8ab7c283462242468b05f8aff3cf2cf1
976,bc1qz6lks9udfn78vx3cju9uyc6kqk6739hndak4ct,612,1241824,1241824,2022-12-29 19:46:24,2022-12-28 21:55:38,0,inbound,67af70604a7ba416de056a38623ff4eb8ab7c283462242468b05f8aff3cf2cf1
977,bc1qz6lks9udfn78vx3cju9uyc6kqk6739hndak4ct,613,3351748,3247160,2023-03-05 09:54:06,2022-12-16 02:40:02,104588,inbound,67af70604a7ba416de056a38623ff4eb8ab7c283462242468b05f8aff3cf2cf1
978,bc1qz6lks9udfn78vx3cju9uyc6kqk6739hndak4ct,614,181701,181701,2022-12-29 00:30:43,2022-12-28 21:55:38,0,inbound,67af70604a7ba416de056a38623ff4eb8ab7c283462242468b05f8aff3cf2cf1
979,bc1qz6lks9udfn78vx3cju9uyc6kqk6739hndak4ct,615,269127794,268831720,2023-04-10 06:04:29,2023-03-01 02:01:35,296074,outbound,67af70604a7ba416de056a38623ff4eb8ab7c283462242468b05f8aff3cf2cf1
980,bc1qz6lks9udfn78vx3cju9uyc6kqk6739hndak4ct,616,282210964,282113496,2023-04-09 03:36:43,2023-03-17 11:26:49,97468,inbound,67af70604a7ba416de056a38623ff4eb8ab7c283462242468b05f8aff3cf2cf1
981,bc1qz6lks9udfn78vx3cju9uyc6kqk6739hndak4ct,617,17735265,17735265,2023-02-06 05:13:11,2022-11-28 23:35:36,0,inbound,67af70604a7ba416de056a38623ff4eb8ab7c283462242468b05f8aff3cf2cf1
982,bc1qz6lks9udfn78vx3cju9uyc6kqk6739hndak4ct,790,271343713,271343713,2022-12-26 19:45:56,2022-12-26 19:27:29,0,inbound,67af70604a7ba416de056a38623ff4eb8ab7c283462242468b05f8aff3cf2cf1
983,bc1qz6lks9udfn78vx3cju9uyc6kqk6739hndak4ct,791,277064,277064,2022-12-26 23:26:53,2022-12-26 19:27:29,0,inbound,67af70604a7ba416de056a38623ff4eb8ab7c283462242468b05f8aff3cf2cf1
984,bc1qz6lks9udfn78vx3cju9uyc6kqk6739hndak4ct,792,189978,189978,2022-12-27 00:07:44,2022-12-26 19:27:29,0,inbound,67af70604a7ba416de056a38623ff4eb8ab7c283462242468b05f8aff3cf2cf1
985,bc1qz6lks9udfn78vx3cju9uyc6kqk6739hndak4ct,793,120334,120334,2023-01-07 22:04:43,2022-12-26 19:27:29,0,inbound,67af70604a7ba416de056a38623ff4eb8ab7c283462242468b05f8aff3cf2cf1
986,bc1qz6lks9udfn78vx3cju9uyc6kqk6739hndak4ct,794,62285605,62285605,2023-04-08 11:18:46,2022-12-19 05:23:28,0,inbound,67af70604a7ba416de056a38623ff4eb8ab7c283462242468b05f8aff3cf2cf1
987,bc1qz6lks9udfn78vx3cju9uyc6kqk6739hndak4ct,795,108801,108801,2023-01-10 00:26:26,2022-12-26 19:27:29,0,inbound,67af70604a7ba416de056a38623ff4eb8ab7c283462242468b05f8aff3cf2cf1
988,bc1qz6lks9udfn78vx3cju9uyc6kqk6739hndak4ct,796,6535788,6050655,2023-04-07 20:14:45,2021-01-10 03:16:43,485133,inbound,67af70604a7ba416de056a38623ff4eb8ab7c283462242468b05f8aff3cf2cf1
989,bc1qz6lks9udfn78vx3cju9uyc6kqk6739hndak4ct,797,126070,126070,2022-12-26 20:58:58,2022-12-26 19:27:29,0,inbound,67af70604a7ba416de056a38623ff4eb8ab7c283462242468b05f8aff3cf2cf1
990,bc1qz6lks9udfn78vx3cju9uyc6kqk6739hndak4ct,798,5826596,5826596,2022-12-26 19:57:46,2022-12-26 19:27:29,0,inbound,67af70604a7ba416de056a38623ff4eb8ab7c283462242468b05f8aff3cf2cf1
991,bc1qz6lks9udfn78vx3cju9uyc6kqk6739hndak4ct,799,831610,831610,2022-12-26 20:28:41,2022-12-26 19:27:29,0,inbound,67af70604a7ba416de056a38623ff4eb8ab7c283462242468b05f8aff3cf2cf1
992,bc1qz6lks9udfn78vx3cju9uyc6kqk6739hndak4ct,800,335068,335068,2022-12-26 21:28:41,2022-12-26 19:27:29,0,inbound,67af70604a7ba416de056a38623ff4eb8ab7c283462242468b05f8aff3cf2cf1
993,bc1qz6lks9udfn78vx3cju9uyc6kqk6739hndak4ct,801,2252305,2252305,2023-02-20 07:37:24,2022-12-26 19:27:29,0,inbound,67af70604a7ba416de056a38623ff4eb8ab7c283462242468b05f8aff3cf2cf1
994,bc1qz6lks9udfn78vx3cju9uyc6kqk6739hndak4ct,802,306036,306036,2022-12-27 00:07:45,2022-12-26 19:27:29,0,inbound,67af70604a7ba416de056a38623ff4eb8ab7c283462242468b05f8aff3cf2cf1
995,bc1qz6lks9udfn78vx3cju9uyc6kqk6739hndak4ct,803,3562103,3562103,2022-12-27 01:09:28,2022-12-26 19:27:29,0,inbound,67af70604a7ba416de056a38623ff4eb8ab7c283462242468b05f8aff3cf2cf1
996,bc1qz6lks9udfn78vx3cju9uyc6kqk6739hndak4ct,804,91361,91361,2023-01-03 22:54:43,2022-12-26 19:27:29,0,inbound,67af70604a7ba416de056a38623ff4eb8ab7c283462242468b05f8aff3cf2cf1
997,bc1qz6lks9udfn78vx3cju9uyc6kqk6739hndak4ct,805,111308,111308,2023-01-03 17:01:10,2022-12-26 19:27:29,0,inbound,67af70604a7ba416de056a38623ff4eb8ab7c283462242468b05f8aff3cf2cf1
998,bc1qz6lks9udfn78vx3cju9uyc6kqk6739hndak4ct,806,445280,445280,2022-12-27 06:02:07,2022-12-26 19:27:29,0,inbound,67af70604a7ba416de056a38623ff4eb8ab7c283462242468b05f8aff3cf2cf1
999,bc1qz6lks9udfn78vx3cju9uyc6kqk6739hndak4ct,807,47811571,47082159,2023-04-03 07:02:20,2023-02-28 07:32:48,729412,inbound,67af70604a7ba416de056a38623ff4eb8ab7c283462242468b05f8aff3cf2cf1
1000,bc1qz6lks9udfn78vx3cju9uyc6kqk6739hndak4ct,808,50642,50642,2023-02-08 13:41:13,2022-12-26 19:27:29,0,inbound,67af70604a7ba416de056a38623ff4eb8ab7c283462242468b05f8aff3cf2cf1
1001,bc1qz6lks9udfn78vx3cju9uyc6kqk6739hndak4ct,809,1200116,1200116,2023-01-02 15:52:06,2022-12-26 19:27:29,0,inbound,67af70604a7ba416de056a38623ff4eb8ab7c283462242468b05f8aff3cf2cf1
1002,bc1qz6lks9udfn78vx3cju9uyc6kqk6739hndak4ct,810,60051,60051,2022-12-27 17:08:03,2022-12-26 19:27:29,0,inbound,67af70604a7ba416de056a38623ff4eb8ab7c283462242468b05f8aff3cf2cf1
1003,bc1qz6lks9udfn78vx3cju9uyc6kqk6739hndak4ct,811,213772573,213772573,2023-03-30 20:07:31,2023-03-14 04:13:14,0,inbound,67af70604a7ba416de056a38623ff4eb8ab7c283462242468b05f8aff3cf2cf1
1004,bc1qz6lks9udfn78vx3cju9uyc6kqk6739hndak4ct,812,247986,247986,2022-12-27 05:01:37,2022-12-26 19:27:29,0,inbound,67af70604a7ba416de056a38623ff4eb8ab7c283462242468b05f8aff3cf2cf1
1005,bc1qz6lks9udfn78vx3cju9uyc6kqk6739hndak4ct,813,277072,277072,2022-12-27 01:17:39,2022-12-26 19:27:29,0,inbound,67af70604a7ba416de056a38623ff4eb8ab7c283462242468b05f8aff3cf2cf1
1006,bc1qz6lks9udfn78vx3cju9uyc6kqk6739hndak4ct,814,4788984848,4788630485,2023-04-10 15:29:18,2023-04-05 16:09:17,354363,outbound,67af70604a7ba416de056a38623ff4eb8ab7c283462242468b05f8aff3cf2cf1
1007,bc1qz6lks9udfn78vx3cju9uyc6kqk6739hndak4ct,815,30006910,29956404,2023-04-09 11:04:23,2022-12-26 15:52:15,50506,inbound,67af70604a7ba416de056a38623ff4eb8ab7c283462242468b05f8aff3cf2cf1
1008,bc1qz6lks9udfn78vx3cju9uyc6kqk6739hndak4ct,816,1429558809,1429558809,2023-04-10 14:29:18,2023-03-31 19:56:15,0,inbound,67af70604a7ba416de056a38623ff4eb8ab7c283462242468b05f8aff3cf2cf1
1009,bc1qz6lks9udfn78vx3cju9uyc6kqk6739hndak4ct,817,529590911,529590911,2023-04-07 16:10:35,2023-02-14 07:07:10,0,inbound,67af70604a7ba416de056a38623ff4eb8ab7c283462242468b05f8aff3cf2cf1
1010,bc1qz6lks9udfn78vx3cju9uyc6kqk6739hndak4ct,818,362744268,362744268,2023-01-28 04:29:18,2023-01-08 23:30:02,0,inbound,67af70604a7ba416de056a38623ff4eb8ab7c283462242468b05f8aff3cf2cf1
1011,bc1qz6lks9udfn78vx3cju9uyc6kqk6739hndak4ct,819,5364444,5364444,2023-02-02 01:38:46,2022-07-15 00:38:52,0,outbound,67af70604a7ba416de056a38623ff4eb8ab7c283462242468b05f8aff3cf2cf1
1012,bc1qz6lks9udfn78vx3cju9uyc6kqk6739hndak4ct,820,28267661,28267661,2023-04-10 11:20:52,2022-07-30 22:46:54,0,inbound,67af70604a7ba416de056a38623ff4eb8ab7c283462242468b05f8aff3cf2cf1
1013,bc1qz6lks9udfn78vx3cju9uyc6kqk6739hndak4ct,821,45974108,45745116,2023-04-10 02:24:29,2023-03-03 06:01:46,228992,outbound,67af70604a7ba416de056a38623ff4eb8ab7c283462242468b05f8aff3cf2cf1
1014,bc1qz6lks9udfn78vx3cju9uyc6kqk6739hndak4ct,822,255287,255287,2022-12-27 16:24:30,2022-12-26 19:27:29,0,inbound,67af70604a7ba416de056a38623ff4eb8ab7c283462242468b05f8aff3cf2cf1
1015,bc1qz6lks9udfn78vx3cju9uyc6kqk6739hndak4ct,823,358293,358293,2022-12-27 00:07:45,2022-12-26 19:27:29,0,inbound,67af70604a7ba416de056a38623ff4eb8ab7c283462242468b05f8aff3cf2cf1
1016,bc1qz6lks9udfn78vx3cju9uyc6kqk6739hndak4ct,824,335072,335072,2022-12-26 20:56:15,2022-12-26 19:27:29,0,inbound,67af70604a7ba416de056a38623ff4eb8ab7c283462242468b05f8aff3cf2cf1
1017,bc1qz6lks9udfn78vx3cju9uyc6kqk6739hndak4ct,825,595174283,594994335,2023-04-10 15:42:31,2023-03-31 10:24:10,179948,outbound,67af70604a7ba416de056a38623ff4eb8ab7c283462242468b05f8aff3cf2cf1
1018,bc1qz6lks9udfn78vx3cju9uyc6kqk6739hndak4ct,826,22529307567,11551535882,2023-04-10 14:45:35,2023-03-28 01:59:09,10977771685,outbound,67af70604a7ba416de056a38623ff4eb8ab7c283462242468b05f8aff3cf2cf1
1019,bc1qz6lks9udfn78vx3cju9uyc6kqk6739hndak4ct,827,62329,62329,2022-12-27 00:07:42,2022-12-26 19:27:29,0,inbound,67af70604a7ba416de056a38623ff4eb8ab7c283462242468b05f8aff3cf2cf1
1020,bc1qz6lks9udfn78vx3cju9uyc6kqk6739hndak4ct,828,251332359,251325086,2023-03-26 06:09:52,2023-02-04 16:28:08,7273,outbound,67af70604a7ba416de056a38623ff4eb8ab7c283462242468b05f8aff3cf2cf1
1021,bc1qz6lks9udfn78vx3cju9uyc6kqk6739hndak4ct,829,60429,60429,2022-12-27 00:01:56,2022-12-26 19:27:29,0,inbound,67af70604a7ba416de056a38623ff4eb8ab7c283462242468b05f8aff3cf2cf1
1022,bc1qz6lks9udfn78vx3cju9uyc6kqk6739hndak4ct,830,59370,59370,2022-12-27 00:01:56,2022-12-26 19:27:29,0,inbound,67af70604a7ba416de056a38623ff4eb8ab7c283462242468b05f8aff3cf2cf1
1023,bc1qz6lks9udfn78vx3cju9uyc6kqk6739hndak4ct,831,134057816,132235294,2023-04-04 20:22:08,2022-12-22 06:21:53,1822522,inbound,67af70604a7ba416de056a38623ff4eb8ab7c283462242468b05f8aff3cf2cf1
1024,bc1qz6lks9udfn78vx3cju9uyc6kqk6739hndak4ct,832,422111,422111,2023-01-07 23:49:00,2022-12-26 19:27:29,0,inbound,67af70604a7ba416de056a38623ff4eb8ab7c283462242468b05f8aff3cf2cf1
1025,bc1qz6lks9udfn78vx3cju9uyc6kqk6739hndak4ct,833,99643,99643,2022-12-27 05:01:37,2022-12-26 19:27:29,0,inbound,67af70604a7ba416de056a38623ff4eb8ab7c283462242468b05f8aff3cf2cf1
1026,bc1qz6lks9udfn78vx3cju9uyc6kqk6739hndak4ct,834,160939,160939,2022-12-29 06:59:21,2022-12-26 19:27:29,0,inbound,67af70604a7ba416de056a38623ff4eb8ab7c283462242468b05f8aff3cf2cf1
1027,bc1qz6lks9udfn78vx3cju9uyc6kqk6739hndak4ct,835,100017,100017,2022-12-26 19:32:43,2022-12-26 19:27:29,0,inbound,67af70604a7ba416de056a38623ff4eb8ab7c283462242468b05f8aff3cf2cf1
1028,bc1qz6lks9udfn78vx3cju9uyc6kqk6739hndak4ct,836,564017,564017,2022-12-27 17:50:28,2022-12-26 19:27:29,0,inbound,67af70604a7ba416de056a38623ff4eb8ab7c283462242468b05f8aff3cf2cf1
1029,bc1qz6lks9udfn78vx3cju9uyc6kqk6739hndak4ct,837,73907,73907,2022-12-27 00:07:42,2022-12-26 19:27:29,0,inbound,67af70604a7ba416de056a38623ff4eb8ab7c283462242468b05f8aff3cf2cf1
1030,bc1qz6lks9udfn78vx3cju9uyc6kqk6739hndak4ct,838,104897210,102688694,2023-04-10 08:26:24,2023-03-19 01:16:45,2208516,inbound,67af70604a7ba416de056a38623ff4eb8ab7c283462242468b05f8aff3cf2cf1
1031,bc1qz6lks9udfn78vx3cju9uyc6kqk6739hndak4ct,839,564008,564008,2022-12-27 08:20:33,2022-12-26 19:27:29,0,inbound,67af70604a7ba416de056a38623ff4eb8ab7c283462242468b05f8aff3cf2cf1
1032,bc1qz6lks9udfn78vx3cju9uyc6kqk6739hndak4ct,840,19443600,17059889,2023-04-10 08:25:16,2023-03-11 07:46:00,2383711,inbound,67af70604a7ba416de056a38623ff4eb8ab7c283462242468b05f8aff3cf2cf1
1033,bc1qz6lks9udfn78vx3cju9uyc6kqk6739hndak4ct,841,201860,201860,2023-01-03 20:43:41,2022-12-26 19:27:29,0,inbound,67af70604a7ba416de056a38623ff4eb8ab7c283462242468b05f8aff3cf2cf1
1034,bc1qz6lks9udfn78vx3cju9uyc6kqk6739hndak4ct,842,7746314241,7744085585,2023-04-10 15:46:25,2023-04-07 19:33:49,2228656,inbound,67af70604a7ba416de056a38623ff4eb8ab7c283462242468b05f8aff3cf2cf1
1035,bc1qz6lks9udfn78vx3cju9uyc6kqk6739hndak4ct,843,120131079,120131079,2023-04-07 06:08:43,2022-12-13 10:05:31,0,outbound,67af70604a7ba416de056a38623ff4eb8ab7c283462242468b05f8aff3cf2cf1
1036,bc1qz6lks9udfn78vx3cju9uyc6kqk6739hndak4ct,844,281620922,280883994,2023-04-07 21:43:58,2023-02-26 21:37:13,736928,inbound,67af70604a7ba416de056a38623ff4eb8ab7c283462242468b05f8aff3cf2cf1
1037,bc1qz6lks9udfn78vx3cju9uyc6kqk6739hndak4ct,845,567215,567215,2022-12-27 00:07:47,2022-12-26 19:27:29,0,inbound,67af70604a7ba416de056a38623ff4eb8ab7c283462242468b05f8aff3cf2cf1
1038,bc1qz6lks9udfn78vx3cju9uyc6kqk6739hndak4ct,846,77429486,75660260,2023-04-10 10:30:07,2023-02-03 19:57:52,1769226,inbound,67af70604a7ba416de056a38623ff4eb8ab7c283462242468b05f8aff3cf2cf1
1039,bc1qz6lks9udfn78vx3cju9uyc6kqk6739hndak4ct,847,8506714,8497045,2022-12-26 22:36:42,2021-12-23 14:00:00,9669,inbound,67af70604a7ba416de056a38623ff4eb8ab7c283462242468b05f8aff3cf2cf1
1040,bc1qz6lks9udfn78vx3cju9uyc6kqk6739hndak4ct,848,227713208,227713208,2023-04-02 11:39:20,2023-01-08 16:11:00,0,inbound,67af70604a7ba416de056a38623ff4eb8ab7c283462242468b05f8aff3cf2cf1
1041,bc1qz6lks9udfn78vx3cju9uyc6kqk6739hndak4ct,954,2934177,2934177,2023-03-24 18:01:01,2022-06-14 06:26:41,0,inbound,67af70604a7ba416de056a38623ff4eb8ab7c283462242468b05f8aff3cf2cf1
1042,bc1qz6lks9udfn78vx3cju9uyc6kqk6739hndak4ct,955,1299000,1299000,2023-01-30 11:58:19,2022-12-23 12:52:47,0,inbound,67af70604a7ba416de056a38623ff4eb8ab7c283462242468b05f8aff3cf2cf1
1043,bc1qz6lks9udfn78vx3cju9uyc6kqk6739hndak4ct,956,21744326,21744326,2022-12-23 15:15:05,2022-12-23 12:52:47,0,inbound,67af70604a7ba416de056a38623ff4eb8ab7c283462242468b05f8aff3cf2cf1
1044,bc1qz6lks9udfn78vx3cju9uyc6kqk6739hndak4ct,957,2739421,2725382,2023-02-19 05:24:31,2022-12-14 13:46:54,14039,inbound,67af70604a7ba416de056a38623ff4eb8ab7c283462242468b05f8aff3cf2cf1
1045,bc1qz6lks9udfn78vx3cju9uyc6kqk6739hndak4ct,958,12607588,12607588,2022-12-23 15:10:47,2022-09-11 14:23:08,0,inbound,67af70604a7ba416de056a38623ff4eb8ab7c283462242468b05f8aff3cf2cf1
1046,bc1qz6lks9udfn78vx3cju9uyc6kqk6739hndak4ct,959,101075674,101075674,2022-12-29 12:55:12,2022-12-23 12:52:47,0,inbound,67af70604a7ba416de056a38623ff4eb8ab7c283462242468b05f8aff3cf2cf1
1047,bc1qz6lks9udfn78vx3cju9uyc6kqk6739hndak4ct,960,80000,0,2022-12-23 12:52:47,2022-12-23 12:52:47,80000,inbound,67af70604a7ba416de056a38623ff4eb8ab7c283462242468b05f8aff3cf2cf1
1048,bc1qz6lks9udfn78vx3cju9uyc6kqk6739hndak4ct,961,282210,282210,2022-12-23 17:52:03,2022-12-23 12:52:47,0,inbound,67af70604a7ba416de056a38623ff4eb8ab7c283462242468b05f8aff3cf2cf1
1049,bc1qz6lks9udfn78vx3cju9uyc6kqk6739hndak4ct,962,172113071,172113071,2022-12-28 10:07:34,2022-12-22 14:11:23,0,inbound,67af70604a7ba416de056a38623ff4eb8ab7c283462242468b05f8aff3cf2cf1
1050,bc1qz6lks9udfn78vx3cju9uyc6kqk6739hndak4ct,963,570000,570000,2023-01-19 21:21:19,2022-12-23 12:52:47,0,inbound,67af70604a7ba416de056a38623ff4eb8ab7c283462242468b05f8aff3cf2cf1
1051,bc1qz6lks9udfn78vx3cju9uyc6kqk6739hndak4ct,964,39558961,39558961,2023-01-20 13:39:48,2022-12-23 12:52:47,0,inbound,67af70604a7ba416de056a38623ff4eb8ab7c283462242468b05f8aff3cf2cf1
1052,bc1qz6lks9udfn78vx3cju9uyc6kqk6739hndak4ct,965,15804881,15804881,2022-12-24 21:32:16,2022-11-18 06:35:47,0,inbound,67af70604a7ba416de056a38623ff4eb8ab7c283462242468b05f8aff3cf2cf1
1053,bc1qz6lks9udfn78vx3cju9uyc6kqk6739hndak4ct,966,10328699,0,2023-01-20 19:31:31,2022-12-23 12:52:47,10328699,inbound,67af70604a7ba416de056a38623ff4eb8ab7c283462242468b05f8aff3cf2cf1
1054,bc1qz6lks9udfn78vx3cju9uyc6kqk6739hndak4ct,967,1499980000,1499980000,2023-01-01 06:15:32,2022-12-23 12:52:47,0,inbound,67af70604a7ba416de056a38623ff4eb8ab7c283462242468b05f8aff3cf2cf1
1055,bc1qz6lks9udfn78vx3cju9uyc6kqk6739hndak4ct,968,1853919,0,2022-12-23 12:52:47,2022-12-23 12:52:47,1853919,inbound,67af70604a7ba416de056a38623ff4eb8ab7c283462242468b05f8aff3cf2cf1
1056,bc1qz6lks9udfn78vx3cju9uyc6kqk6739hndak4ct,969,140297127,140297127,2022-12-28 10:26:53,2022-12-23 12:11:13,0,inbound,67af70604a7ba416de056a38623ff4eb8ab7c283462242468b05f8aff3cf2cf1
1057,bc1qz6lks9udfn78vx3cju9uyc6kqk6739hndak4ct,970,4536156,4536156,2023-03-01 01:36:17,2022-12-23 12:52:47,0,inbound,67af70604a7ba416de056a38623ff4eb8ab7c283462242468b05f8aff3cf2cf1
1058,bc1qz6lks9udfn78vx3cju9uyc6kqk6739hndak4ct,971,8699767,0,2022-12-23 12:52:47,2022-12-23 12:52:47,8699767,inbound,67af70604a7ba416de056a38623ff4eb8ab7c283462242468b05f8aff3cf2cf1
1059,bc1qz6lks9udfn78vx3cju9uyc6kqk6739hndak4ct,972,4413723,0,2023-01-20 15:56:40,2022-12-23 12:52:47,4413723,inbound,67af70604a7ba416de056a38623ff4eb8ab7c283462242468b05f8aff3cf2cf1
1060,bc1qz6lks9udfn78vx3cju9uyc6kqk6739hndak4ct,973,102544048,102544048,2023-01-24 13:07:57,2022-10-19 14:48:45,0,inbound,67af70604a7ba416de056a38623ff4eb8ab7c283462242468b05f8aff3cf2cf1
1061,bc1qz6lks9udfn78vx3cju9uyc6kqk6739hndak4ct,974,685596,681398,2023-03-11 18:49:41,2022-12-23 12:52:47,4198,inbound,67af70604a7ba416de056a38623ff4eb8ab7c283462242468b05f8aff3cf2cf1
1062,bc1qz6lks9udfn78vx3cju9uyc6kqk6739hndak4ct,975,4241270,0,2022-12-23 12:52:47,2022-12-23 12:52:47,4241270,inbound,67af70604a7ba416de056a38623ff4eb8ab7c283462242468b05f8aff3cf2cf1
1063,bc1qz6lks9udfn78vx3cju9uyc6kqk6739hndak4ct,976,90000,0,2022-12-23 12:52:47,2022-12-23 12:52:47,90000,inbound,67af70604a7ba416de056a38623ff4eb8ab7c283462242468b05f8aff3cf2cf1
1064,bc1qz6lks9udfn78vx3cju9uyc6kqk6739hndak4ct,977,6196379,6196379,2022-12-24 23:57:38,2022-12-17 00:32:46,0,inbound,67af70604a7ba416de056a38623ff4eb8ab7c283462242468b05f8aff3cf2cf1
1065,bc1qz6lks9udfn78vx3cju9uyc6kqk6739hndak4ct,978,44576345,44576345,2022-12-23 14:15:17,2022-12-04 17:18:10,0,inbound,67af70604a7ba416de056a38623ff4eb8ab7c283462242468b05f8aff3cf2cf1
1066,bc1qz6lks9udfn78vx3cju9uyc6kqk6739hndak4ct,979,9188299,9045598,2023-04-09 10:56:57,2022-07-02 21:09:17,142701,inbound,67af70604a7ba416de056a38623ff4eb8ab7c283462242468b05f8aff3cf2cf1
1067,bc1qz6lks9udfn78vx3cju9uyc6kqk6739hndak4ct,980,300789,300789,2022-12-24 00:09:40,2022-12-22 23:44:44,0,inbound,67af70604a7ba416de056a38623ff4eb8ab7c283462242468b05f8aff3cf2cf1
1068,bc1qz6lks9udfn78vx3cju9uyc6kqk6739hndak4ct,981,310200,310200,2022-12-23 06:02:00,2022-11-07 23:46:43,0,inbound,67af70604a7ba416de056a38623ff4eb8ab7c283462242468b05f8aff3cf2cf1
1069,bc1qz6lks9udfn78vx3cju9uyc6kqk6739hndak4ct,982,788330728,788330728,2023-01-17 00:03:45,2022-12-30 00:02:37,0,outbound,67af70604a7ba416de056a38623ff4eb8ab7c283462242468b05f8aff3cf2cf1
1070,bc1qz6lks9udfn78vx3cju9uyc6kqk6739hndak4ct,983,564707,564707,2022-12-23 08:07:36,2022-12-22 23:44:44,0,inbound,67af70604a7ba416de056a38623ff4eb8ab7c283462242468b05f8aff3cf2cf1
1071,bc1qz6lks9udfn78vx3cju9uyc6kqk6739hndak4ct,984,127035340,127035340,2023-03-31 17:30:22,2023-02-18 20:21:41,0,inbound,67af70604a7ba416de056a38623ff4eb8ab7c283462242468b05f8aff3cf2cf1
1072,bc1qz6lks9udfn78vx3cju9uyc6kqk6739hndak4ct,985,40054951,39459582,2023-03-31 05:11:17,2023-01-13 06:03:10,595369,outbound,67af70604a7ba416de056a38623ff4eb8ab7c283462242468b05f8aff3cf2cf1
1073,bc1qz6lks9udfn78vx3cju9uyc6kqk6739hndak4ct,986,568360,568360,2022-12-23 01:08:50,2022-12-22 23:44:44,0,inbound,67af70604a7ba416de056a38623ff4eb8ab7c283462242468b05f8aff3cf2cf1
1074,bc1qz6lks9udfn78vx3cju9uyc6kqk6739hndak4ct,987,103470,103470,2022-12-23 06:03:50,2022-12-22 23:44:44,0,inbound,67af70604a7ba416de056a38623ff4eb8ab7c283462242468b05f8aff3cf2cf1
1075,bc1qz6lks9udfn78vx3cju9uyc6kqk6739hndak4ct,988,536950,536950,2022-12-29 07:07:18,2022-12-22 15:57:52,0,inbound,67af70604a7ba416de056a38623ff4eb8ab7c283462242468b05f8aff3cf2cf1
1076,bc1qz6lks9udfn78vx3cju9uyc6kqk6739hndak4ct,989,907703,907703,2022-12-26 17:04:40,2022-12-22 23:44:44,0,inbound,67af70604a7ba416de056a38623ff4eb8ab7c283462242468b05f8aff3cf2cf1
1077,bc1qz6lks9udfn78vx3cju9uyc6kqk6739hndak4ct,990,338949,338949,2022-12-24 00:09:40,2022-12-22 23:44:44,0,inbound,67af70604a7ba416de056a38623ff4eb8ab7c283462242468b05f8aff3cf2cf1
1078,bc1qz6lks9udfn78vx3cju9uyc6kqk6739hndak4ct,991,283680,283680,2022-12-23 00:31:36,2022-12-22 23:44:44,0,inbound,67af70604a7ba416de056a38623ff4eb8ab7c283462242468b05f8aff3cf2cf1
1079,bc1qz6lks9udfn78vx3cju9uyc6kqk6739hndak4ct,992,132542,132542,2022-12-23 06:03:50,2022-12-22 23:44:44,0,inbound,67af70604a7ba416de056a38623ff4eb8ab7c283462242468b05f8aff3cf2cf1
1080,bc1qz6lks9udfn78vx3cju9uyc6kqk6739hndak4ct,993,161559,161559,2022-12-27 20:04:56,2022-12-22 23:44:44,0,inbound,67af70604a7ba416de056a38623ff4eb8ab7c283462242468b05f8aff3cf2cf1
1081,bc1qz6lks9udfn78vx3cju9uyc6kqk6739hndak4ct,994,4664374,4499791,2023-04-10 08:24:34,2022-12-15 01:50:06,164583,inbound,67af70604a7ba416de056a38623ff4eb8ab7c283462242468b05f8aff3cf2cf1
1082,bc1qz6lks9udfn78vx3cju9uyc6kqk6739hndak4ct,995,84027913543,84025630119,2023-03-08 04:25:05,2023-03-18 02:16:15,2283424,inbound,67af70604a7ba416de056a38623ff4eb8ab7c283462242468b05f8aff3cf2cf1
1083,bc1qz6lks9udfn78vx3cju9uyc6kqk6739hndak4ct,996,33809554,33809554,2023-04-08 12:43:19,2022-12-11 10:38:49,0,outbound,67af70604a7ba416de056a38623ff4eb8ab7c283462242468b05f8aff3cf2cf1
1084,bc1qz6lks9udfn78vx3cju9uyc6kqk6739hndak4ct,997,1786496,1786496,2022-12-26 14:58:29,2022-12-22 23:44:44,0,inbound,67af70604a7ba416de056a38623ff4eb8ab7c283462242468b05f8aff3cf2cf1
1085,bc1qz6lks9udfn78vx3cju9uyc6kqk6739hndak4ct,998,277919,277919,2022-12-27 18:21:22,2022-12-22 23:44:44,0,inbound,67af70604a7ba416de056a38623ff4eb8ab7c283462242468b05f8aff3cf2cf1
1086,bc1qz6lks9udfn78vx3cju9uyc6kqk6739hndak4ct,999,19600678,19600678,2023-03-14 09:33:05,2022-12-13 16:24:53,0,inbound,67af70604a7ba416de056a38623ff4eb8ab7c283462242468b05f8aff3cf2cf1
1087,bc1qz6lks9udfn78vx3cju9uyc6kqk6739hndak4ct,1000,277816,277816,2022-12-29 03:46:18,2022-12-22 23:44:44,0,inbound,67af70604a7ba416de056a38623ff4eb8ab7c283462242468b05f8aff3cf2cf1
1088,bc1qz6lks9udfn78vx3cju9uyc6kqk6739hndak4ct,1001,17833,17833,2022-12-24 01:03:09,2022-12-22 23:44:44,0,inbound,67af70604a7ba416de056a38623ff4eb8ab7c283462242468b05f8aff3cf2cf1
1089,bc1qz6lks9udfn78vx3cju9uyc6kqk6739hndak4ct,1002,5835452,5835452,2023-03-17 14:36:30,2022-10-28 17:18:39,0,inbound,67af70604a7ba416de056a38623ff4eb8ab7c283462242468b05f8aff3cf2cf1
1090,bc1qz6lks9udfn78vx3cju9uyc6kqk6739hndak4ct,1003,132586,132586,2022-12-30 18:55:35,2022-12-22 23:44:44,0,inbound,67af70604a7ba416de056a38623ff4eb8ab7c283462242468b05f8aff3cf2cf1
1091,bc1qz6lks9udfn78vx3cju9uyc6kqk6739hndak4ct,1004,475542,475542,2022-12-23 08:19:51,2022-12-22 23:44:44,0,inbound,67af70604a7ba416de056a38623ff4eb8ab7c283462242468b05f8aff3cf2cf1
1092,bc1qz6lks9udfn78vx3cju9uyc6kqk6739hndak4ct,1005,62277719,62277719,2022-12-30 16:20:35,2022-12-08 00:23:51,0,inbound,67af70604a7ba416de056a38623ff4eb8ab7c283462242468b05f8aff3cf2cf1
1093,bc1qz6lks9udfn78vx3cju9uyc6kqk6739hndak4ct,1006,3047594064,3047594064,2023-04-10 08:03:33,2023-03-31 22:08:09,0,outbound,67af70604a7ba416de056a38623ff4eb8ab7c283462242468b05f8aff3cf2cf1
1094,bc1qz6lks9udfn78vx3cju9uyc6kqk6739hndak4ct,1007,238063725,238063725,2023-03-16 02:59:32,2022-10-10 21:03:28,0,outbound,67af70604a7ba416de056a38623ff4eb8ab7c283462242468b05f8aff3cf2cf1
1095,bc1qz6lks9udfn78vx3cju9uyc6kqk6739hndak4ct,1008,133273209,133273209,2023-04-10 08:40:39,2022-12-18 22:02:17,0,inbound,67af70604a7ba416de056a38623ff4eb8ab7c283462242468b05f8aff3cf2cf1
1096,bc1qz6lks9udfn78vx3cju9uyc6kqk6739hndak4ct,1009,6822051,6822051,2022-12-23 02:24:05,2022-12-22 23:44:44,0,inbound,67af70604a7ba416de056a38623ff4eb8ab7c283462242468b05f8aff3cf2cf1
1097,bc1qz6lks9udfn78vx3cju9uyc6kqk6739hndak4ct,1010,323206,323206,2022-12-29 02:30:26,2022-12-22 23:38:16,0,inbound,67af70604a7ba416de056a38623ff4eb8ab7c283462242468b05f8aff3cf2cf1
1098,bc1qz6lks9udfn78vx3cju9uyc6kqk6739hndak4ct,1011,467719863631,467624238890,2023-04-10 16:07:38,2023-04-10 12:03:27,95624741,inbound,67af70604a7ba416de056a38623ff4eb8ab7c283462242468b05f8aff3cf2cf1
1099,bc1qz6lks9udfn78vx3cju9uyc6kqk6739hndak4ct,1012,103469,103469,2022-12-23 06:03:50,2022-12-22 23:44:44,0,inbound,67af70604a7ba416de056a38623ff4eb8ab7c283462242468b05f8aff3cf2cf1
1100,bc1qz6lks9udfn78vx3cju9uyc6kqk6739hndak4ct,1256,34725880,0,2022-12-18 20:16:45,2022-12-18 19:12:47,34725880,inbound,67af70604a7ba416de056a38623ff4eb8ab7c283462242468b05f8aff3cf2cf1
1101,bc1qz6lks9udfn78vx3cju9uyc6kqk6739hndak4ct,1257,1019600,1019600,2023-02-05 11:37:58,2022-12-18 18:56:48,0,inbound,67af70604a7ba416de056a38623ff4eb8ab7c283462242468b05f8aff3cf2cf1
1102,bc1qz6lks9udfn78vx3cju9uyc6kqk6739hndak4ct,1258,130631,130631,2023-01-01 10:09:32,2022-03-11 10:35:01,0,inbound,67af70604a7ba416de056a38623ff4eb8ab7c283462242468b05f8aff3cf2cf1
1103,bc1qz6lks9udfn78vx3cju9uyc6kqk6739hndak4ct,1259,5051177,0,2022-12-18 18:56:48,2022-12-18 18:56:48,5051177,inbound,67af70604a7ba416de056a38623ff4eb8ab7c283462242468b05f8aff3cf2cf1
1104,bc1qz6lks9udfn78vx3cju9uyc6kqk6739hndak4ct,1260,11934639,11934639,2022-12-20 06:41:58,2022-12-18 18:56:48,0,inbound,67af70604a7ba416de056a38623ff4eb8ab7c283462242468b05f8aff3cf2cf1
1105,bc1qz6lks9udfn78vx3cju9uyc6kqk6739hndak4ct,1261,28980000,0,2022-12-18 18:56:48,2022-12-18 18:56:48,28980000,inbound,67af70604a7ba416de056a38623ff4eb8ab7c283462242468b05f8aff3cf2cf1
1106,bc1qz6lks9udfn78vx3cju9uyc6kqk6739hndak4ct,1262,2676527,2676527,2023-01-24 19:34:22,2022-12-18 18:56:48,0,inbound,67af70604a7ba416de056a38623ff4eb8ab7c283462242468b05f8aff3cf2cf1
1107,bc1qz6lks9udfn78vx3cju9uyc6kqk6739hndak4ct,1263,565902,0,2022-12-18 18:56:48,2022-12-18 18:56:48,565902,inbound,67af70604a7ba416de056a38623ff4eb8ab7c283462242468b05f8aff3cf2cf1
1108,bc1qz6lks9udfn78vx3cju9uyc6kqk6739hndak4ct,1264,1054812,1054812,2022-12-18 20:00:52,2022-12-18 18:56:48,0,inbound,67af70604a7ba416de056a38623ff4eb8ab7c283462242468b05f8aff3cf2cf1
1109,bc1qz6lks9udfn78vx3cju9uyc6kqk6739hndak4ct,1265,252660838,252660838,2023-04-10 11:28:34,2023-03-14 08:28:40,0,inbound,67af70604a7ba416de056a38623ff4eb8ab7c283462242468b05f8aff3cf2cf1
1110,bc1qz6lks9udfn78vx3cju9uyc6kqk6739hndak4ct,1266,5428809,0,2023-02-08 12:27:58,2022-11-10 14:32:52,5428809,inbound,67af70604a7ba416de056a38623ff4eb8ab7c283462242468b05f8aff3cf2cf1
1111,bc1qz6lks9udfn78vx3cju9uyc6kqk6739hndak4ct,1267,2266700,0,2022-12-18 04:24:47,2022-12-18 04:24:47,2266700,inbound,67af70604a7ba416de056a38623ff4eb8ab7c283462242468b05f8aff3cf2cf1
1112,bc1qz6lks9udfn78vx3cju9uyc6kqk6739hndak4ct,1268,2852152,2852152,2023-03-30 05:37:40,2022-07-11 15:00:39,0,inbound,67af70604a7ba416de056a38623ff4eb8ab7c283462242468b05f8aff3cf2cf1
1113,bc1qz6lks9udfn78vx3cju9uyc6kqk6739hndak4ct,1269,1432711,1432711,2022-12-19 00:52:23,2022-12-17 01:29:03,0,inbound,67af70604a7ba416de056a38623ff4eb8ab7c283462242468b05f8aff3cf2cf1
1114,bc1qz6lks9udfn78vx3cju9uyc6kqk6739hndak4ct,1270,1062715281,0,2023-03-19 02:11:38,2023-01-21 14:54:54,1062715281,inbound,67af70604a7ba416de056a38623ff4eb8ab7c283462242468b05f8aff3cf2cf1
1115,bc1qz6lks9udfn78vx3cju9uyc6kqk6739hndak4ct,1271,597273,597273,2022-12-17 02:15:15,2022-12-17 01:29:03,0,inbound,67af70604a7ba416de056a38623ff4eb8ab7c283462242468b05f8aff3cf2cf1
1116,bc1qz6lks9udfn78vx3cju9uyc6kqk6739hndak4ct,1272,109619093952,109615720650,2023-04-10 16:39:45,2023-04-10 09:24:54,3373302,inbound,67af70604a7ba416de056a38623ff4eb8ab7c283462242468b05f8aff3cf2cf1
1117,bc1qz6lks9udfn78vx3cju9uyc6kqk6739hndak4ct,1273,30550571,29776499,2023-04-05 06:53:22,2023-02-02 00:02:25,774072,outbound,67af70604a7ba416de056a38623ff4eb8ab7c283462242468b05f8aff3cf2cf1
1118,bc1qz6lks9udfn78vx3cju9uyc6kqk6739hndak4ct,1274,502957,502957,2022-12-19 18:32:12,2022-12-17 01:29:04,0,inbound,67af70604a7ba416de056a38623ff4eb8ab7c283462242468b05f8aff3cf2cf1
1119,bc1qz6lks9udfn78vx3cju9uyc6kqk6739hndak4ct,1275,299448,299448,2022-12-17 02:31:17,2022-12-17 01:29:03,0,inbound,67af70604a7ba416de056a38623ff4eb8ab7c283462242468b05f8aff3cf2cf1
1120,bc1qz6lks9udfn78vx3cju9uyc6kqk6739hndak4ct,1276,632463,632463,2022-12-21 04:46:24,2022-12-17 01:29:04,0,inbound,67af70604a7ba416de056a38623ff4eb8ab7c283462242468b05f8aff3cf2cf1
1121,bc1qz6lks9udfn78vx3cju9uyc6kqk6739hndak4ct,1277,305363,305363,2022-12-17 03:00:42,2022-12-17 01:29:03,0,inbound,67af70604a7ba416de056a38623ff4eb8ab7c283462242468b05f8aff3cf2cf1
1122,bc1qz6lks9udfn78vx3cju9uyc6kqk6739hndak4ct,1278,28739788,28739788,2023-04-09 04:14:11,2022-09-10 00:03:40,0,inbound,67af70604a7ba416de056a38623ff4eb8ab7c283462242468b05f8aff3cf2cf1
1123,bc1qz6lks9udfn78vx3cju9uyc6kqk6739hndak4ct,1279,612867,612867,2022-12-17 06:44:15,2022-12-17 01:29:03,0,inbound,67af70604a7ba416de056a38623ff4eb8ab7c283462242468b05f8aff3cf2cf1
1124,bc1qz6lks9udfn78vx3cju9uyc6kqk6739hndak4ct,1280,510099,510099,2022-12-17 01:55:29,2022-12-17 01:29:03,0,inbound,67af70604a7ba416de056a38623ff4eb8ab7c283462242468b05f8aff3cf2cf1
1125,bc1qz6lks9udfn78vx3cju9uyc6kqk6739hndak4ct,1281,328187,328187,2022-12-17 15:59:59,2022-12-16 21:30:17,0,inbound,67af70604a7ba416de056a38623ff4eb8ab7c283462242468b05f8aff3cf2cf1
1126,bc1qz6lks9udfn78vx3cju9uyc6kqk6739hndak4ct,1282,6318080,6318080,2022-12-29 09:27:37,2022-09-28 21:14:32,0,inbound,67af70604a7ba416de056a38623ff4eb8ab7c283462242468b05f8aff3cf2cf1
1127,bc1qz6lks9udfn78vx3cju9uyc6kqk6739hndak4ct,1283,325733044,323202775,2023-04-10 08:14:12,2023-03-27 17:02:35,2530269,outbound,67af70604a7ba416de056a38623ff4eb8ab7c283462242468b05f8aff3cf2cf1
1128,bc1qz6lks9udfn78vx3cju9uyc6kqk6739hndak4ct,1284,125399,125399,2022-12-30 23:38:29,2022-12-17 01:29:03,0,inbound,67af70604a7ba416de056a38623ff4eb8ab7c283462242468b05f8aff3cf2cf1
1129,bc1qz6lks9udfn78vx3cju9uyc6kqk6739hndak4ct,1285,12690016,12690016,2023-02-05 18:02:02,2022-09-20 11:08:28,0,inbound,67af70604a7ba416de056a38623ff4eb8ab7c283462242468b05f8aff3cf2cf1
1130,bc1qz6lks9udfn78vx3cju9uyc6kqk6739hndak4ct,1286,119765,119765,2022-12-27 17:27:02,2022-12-17 01:29:03,0,inbound,67af70604a7ba416de056a38623ff4eb8ab7c283462242468b05f8aff3cf2cf1
1131,bc1qz6lks9udfn78vx3cju9uyc6kqk6739hndak4ct,1287,227095,227095,2022-12-19 04:53:14,2022-12-17 01:29:03,0,inbound,67af70604a7ba416de056a38623ff4eb8ab7c283462242468b05f8aff3cf2cf1
1132,bc1qz6lks9udfn78vx3cju9uyc6kqk6739hndak4ct,1288,179603,179603,2022-12-19 05:21:13,2022-12-17 01:29:03,0,inbound,67af70604a7ba416de056a38623ff4eb8ab7c283462242468b05f8aff3cf2cf1
1133,bc1qz6lks9udfn78vx3cju9uyc6kqk6739hndak4ct,1289,283232265,283232265,2023-04-08 09:05:37,2023-01-13 07:12:31,0,inbound,67af70604a7ba416de056a38623ff4eb8ab7c283462242468b05f8aff3cf2cf1
1134,bc1qz6lks9udfn78vx3cju9uyc6kqk6739hndak4ct,1290,194950871,194950871,2023-04-10 02:13:21,2022-12-22 20:13:48,0,outbound,67af70604a7ba416de056a38623ff4eb8ab7c283462242468b05f8aff3cf2cf1
1135,bc1qz6lks9udfn78vx3cju9uyc6kqk6739hndak4ct,1291,532400,0,2022-12-17 01:29:03,2022-12-17 01:29:03,532400,inbound,67af70604a7ba416de056a38623ff4eb8ab7c283462242468b05f8aff3cf2cf1
1136,bc1qz6lks9udfn78vx3cju9uyc6kqk6739hndak4ct,1292,1064358391,1064350591,2023-04-10 16:01:45,2023-03-15 00:01:42,7800,outbound,67af70604a7ba416de056a38623ff4eb8ab7c283462242468b05f8aff3cf2cf1
1137,bc1qz6lks9udfn78vx3cju9uyc6kqk6739hndak4ct,1293,234452325,234452325,2023-04-08 18:22:18,2022-10-15 08:10:01,0,outbound,67af70604a7ba416de056a38623ff4eb8ab7c283462242468b05f8aff3cf2cf1
1138,bc1qz6lks9udfn78vx3cju9uyc6kqk6739hndak4ct,1294,52525214,29836491,2023-04-02 14:27:43,2022-12-27 22:02:06,22688723,inbound,67af70604a7ba416de056a38623ff4eb8ab7c283462242468b05f8aff3cf2cf1
1139,bc1qz6lks9udfn78vx3cju9uyc6kqk6739hndak4ct,1295,68852,68852,2023-03-01 13:15:09,2022-12-17 01:29:03,0,inbound,67af70604a7ba416de056a38623ff4eb8ab7c283462242468b05f8aff3cf2cf1
1140,bc1qz6lks9udfn78vx3cju9uyc6kqk6739hndak4ct,1296,37240973,36696294,2023-04-10 14:37:55,2022-12-31 11:27:08,544679,inbound,67af70604a7ba416de056a38623ff4eb8ab7c283462242468b05f8aff3cf2cf1
1141,bc1qz6lks9udfn78vx3cju9uyc6kqk6739hndak4ct,1297,285499,285499,2022-12-17 11:26:24,2022-12-17 01:29:03,0,inbound,67af70604a7ba416de056a38623ff4eb8ab7c283462242468b05f8aff3cf2cf1
1142,bc1qz6lks9udfn78vx3cju9uyc6kqk6739hndak4ct,1298,203579,203579,2022-12-17 03:46:13,2022-12-17 01:29:03,0,inbound,67af70604a7ba416de056a38623ff4eb8ab7c283462242468b05f8aff3cf2cf1
1143,bc1qz6lks9udfn78vx3cju9uyc6kqk6739hndak4ct,1299,25641871,24212083,2023-04-10 08:25:59,2023-03-20 03:52:26,1429788,inbound,67af70604a7ba416de056a38623ff4eb8ab7c283462242468b05f8aff3cf2cf1
1144,bc1qz6lks9udfn78vx3cju9uyc6kqk6739hndak4ct,1300,1015337,1015337,2022-12-30 10:21:00,2022-12-17 01:29:03,0,inbound,67af70604a7ba416de056a38623ff4eb8ab7c283462242468b05f8aff3cf2cf1
1145,bc1qz6lks9udfn78vx3cju9uyc6kqk6739hndak4ct,1301,424565,424565,2022-12-17 18:23:46,2022-12-17 01:29:03,0,inbound,67af70604a7ba416de056a38623ff4eb8ab7c283462242468b05f8aff3cf2cf1
1146,bc1qz6lks9udfn78vx3cju9uyc6kqk6739hndak4ct,1302,159321056,159321056,2023-04-08 00:13:14,2023-02-01 22:13:02,0,outbound,67af70604a7ba416de056a38623ff4eb8ab7c283462242468b05f8aff3cf2cf1
1147,bc1qz6lks9udfn78vx3cju9uyc6kqk6739hndak4ct,1303,62450637,62441824,2023-03-25 17:06:39,2022-12-28 19:11:43,8813,outbound,67af70604a7ba416de056a38623ff4eb8ab7c283462242468b05f8aff3cf2cf1
1148,bc1qz6lks9udfn78vx3cju9uyc6kqk6739hndak4ct,1304,256371758,256371758,2023-04-08 09:08:45,2023-02-09 02:06:45,0,inbound,67af70604a7ba416de056a38623ff4eb8ab7c283462242468b05f8aff3cf2cf1
1149,bc1qz6lks9udfn78vx3cju9uyc6kqk6739hndak4ct,1305,367476,367476,2022-12-17 03:05:11,2022-12-17 01:29:03,0,inbound,67af70604a7ba416de056a38623ff4eb8ab7c283462242468b05f8aff3cf2cf1
1150,bc1qz6lks9udfn78vx3cju9uyc6kqk6739hndak4ct,1306,30121153,30121153,2023-04-09 20:09:38,2023-02-14 13:38:25,0,inbound,67af70604a7ba416de056a38623ff4eb8ab7c283462242468b05f8aff3cf2cf1
1151,bc1qz6lks9udfn78vx3cju9uyc6kqk6739hndak4ct,1307,29947577,28930547,2023-04-10 08:25:39,2023-02-20 00:11:59,1017030,inbound,67af70604a7ba416de056a38623ff4eb8ab7c283462242468b05f8aff3cf2cf1
1152,bc1qz6lks9udfn78vx3cju9uyc6kqk6739hndak4ct,1308,62313970,62313970,2023-04-08 16:32:43,2023-01-18 07:25:03,0,outbound,67af70604a7ba416de056a38623ff4eb8ab7c283462242468b05f8aff3cf2cf1
1153,bc1qz6lks9udfn78vx3cju9uyc6kqk6739hndak4ct,1309,272515171,272515171,2023-04-09 21:55:07,2023-02-28 17:56:40,0,inbound,67af70604a7ba416de056a38623ff4eb8ab7c283462242468b05f8aff3cf2cf1
1154,bc1qz6lks9udfn78vx3cju9uyc6kqk6739hndak4ct,1310,63933539,63576768,2023-04-07 05:39:30,2022-12-13 14:58:30,356771,inbound,67af70604a7ba416de056a38623ff4eb8ab7c283462242468b05f8aff3cf2cf1
1155,bc1qz6lks9udfn78vx3cju9uyc6kqk6739hndak4ct,1311,68633449,65786664,2023-04-04 13:31:06,2022-12-30 15:14:30,2846785,inbound,67af70604a7ba416de056a38623ff4eb8ab7c283462242468b05f8aff3cf2cf1
1156,bc1qz6lks9udfn78vx3cju9uyc6kqk6739hndak4ct,1312,2601924642,2496821238,2023-04-10 12:30:38,2023-03-31 05:40:29,105103404,inbound,67af70604a7ba416de056a38623ff4eb8ab7c283462242468b05f8aff3cf2cf1
1157,bc1qz6lks9udfn78vx3cju9uyc6kqk6739hndak4ct,1313,26023051,26023051,2023-01-22 06:02:11,2022-02-08 18:43:36,0,inbound,67af70604a7ba416de056a38623ff4eb8ab7c283462242468b05f8aff3cf2cf1
1158,bc1qz6lks9udfn78vx3cju9uyc6kqk6739hndak4ct,1314,319758068,319758068,2023-04-08 00:05:06,2023-01-24 21:25:31,0,outbound,67af70604a7ba416de056a38623ff4eb8ab7c283462242468b05f8aff3cf2cf1
1159,bc1qz6lks9udfn78vx3cju9uyc6kqk6739hndak4ct,1743,28872127,28872127,2023-01-12 12:17:49,2022-07-05 13:08:42,0,inbound,67af70604a7ba416de056a38623ff4eb8ab7c283462242468b05f8aff3cf2cf1
1160,bc1qz6lks9udfn78vx3cju9uyc6kqk6739hndak4ct,1744,27228000,27228000,2022-12-11 15:22:40,2022-09-20 16:34:14,0,inbound,67af70604a7ba416de056a38623ff4eb8ab7c283462242468b05f8aff3cf2cf1
1161,bc1qz6lks9udfn78vx3cju9uyc6kqk6739hndak4ct,1745,623212486,623212486,2023-04-09 00:42:51,2022-12-09 06:36:26,0,outbound,67af70604a7ba416de056a38623ff4eb8ab7c283462242468b05f8aff3cf2cf1
1162,bc1qz6lks9udfn78vx3cju9uyc6kqk6739hndak4ct,1746,2826400,2826400,2022-12-11 12:38:34,2022-12-11 12:24:09,0,inbound,67af70604a7ba416de056a38623ff4eb8ab7c283462242468b05f8aff3cf2cf1
1163,bc1qz6lks9udfn78vx3cju9uyc6kqk6739hndak4ct,1747,106508297,37000216,2023-04-10 06:37:08,2022-08-17 18:41:43,69508081,inbound,67af70604a7ba416de056a38623ff4eb8ab7c283462242468b05f8aff3cf2cf1
1164,bc1qz6lks9udfn78vx3cju9uyc6kqk6739hndak4ct,1748,3311000,3311000,2022-12-19 12:08:37,2022-12-11 12:24:09,0,inbound,67af70604a7ba416de056a38623ff4eb8ab7c283462242468b05f8aff3cf2cf1
1165,bc1qz6lks9udfn78vx3cju9uyc6kqk6739hndak4ct,1749,43819282,43819282,2023-03-13 16:36:39,2022-12-11 12:24:09,0,inbound,67af70604a7ba416de056a38623ff4eb8ab7c283462242468b05f8aff3cf2cf1
1166,bc1qz6lks9udfn78vx3cju9uyc6kqk6739hndak4ct,1750,49767247,0,2022-12-11 12:24:09,2022-12-11 12:24:09,49767247,inbound,67af70604a7ba416de056a38623ff4eb8ab7c283462242468b05f8aff3cf2cf1
1167,bc1qz6lks9udfn78vx3cju9uyc6kqk6739hndak4ct,1751,332391938,332391938,2022-12-12 15:10:25,2022-12-11 12:24:09,0,inbound,67af70604a7ba416de056a38623ff4eb8ab7c283462242468b05f8aff3cf2cf1
1168,bc1qz6lks9udfn78vx3cju9uyc6kqk6739hndak4ct,1752,33498283,30746125,2022-12-10 23:13:47,2021-10-06 17:09:07,2752158,inbound,67af70604a7ba416de056a38623ff4eb8ab7c283462242468b05f8aff3cf2cf1
1169,bc1qz6lks9udfn78vx3cju9uyc6kqk6739hndak4ct,1753,1040804059,1040591359,2023-04-04 03:26:11,2022-08-12 16:51:07,212700,inbound,67af70604a7ba416de056a38623ff4eb8ab7c283462242468b05f8aff3cf2cf1
1170,bc1qz6lks9udfn78vx3cju9uyc6kqk6739hndak4ct,1754,12504528,408000,2023-03-31 18:54:23,2021-03-06 07:35:59,12096528,inbound,67af70604a7ba416de056a38623ff4eb8ab7c283462242468b05f8aff3cf2cf1
1171,bc1qz6lks9udfn78vx3cju9uyc6kqk6739hndak4ct,1755,2056776,2056776,2022-12-09 11:46:09,2022-11-28 16:28:01,0,inbound,67af70604a7ba416de056a38623ff4eb8ab7c283462242468b05f8aff3cf2cf1
1172,bc1qz6lks9udfn78vx3cju9uyc6kqk6739hndak4ct,1756,145693,145693,2022-12-09 12:45:06,2022-12-09 11:12:03,0,inbound,67af70604a7ba416de056a38623ff4eb8ab7c283462242468b05f8aff3cf2cf1
1173,bc1qz6lks9udfn78vx3cju9uyc6kqk6739hndak4ct,1757,1134746,0,2022-12-09 11:12:03,2022-12-09 11:12:03,1134746,inbound,67af70604a7ba416de056a38623ff4eb8ab7c283462242468b05f8aff3cf2cf1
1174,bc1qz6lks9udfn78vx3cju9uyc6kqk6739hndak4ct,1758,6429241,6429241,2022-12-09 11:38:20,2022-12-09 11:12:03,0,inbound,67af70604a7ba416de056a38623ff4eb8ab7c283462242468b05f8aff3cf2cf1
1175,bc1qz6lks9udfn78vx3cju9uyc6kqk6739hndak4ct,1759,829438,829438,2022-12-09 17:01:40,2022-11-15 09:47:27,0,inbound,67af70604a7ba416de056a38623ff4eb8ab7c283462242468b05f8aff3cf2cf1
1176,bc1qz6lks9udfn78vx3cju9uyc6kqk6739hndak4ct,1760,635339722647,632074436628,2023-04-10 17:40:20,2023-04-07 05:40:19,3265286019,inbound,67af70604a7ba416de056a38623ff4eb8ab7c283462242468b05f8aff3cf2cf1
1177,bc1qz6lks9udfn78vx3cju9uyc6kqk6739hndak4ct,1761,27308400,0,2022-12-09 08:31:01,2022-12-09 08:31:01,27308400,inbound,67af70604a7ba416de056a38623ff4eb8ab7c283462242468b05f8aff3cf2cf1
1178,bc1qz6lks9udfn78vx3cju9uyc6kqk6739hndak4ct,1762,993456,993456,2023-04-06 01:38:02,2022-08-06 01:33:08,0,inbound,67af70604a7ba416de056a38623ff4eb8ab7c283462242468b05f8aff3cf2cf1
1179,bc1qz6lks9udfn78vx3cju9uyc6kqk6739hndak4ct,1763,524404,524404,2022-12-09 05:01:06,2022-12-09 04:23:11,0,inbound,67af70604a7ba416de056a38623ff4eb8ab7c283462242468b05f8aff3cf2cf1
1180,bc1qz6lks9udfn78vx3cju9uyc6kqk6739hndak4ct,1764,81576419,0,2022-12-25 03:49:07,2022-12-08 13:58:07,81576419,inbound,67af70604a7ba416de056a38623ff4eb8ab7c283462242468b05f8aff3cf2cf1
1181,bc1qz6lks9udfn78vx3cju9uyc6kqk6739hndak4ct,1765,5560273,5560273,2022-12-09 04:28:22,2022-12-09 04:23:11,0,inbound,67af70604a7ba416de056a38623ff4eb8ab7c283462242468b05f8aff3cf2cf1
1182,bc1qz6lks9udfn78vx3cju9uyc6kqk6739hndak4ct,1766,197039439,195299393,2023-04-10 08:25:10,2023-03-09 06:30:08,1740046,inbound,67af70604a7ba416de056a38623ff4eb8ab7c283462242468b05f8aff3cf2cf1
1183,bc1qz6lks9udfn78vx3cju9uyc6kqk6739hndak4ct,1767,2256979,2256979,2022-12-09 06:17:30,2022-07-27 21:42:15,0,inbound,67af70604a7ba416de056a38623ff4eb8ab7c283462242468b05f8aff3cf2cf1
1184,bc1qz6lks9udfn78vx3cju9uyc6kqk6739hndak4ct,1768,29067,0,2022-12-09 04:23:11,2022-12-09 04:23:11,29067,inbound,67af70604a7ba416de056a38623ff4eb8ab7c283462242468b05f8aff3cf2cf1
1185,bc1qz6lks9udfn78vx3cju9uyc6kqk6739hndak4ct,1769,206330,206330,2022-12-23 20:01:09,2022-12-09 04:23:11,0,inbound,67af70604a7ba416de056a38623ff4eb8ab7c283462242468b05f8aff3cf2cf1
1186,bc1qz6lks9udfn78vx3cju9uyc6kqk6739hndak4ct,1770,2488781,2488781,2022-12-12 09:08:19,2022-12-09 04:23:11,0,inbound,67af70604a7ba416de056a38623ff4eb8ab7c283462242468b05f8aff3cf2cf1
1187,bc1qz6lks9udfn78vx3cju9uyc6kqk6739hndak4ct,1771,235287,235287,2022-12-09 10:05:55,2022-12-09 04:23:11,0,inbound,67af70604a7ba416de056a38623ff4eb8ab7c283462242468b05f8aff3cf2cf1
1188,bc1qz6lks9udfn78vx3cju9uyc6kqk6739hndak4ct,1772,273339,273339,2022-12-12 17:30:08,2022-12-09 04:23:11,0,inbound,67af70604a7ba416de056a38623ff4eb8ab7c283462242468b05f8aff3cf2cf1
1189,bc1qz6lks9udfn78vx3cju9uyc6kqk6739hndak4ct,1773,3758512,3758512,2022-12-15 05:42:14,2022-11-21 20:54:09,0,inbound,67af70604a7ba416de056a38623ff4eb8ab7c283462242468b05f8aff3cf2cf1
1190,bc1qz6lks9udfn78vx3cju9uyc6kqk6739hndak4ct,1774,290600,290600,2022-12-13 17:35:22,2022-12-09 04:23:11,0,inbound,67af70604a7ba416de056a38623ff4eb8ab7c283462242468b05f8aff3cf2cf1
1191,bc1qz6lks9udfn78vx3cju9uyc6kqk6739hndak4ct,1775,2906227,2906227,2022-12-31 02:30:47,2022-12-09 04:23:11,0,inbound,67af70604a7ba416de056a38623ff4eb8ab7c283462242468b05f8aff3cf2cf1
1192,bc1qz6lks9udfn78vx3cju9uyc6kqk6739hndak4ct,1776,215065,215065,2022-12-09 06:50:20,2022-12-09 04:23:11,0,inbound,67af70604a7ba416de056a38623ff4eb8ab7c283462242468b05f8aff3cf2cf1
1193,bc1qz6lks9udfn78vx3cju9uyc6kqk6739hndak4ct,1777,275772,275772,2022-12-09 06:26:12,2022-12-09 04:23:11,0,inbound,67af70604a7ba416de056a38623ff4eb8ab7c283462242468b05f8aff3cf2cf1
1194,bc1qz6lks9udfn78vx3cju9uyc6kqk6739hndak4ct,1778,1666636,1666636,2022-12-09 05:03:35,2022-12-09 04:23:11,0,inbound,67af70604a7ba416de056a38623ff4eb8ab7c283462242468b05f8aff3cf2cf1
1195,bc1qz6lks9udfn78vx3cju9uyc6kqk6739hndak4ct,1779,592883,592883,2022-12-09 05:55:13,2022-12-09 04:23:11,0,inbound,67af70604a7ba416de056a38623ff4eb8ab7c283462242468b05f8aff3cf2cf1
1196,bc1qz6lks9udfn78vx3cju9uyc6kqk6739hndak4ct,1780,11546570310,11546570310,2023-03-06 13:50:39,2023-02-27 14:57:07,0,inbound,67af70604a7ba416de056a38623ff4eb8ab7c283462242468b05f8aff3cf2cf1
1197,bc1qz6lks9udfn78vx3cju9uyc6kqk6739hndak4ct,1781,552156,552156,2022-12-12 15:36:56,2022-12-09 04:23:11,0,inbound,67af70604a7ba416de056a38623ff4eb8ab7c283462242468b05f8aff3cf2cf1
1198,bc1qz6lks9udfn78vx3cju9uyc6kqk6739hndak4ct,1782,674167722,674018900,2023-04-10 10:40:31,2023-03-18 10:18:42,148822,outbound,67af70604a7ba416de056a38623ff4eb8ab7c283462242468b05f8aff3cf2cf1
1199,bc1qz6lks9udfn78vx3cju9uyc6kqk6739hndak4ct,1783,221765,221765,2023-01-23 00:28:18,2022-12-09 04:23:11,0,inbound,67af70604a7ba416de056a38623ff4eb8ab7c283462242468b05f8aff3cf2cf1
1200,bc1qz6lks9udfn78vx3cju9uyc6kqk6739hndak4ct,1784,554384,554384,2022-12-22 04:56:27,2022-12-09 04:23:11,0,inbound,67af70604a7ba416de056a38623ff4eb8ab7c283462242468b05f8aff3cf2cf1
1201,bc1qz6lks9udfn78vx3cju9uyc6kqk6739hndak4ct,1785,25316744,25316744,2023-01-05 12:10:07,2022-12-09 03:58:09,0,inbound,67af70604a7ba416de056a38623ff4eb8ab7c283462242468b05f8aff3cf2cf1
1202,bc1qz6lks9udfn78vx3cju9uyc6kqk6739hndak4ct,1786,1302202,1302202,2022-12-09 05:03:35,2022-12-09 04:23:11,0,inbound,67af70604a7ba416de056a38623ff4eb8ab7c283462242468b05f8aff3cf2cf1
1203,bc1qz6lks9udfn78vx3cju9uyc6kqk6739hndak4ct,1787,44353430,43811098,2023-04-10 00:57:07,2022-12-12 00:41:01,542332,outbound,67af70604a7ba416de056a38623ff4eb8ab7c283462242468b05f8aff3cf2cf1
1204,bc1qz6lks9udfn78vx3cju9uyc6kqk6739hndak4ct,1788,64000,64000,2022-12-09 04:40:48,2022-12-09 04:23:11,0,inbound,67af70604a7ba416de056a38623ff4eb8ab7c283462242468b05f8aff3cf2cf1
1205,bc1qz6lks9udfn78vx3cju9uyc6kqk6739hndak4ct,1789,34878,34878,2022-12-09 04:50:31,2022-12-09 04:23:11,0,inbound,67af70604a7ba416de056a38623ff4eb8ab7c283462242468b05f8aff3cf2cf1
1206,bc1qz6lks9udfn78vx3cju9uyc6kqk6739hndak4ct,1790,160076,160076,2022-12-09 06:32:12,2022-12-09 04:23:11,0,inbound,67af70604a7ba416de056a38623ff4eb8ab7c283462242468b05f8aff3cf2cf1
1207,bc1qz6lks9udfn78vx3cju9uyc6kqk6739hndak4ct,1791,1104597,1104597,2022-12-09 04:46:54,2022-12-09 04:23:11,0,inbound,67af70604a7ba416de056a38623ff4eb8ab7c283462242468b05f8aff3cf2cf1
1208,bc1qz6lks9udfn78vx3cju9uyc6kqk6739hndak4ct,1792,523281,523281,2022-12-12 16:59:14,2022-12-09 04:23:11,0,inbound,67af70604a7ba416de056a38623ff4eb8ab7c283462242468b05f8aff3cf2cf1
1209,bc1qz6lks9udfn78vx3cju9uyc6kqk6739hndak4ct,1793,13494694,13369352,2023-04-08 00:10:26,2022-07-20 19:52:24,125342,outbound,67af70604a7ba416de056a38623ff4eb8ab7c283462242468b05f8aff3cf2cf1
1210,bc1qz6lks9udfn78vx3cju9uyc6kqk6739hndak4ct,1794,143361,143361,2023-01-04 07:42:06,2022-12-08 02:06:36,0,inbound,67af70604a7ba416de056a38623ff4eb8ab7c283462242468b05f8aff3cf2cf1
1211,bc1qz6lks9udfn78vx3cju9uyc6kqk6739hndak4ct,1795,160111,160111,2022-12-09 07:58:18,2022-12-09 04:23:11,0,inbound,67af70604a7ba416de056a38623ff4eb8ab7c283462242468b05f8aff3cf2cf1
1212,bc1qz6lks9udfn78vx3cju9uyc6kqk6739hndak4ct,1796,16129310,16129310,2023-02-19 05:12:44,2022-10-08 15:33:31,0,inbound,67af70604a7ba416de056a38623ff4eb8ab7c283462242468b05f8aff3cf2cf1
1213,bc1qz6lks9udfn78vx3cju9uyc6kqk6739hndak4ct,1797,284836,284836,2022-12-09 06:25:12,2022-12-09 04:23:11,0,inbound,67af70604a7ba416de056a38623ff4eb8ab7c283462242468b05f8aff3cf2cf1
1214,bc1qz6lks9udfn78vx3cju9uyc6kqk6739hndak4ct,1798,58140077,58140077,2023-03-10 01:46:02,2022-05-31 02:03:07,0,inbound,67af70604a7ba416de056a38623ff4eb8ab7c283462242468b05f8aff3cf2cf1
1215,bc1qz6lks9udfn78vx3cju9uyc6kqk6739hndak4ct,1799,344881229,342843317,2023-04-07 00:52:21,2023-01-15 23:37:10,2037912,inbound,67af70604a7ba416de056a38623ff4eb8ab7c283462242468b05f8aff3cf2cf1
1216,bc1qz6lks9udfn78vx3cju9uyc6kqk6739hndak4ct,1800,5477822,253664,2023-03-17 23:10:08,2022-06-21 00:41:08,5224158,inbound,67af70604a7ba416de056a38623ff4eb8ab7c283462242468b05f8aff3cf2cf1
1217,bc1qz6lks9udfn78vx3cju9uyc6kqk6739hndak4ct,1801,85849922,85791225,2023-04-10 17:27:09,2023-03-12 19:51:08,58697,inbound,67af70604a7ba416de056a38623ff4eb8ab7c283462242468b05f8aff3cf2cf1
1218,bc1qz6lks9udfn78vx3cju9uyc6kqk6739hndak4ct,618,1733390,1733390,2022-12-28 23:12:18,2022-12-28 21:55:38,0,inbound,5973c5ebd0409e47edaadd0efa92fd0a3806012457163e14e63ab083bbf4f491
1219,bc1qz6lks9udfn78vx3cju9uyc6kqk6739hndak4ct,849,108756,108756,2022-12-27 05:01:37,2022-12-26 19:27:29,0,inbound,5973c5ebd0409e47edaadd0efa92fd0a3806012457163e14e63ab083bbf4f491
1220,bc1qz6lks9udfn78vx3cju9uyc6kqk6739hndak4ct,1013,4695896084,4695747955,2023-04-10 01:36:28,2023-03-08 08:01:59,148129,outbound,5973c5ebd0409e47edaadd0efa92fd0a3806012457163e14e63ab083bbf4f491
1221,bc1qz6lks9udfn78vx3cju9uyc6kqk6739hndak4ct,1315,279906,279906,2022-12-19 03:15:13,2022-12-17 01:29:03,0,inbound,5973c5ebd0409e47edaadd0efa92fd0a3806012457163e14e63ab083bbf4f491
1222,bc1qz6lks9udfn78vx3cju9uyc6kqk6739hndak4ct,1802,2843960,2843960,2022-12-12 15:04:20,2022-12-07 23:11:06,0,inbound,5973c5ebd0409e47edaadd0efa92fd0a3806012457163e14e63ab083bbf4f491
1223,bc1qz6lks9udfn78vx3cju9uyc6kqk6739hndak4ct,619,140470,140470,2022-12-29 05:01:39,2022-12-28 21:55:38,0,inbound,5d2fbda03bd9e50b92e4dd240be24ee687be28775e6deca410afe26f8484c948
1224,bc1qz6lks9udfn78vx3cju9uyc6kqk6739hndak4ct,850,272368687,272368687,2023-04-09 06:05:54,2023-03-12 13:52:17,0,inbound,5d2fbda03bd9e50b92e4dd240be24ee687be28775e6deca410afe26f8484c948
1225,bc1qz6lks9udfn78vx3cju9uyc6kqk6739hndak4ct,1014,564746,564746,2022-12-29 02:30:26,2022-12-22 23:44:44,0,inbound,5d2fbda03bd9e50b92e4dd240be24ee687be28775e6deca410afe26f8484c948
1226,bc1qz6lks9udfn78vx3cju9uyc6kqk6739hndak4ct,1316,166882438,166882438,2023-04-10 04:06:13,2023-03-19 22:07:51,0,outbound,5d2fbda03bd9e50b92e4dd240be24ee687be28775e6deca410afe26f8484c948
1227,bc1qz6lks9udfn78vx3cju9uyc6kqk6739hndak4ct,1803,558004,558004,2022-12-09 05:01:06,2022-12-09 04:23:11,0,inbound,5d2fbda03bd9e50b92e4dd240be24ee687be28775e6deca410afe26f8484c948
1228,bc1qz6lks9udfn78vx3cju9uyc6kqk6739hndak4ct,620,23699577,23699577,2023-03-14 20:54:49,2022-12-28 02:19:25,0,outbound,78d9c7a5a36baf6df4f6f03c8a51451750b470fe4176485b23c5dd9505f6d2a2
1229,bc1qz6lks9udfn78vx3cju9uyc6kqk6739hndak4ct,621,147676278,147676278,2023-04-09 01:23:59,2023-01-03 16:42:45,0,inbound,78d9c7a5a36baf6df4f6f03c8a51451750b470fe4176485b23c5dd9505f6d2a2
1230,bc1qz6lks9udfn78vx3cju9uyc6kqk6739hndak4ct,622,282594,282594,2022-12-31 22:00:25,2022-12-28 21:55:38,0,inbound,78d9c7a5a36baf6df4f6f03c8a51451750b470fe4176485b23c5dd9505f6d2a2
1231,bc1qz6lks9udfn78vx3cju9uyc6kqk6739hndak4ct,623,11145752,11132782,2023-03-21 21:03:47,2022-07-29 19:37:58,12970,inbound,78d9c7a5a36baf6df4f6f03c8a51451750b470fe4176485b23c5dd9505f6d2a2
1232,bc1qz6lks9udfn78vx3cju9uyc6kqk6739hndak4ct,851,359718080,359718080,2023-03-22 17:04:42,2023-01-21 01:56:08,0,inbound,78d9c7a5a36baf6df4f6f03c8a51451750b470fe4176485b23c5dd9505f6d2a2
1233,bc1qz6lks9udfn78vx3cju9uyc6kqk6739hndak4ct,852,237485,237485,2022-12-27 00:05:16,2022-12-26 19:27:29,0,inbound,78d9c7a5a36baf6df4f6f03c8a51451750b470fe4176485b23c5dd9505f6d2a2
1234,bc1qz6lks9udfn78vx3cju9uyc6kqk6739hndak4ct,853,106919792,106919792,2023-01-11 10:05:17,2022-12-09 06:06:11,0,inbound,78d9c7a5a36baf6df4f6f03c8a51451750b470fe4176485b23c5dd9505f6d2a2
1235,bc1qz6lks9udfn78vx3cju9uyc6kqk6739hndak4ct,854,19166578,19166578,2022-12-28 22:01:10,2022-08-25 01:15:09,0,inbound,78d9c7a5a36baf6df4f6f03c8a51451750b470fe4176485b23c5dd9505f6d2a2
1236,bc1qz6lks9udfn78vx3cju9uyc6kqk6739hndak4ct,1015,861376,861376,2022-12-23 11:56:58,2022-12-22 23:44:44,0,inbound,78d9c7a5a36baf6df4f6f03c8a51451750b470fe4176485b23c5dd9505f6d2a2
1237,bc1qz6lks9udfn78vx3cju9uyc6kqk6739hndak4ct,1016,225939,225939,2022-12-23 07:10:19,2022-12-22 23:44:44,0,inbound,78d9c7a5a36baf6df4f6f03c8a51451750b470fe4176485b23c5dd9505f6d2a2
1238,bc1qz6lks9udfn78vx3cju9uyc6kqk6739hndak4ct,1017,55892374,54380732,2023-04-09 19:40:50,2022-12-25 03:30:28,1511642,inbound,78d9c7a5a36baf6df4f6f03c8a51451750b470fe4176485b23c5dd9505f6d2a2
1239,bc1qz6lks9udfn78vx3cju9uyc6kqk6739hndak4ct,1018,101254333968,101253980698,2023-04-10 15:47:09,2023-03-10 10:12:49,353270,outbound,78d9c7a5a36baf6df4f6f03c8a51451750b470fe4176485b23c5dd9505f6d2a2
1240,bc1qz6lks9udfn78vx3cju9uyc6kqk6739hndak4ct,1317,121682,121682,2022-12-20 02:25:50,2022-12-17 01:29:03,0,inbound,78d9c7a5a36baf6df4f6f03c8a51451750b470fe4176485b23c5dd9505f6d2a2
1241,bc1qz6lks9udfn78vx3cju9uyc6kqk6739hndak4ct,1318,1899575602,1899575602,2023-04-10 06:14:48,2023-02-24 01:53:10,0,inbound,78d9c7a5a36baf6df4f6f03c8a51451750b470fe4176485b23c5dd9505f6d2a2
1242,bc1qz6lks9udfn78vx3cju9uyc6kqk6739hndak4ct,1319,748897,748897,2022-12-17 05:01:44,2022-12-17 01:29:03,0,inbound,78d9c7a5a36baf6df4f6f03c8a51451750b470fe4176485b23c5dd9505f6d2a2
1243,bc1qz6lks9udfn78vx3cju9uyc6kqk6739hndak4ct,1320,245629,245629,2022-12-21 04:46:23,2022-12-17 01:29:03,0,inbound,78d9c7a5a36baf6df4f6f03c8a51451750b470fe4176485b23c5dd9505f6d2a2
1244,bc1qz6lks9udfn78vx3cju9uyc6kqk6739hndak4ct,1804,79843749,79843749,2023-02-18 13:05:42,2022-12-24 05:56:44,0,outbound,78d9c7a5a36baf6df4f6f03c8a51451750b470fe4176485b23c5dd9505f6d2a2
1245,bc1qz6lks9udfn78vx3cju9uyc6kqk6739hndak4ct,1805,2223450,2223450,2022-12-09 17:03:30,2022-12-09 04:23:11,0,inbound,78d9c7a5a36baf6df4f6f03c8a51451750b470fe4176485b23c5dd9505f6d2a2
1246,bc1qz6lks9udfn78vx3cju9uyc6kqk6739hndak4ct,1806,576551,0,2022-12-09 04:23:11,2022-12-09 04:23:11,576551,inbound,78d9c7a5a36baf6df4f6f03c8a51451750b470fe4176485b23c5dd9505f6d2a2
1247,bc1qz6lks9udfn78vx3cju9uyc6kqk6739hndak4ct,1807,277335,277335,2022-12-10 20:20:18,2022-12-09 04:23:11,0,inbound,78d9c7a5a36baf6df4f6f03c8a51451750b470fe4176485b23c5dd9505f6d2a2
1248,bc1qz6lks9udfn78vx3cju9uyc6kqk6739hndak4ct,624,400851,0,2022-12-28 21:55:38,2022-12-28 21:55:38,400851,inbound,7a5f1e348d19b90dbd81d59cb84fc8a93fbb657707fd180c327db1bfb2c3d034
1249,bc1qz6lks9udfn78vx3cju9uyc6kqk6739hndak4ct,625,225601,225601,2022-12-29 05:46:36,2022-12-28 21:55:38,0,inbound,7a5f1e348d19b90dbd81d59cb84fc8a93fbb657707fd180c327db1bfb2c3d034
1250,bc1qz6lks9udfn78vx3cju9uyc6kqk6739hndak4ct,855,181009,181009,2022-12-26 19:30:44,2022-12-26 19:27:29,0,inbound,7a5f1e348d19b90dbd81d59cb84fc8a93fbb657707fd180c327db1bfb2c3d034
1251,bc1qz6lks9udfn78vx3cju9uyc6kqk6739hndak4ct,856,7862935,7862935,2023-04-09 13:07:19,2022-12-26 18:21:09,0,inbound,7a5f1e348d19b90dbd81d59cb84fc8a93fbb657707fd180c327db1bfb2c3d034
1252,bc1qz6lks9udfn78vx3cju9uyc6kqk6739hndak4ct,1019,84636513,84447833,2023-04-10 08:25:20,2022-12-26 01:38:58,188680,inbound,7a5f1e348d19b90dbd81d59cb84fc8a93fbb657707fd180c327db1bfb2c3d034
1253,bc1qz6lks9udfn78vx3cju9uyc6kqk6739hndak4ct,1020,202047,202047,2022-12-25 18:15:28,2022-12-22 23:44:44,0,inbound,7a5f1e348d19b90dbd81d59cb84fc8a93fbb657707fd180c327db1bfb2c3d034
1254,bc1qz6lks9udfn78vx3cju9uyc6kqk6739hndak4ct,1321,24391445,23256749,2023-04-10 11:20:52,2022-12-20 04:24:53,1134696,outbound,7a5f1e348d19b90dbd81d59cb84fc8a93fbb657707fd180c327db1bfb2c3d034
1255,bc1qz6lks9udfn78vx3cju9uyc6kqk6739hndak4ct,1322,16645057,16645057,2023-04-06 10:59:23,2022-07-14 10:49:29,0,outbound,7a5f1e348d19b90dbd81d59cb84fc8a93fbb657707fd180c327db1bfb2c3d034
1256,bc1qz6lks9udfn78vx3cju9uyc6kqk6739hndak4ct,1808,1378024,1378024,2023-01-09 07:13:38,2022-12-09 01:09:09,0,inbound,7a5f1e348d19b90dbd81d59cb84fc8a93fbb657707fd180c327db1bfb2c3d034
1257,bc1qz6lks9udfn78vx3cju9uyc6kqk6739hndak4ct,1809,80676,80676,2022-12-09 06:03:09,2022-12-09 04:23:11,0,inbound,7a5f1e348d19b90dbd81d59cb84fc8a93fbb657707fd180c327db1bfb2c3d034
1258,bc1qz6lks9udfn78vx3cju9uyc6kqk6739hndak4ct,626,105198578,105198578,2023-04-08 18:19:25,2022-10-31 21:21:11,0,inbound,4d8d865d0e1e1101b9b5135c8ce1ad6870987f36e946535eaae59e417867ec94
1259,bc1qz6lks9udfn78vx3cju9uyc6kqk6739hndak4ct,627,442600349,442600349,2023-04-09 01:45:23,2022-12-16 21:35:49,0,inbound,4d8d865d0e1e1101b9b5135c8ce1ad6870987f36e946535eaae59e417867ec94
1260,bc1qz6lks9udfn78vx3cju9uyc6kqk6739hndak4ct,857,630744,630744,2022-12-27 15:45:05,2022-12-26 19:27:29,0,inbound,4d8d865d0e1e1101b9b5135c8ce1ad6870987f36e946535eaae59e417867ec94
1261,bc1qz6lks9udfn78vx3cju9uyc6kqk6739hndak4ct,858,421528,421528,2022-12-26 20:30:49,2022-12-26 19:27:29,0,inbound,4d8d865d0e1e1101b9b5135c8ce1ad6870987f36e946535eaae59e417867ec94
1262,bc1qz6lks9udfn78vx3cju9uyc6kqk6739hndak4ct,1021,83855248,83164024,2023-04-05 13:29:05,2023-01-07 09:19:04,691224,outbound,4d8d865d0e1e1101b9b5135c8ce1ad6870987f36e946535eaae59e417867ec94
1263,bc1qz6lks9udfn78vx3cju9uyc6kqk6739hndak4ct,1022,773531303,773531303,2023-03-14 16:53:22,2023-02-09 00:43:13,0,outbound,4d8d865d0e1e1101b9b5135c8ce1ad6870987f36e946535eaae59e417867ec94
1264,bc1qz6lks9udfn78vx3cju9uyc6kqk6739hndak4ct,1323,47567652,46838620,2023-04-10 08:26:06,2023-03-09 20:47:19,729032,inbound,4d8d865d0e1e1101b9b5135c8ce1ad6870987f36e946535eaae59e417867ec94
1265,bc1qz6lks9udfn78vx3cju9uyc6kqk6739hndak4ct,1324,203646,203646,2022-12-17 03:46:13,2022-12-17 01:29:03,0,inbound,4d8d865d0e1e1101b9b5135c8ce1ad6870987f36e946535eaae59e417867ec94
1266,bc1qz6lks9udfn78vx3cju9uyc6kqk6739hndak4ct,1810,217954,217954,2022-12-13 14:19:52,2022-12-09 04:23:11,0,inbound,4d8d865d0e1e1101b9b5135c8ce1ad6870987f36e946535eaae59e417867ec94
1267,bc1qz6lks9udfn78vx3cju9uyc6kqk6739hndak4ct,1811,1180028,1180028,2023-02-16 13:24:14,2022-12-04 04:45:10,0,inbound,4d8d865d0e1e1101b9b5135c8ce1ad6870987f36e946535eaae59e417867ec94
1268,bc1qz6lks9udfn78vx3cju9uyc6kqk6739hndak4ct,628,54940811,46243494,2023-03-12 10:33:57,2021-09-19 08:15:39,8697317,inbound,1dfce722ac8711093ab680f05a33db4bdd6f6cc38ef29726e6aea485d7a75927
1269,bc1qz6lks9udfn78vx3cju9uyc6kqk6739hndak4ct,629,41171204,41171204,2023-01-20 16:03:06,2023-01-01 17:54:09,0,inbound,1dfce722ac8711093ab680f05a33db4bdd6f6cc38ef29726e6aea485d7a75927
1270,bc1qz6lks9udfn78vx3cju9uyc6kqk6739hndak4ct,859,1415275,1415275,2022-12-26 20:51:20,2022-12-26 19:27:29,0,inbound,1dfce722ac8711093ab680f05a33db4bdd6f6cc38ef29726e6aea485d7a75927
1271,bc1qz6lks9udfn78vx3cju9uyc6kqk6739hndak4ct,1023,1739782,1739782,2022-12-23 06:05:12,2022-12-22 23:44:44,0,inbound,1dfce722ac8711093ab680f05a33db4bdd6f6cc38ef29726e6aea485d7a75927
1272,bc1qz6lks9udfn78vx3cju9uyc6kqk6739hndak4ct,1024,423172,423172,2022-12-25 09:02:57,2022-12-22 23:44:44,0,inbound,1dfce722ac8711093ab680f05a33db4bdd6f6cc38ef29726e6aea485d7a75927
1273,bc1qz6lks9udfn78vx3cju9uyc6kqk6739hndak4ct,1325,33231431,31491319,2023-04-10 00:05:01,2022-11-02 01:32:15,1740112,inbound,1dfce722ac8711093ab680f05a33db4bdd6f6cc38ef29726e6aea485d7a75927
1274,bc1qz6lks9udfn78vx3cju9uyc6kqk6739hndak4ct,1326,57288,57288,2022-12-17 07:03:48,2022-12-17 01:29:03,0,inbound,1dfce722ac8711093ab680f05a33db4bdd6f6cc38ef29726e6aea485d7a75927
1275,bc1qz6lks9udfn78vx3cju9uyc6kqk6739hndak4ct,1812,15172301,9793319,2022-12-27 18:28:09,2022-12-09 04:23:11,5378982,inbound,1dfce722ac8711093ab680f05a33db4bdd6f6cc38ef29726e6aea485d7a75927
1276,bc1qz6lks9udfn78vx3cju9uyc6kqk6739hndak4ct,1813,23627412,23627412,2023-01-22 10:45:09,2022-12-08 15:33:45,0,inbound,1dfce722ac8711093ab680f05a33db4bdd6f6cc38ef29726e6aea485d7a75927
1277,bc1qz6lks9udfn78vx3cju9uyc6kqk6739hndak4ct,630,134517,134517,2023-01-03 18:57:47,2022-12-28 21:55:38,0,inbound,a47a6169afe5ee1954c23ddb7bde0cb8939217c2628e424387b374907533f6fe
1278,bc1qz6lks9udfn78vx3cju9uyc6kqk6739hndak4ct,631,122659,122659,2023-01-03 23:24:34,2022-12-28 21:55:38,0,inbound,a47a6169afe5ee1954c23ddb7bde0cb8939217c2628e424387b374907533f6fe
1279,bc1qz6lks9udfn78vx3cju9uyc6kqk6739hndak4ct,632,104924,104924,2023-01-04 01:41:10,2022-12-28 21:55:38,0,inbound,a47a6169afe5ee1954c23ddb7bde0cb8939217c2628e424387b374907533f6fe
1280,bc1qz6lks9udfn78vx3cju9uyc6kqk6739hndak4ct,633,184979508,184979508,2023-03-19 09:50:06,2023-01-25 08:07:19,0,outbound,a47a6169afe5ee1954c23ddb7bde0cb8939217c2628e424387b374907533f6fe
1281,bc1qz6lks9udfn78vx3cju9uyc6kqk6739hndak4ct,634,12115316,12115316,2022-12-28 23:07:03,2022-12-28 21:55:38,0,inbound,a47a6169afe5ee1954c23ddb7bde0cb8939217c2628e424387b374907533f6fe
1282,bc1qz6lks9udfn78vx3cju9uyc6kqk6739hndak4ct,1025,136757,136757,2022-12-30 18:55:35,2022-12-22 23:44:44,0,inbound,a47a6169afe5ee1954c23ddb7bde0cb8939217c2628e424387b374907533f6fe
1283,bc1qz6lks9udfn78vx3cju9uyc6kqk6739hndak4ct,1026,299502051,299479077,2023-04-07 04:42:50,2022-12-23 16:48:17,22974,inbound,a47a6169afe5ee1954c23ddb7bde0cb8939217c2628e424387b374907533f6fe
1284,bc1qz6lks9udfn78vx3cju9uyc6kqk6739hndak4ct,1027,6383833,6383833,2023-04-06 02:15:04,2022-08-22 00:38:55,0,inbound,a47a6169afe5ee1954c23ddb7bde0cb8939217c2628e424387b374907533f6fe
1285,bc1qz6lks9udfn78vx3cju9uyc6kqk6739hndak4ct,1028,62818,62818,2022-12-23 06:03:49,2022-12-22 23:44:44,0,inbound,a47a6169afe5ee1954c23ddb7bde0cb8939217c2628e424387b374907533f6fe
1286,bc1qz6lks9udfn78vx3cju9uyc6kqk6739hndak4ct,1029,365034,365034,2022-12-26 17:34:14,2022-12-22 23:44:44,0,inbound,a47a6169afe5ee1954c23ddb7bde0cb8939217c2628e424387b374907533f6fe
1287,bc1qz6lks9udfn78vx3cju9uyc6kqk6739hndak4ct,1327,367662,367662,2022-12-17 07:03:48,2022-12-17 01:29:03,0,inbound,a47a6169afe5ee1954c23ddb7bde0cb8939217c2628e424387b374907533f6fe
1288,bc1qz6lks9udfn78vx3cju9uyc6kqk6739hndak4ct,1328,104323,104323,2022-12-17 10:42:59,2022-12-17 01:29:03,0,inbound,a47a6169afe5ee1954c23ddb7bde0cb8939217c2628e424387b374907533f6fe
1289,bc1qz6lks9udfn78vx3cju9uyc6kqk6739hndak4ct,1329,598802,598802,2022-12-17 05:01:40,2022-12-17 01:29:03,0,inbound,a47a6169afe5ee1954c23ddb7bde0cb8939217c2628e424387b374907533f6fe
1290,bc1qz6lks9udfn78vx3cju9uyc6kqk6739hndak4ct,1330,209462,209462,2022-12-17 19:54:12,2022-12-17 01:29:03,0,inbound,a47a6169afe5ee1954c23ddb7bde0cb8939217c2628e424387b374907533f6fe
1291,bc1qz6lks9udfn78vx3cju9uyc6kqk6739hndak4ct,1331,262148,262148,2022-12-17 05:01:31,2022-12-17 01:29:03,0,inbound,a47a6169afe5ee1954c23ddb7bde0cb8939217c2628e424387b374907533f6fe
1292,bc1qz6lks9udfn78vx3cju9uyc6kqk6739hndak4ct,1814,23254,0,2022-12-09 04:23:11,2022-12-09 04:23:11,23254,inbound,a47a6169afe5ee1954c23ddb7bde0cb8939217c2628e424387b374907533f6fe
1293,bc1qz6lks9udfn78vx3cju9uyc6kqk6739hndak4ct,1815,533276,533276,2022-12-22 04:56:27,2022-12-09 04:23:11,0,inbound,a47a6169afe5ee1954c23ddb7bde0cb8939217c2628e424387b374907533f6fe
1294,bc1qz6lks9udfn78vx3cju9uyc6kqk6739hndak4ct,1816,4023971,4023971,2022-12-09 05:10:45,2022-12-09 04:23:11,0,inbound,a47a6169afe5ee1954c23ddb7bde0cb8939217c2628e424387b374907533f6fe
1295,bc1qz6lks9udfn78vx3cju9uyc6kqk6739hndak4ct,635,2880863588,2880863588,2023-03-14 10:41:34,2023-01-11 20:40:22,0,outbound,dcbdff8087beaa3a41a94d638f126367ad0fda5816d05b49d35da9e4552ae784
1296,bc1qz6lks9udfn78vx3cju9uyc6kqk6739hndak4ct,1030,132559,132559,2022-12-23 05:01:46,2022-12-22 23:44:44,0,inbound,dcbdff8087beaa3a41a94d638f126367ad0fda5816d05b49d35da9e4552ae784
1297,bc1qz6lks9udfn78vx3cju9uyc6kqk6739hndak4ct,1332,407302973,395994319,2023-04-01 07:22:48,2021-07-16 03:14:45,11308654,inbound,dcbdff8087beaa3a41a94d638f126367ad0fda5816d05b49d35da9e4552ae784
1298,bc1qz6lks9udfn78vx3cju9uyc6kqk6739hndak4ct,636,4002642780,3999447856,2023-03-18 14:02:30,2023-03-04 22:23:43,3194924,inbound,32109ed86ba84fa3652b5044ea7d716c019343017b6b8c8c214d4971fd8c0b62
1299,bc1qz6lks9udfn78vx3cju9uyc6kqk6739hndak4ct,637,312120,312120,2022-12-29 00:02:20,2022-12-28 21:55:38,0,inbound,32109ed86ba84fa3652b5044ea7d716c019343017b6b8c8c214d4971fd8c0b62
1300,bc1qz6lks9udfn78vx3cju9uyc6kqk6739hndak4ct,638,645442,645442,2022-12-29 00:02:23,2022-12-28 21:55:38,0,inbound,32109ed86ba84fa3652b5044ea7d716c019343017b6b8c8c214d4971fd8c0b62
1301,bc1qz6lks9udfn78vx3cju9uyc6kqk6739hndak4ct,639,78417577,77870115,2023-04-10 08:25:58,2023-03-02 18:00:48,547462,outbound,32109ed86ba84fa3652b5044ea7d716c019343017b6b8c8c214d4971fd8c0b62
1302,bc1qz6lks9udfn78vx3cju9uyc6kqk6739hndak4ct,640,220307867,220307867,2023-03-31 18:04:19,2023-02-19 08:45:42,0,inbound,32109ed86ba84fa3652b5044ea7d716c019343017b6b8c8c214d4971fd8c0b62
1303,bc1qz6lks9udfn78vx3cju9uyc6kqk6739hndak4ct,641,145374,145374,2022-12-29 12:11:19,2022-12-28 21:55:38,0,inbound,32109ed86ba84fa3652b5044ea7d716c019343017b6b8c8c214d4971fd8c0b62
1304,bc1qz6lks9udfn78vx3cju9uyc6kqk6739hndak4ct,642,272254,272254,2022-12-31 22:00:25,2022-12-28 21:55:38,0,inbound,32109ed86ba84fa3652b5044ea7d716c019343017b6b8c8c214d4971fd8c0b62
1305,bc1qz6lks9udfn78vx3cju9uyc6kqk6739hndak4ct,643,121169,121169,2023-01-03 23:24:34,2022-12-28 21:55:38,0,inbound,32109ed86ba84fa3652b5044ea7d716c019343017b6b8c8c214d4971fd8c0b62
1306,bc1qz6lks9udfn78vx3cju9uyc6kqk6739hndak4ct,644,674780170,674780170,2023-01-10 02:38:09,2022-12-18 01:03:58,0,inbound,32109ed86ba84fa3652b5044ea7d716c019343017b6b8c8c214d4971fd8c0b62
1307,bc1qz6lks9udfn78vx3cju9uyc6kqk6739hndak4ct,645,227017753,227017753,2022-12-29 01:54:59,2022-12-28 21:55:38,0,inbound,32109ed86ba84fa3652b5044ea7d716c019343017b6b8c8c214d4971fd8c0b62
1308,bc1qz6lks9udfn78vx3cju9uyc6kqk6739hndak4ct,646,327936609,326227404,2023-04-09 18:53:27,2023-02-11 14:49:37,1709205,outbound,32109ed86ba84fa3652b5044ea7d716c019343017b6b8c8c214d4971fd8c0b62
1309,bc1qz6lks9udfn78vx3cju9uyc6kqk6739hndak4ct,647,9880,9880,2023-01-02 07:53:07,2022-12-28 21:55:38,0,inbound,32109ed86ba84fa3652b5044ea7d716c019343017b6b8c8c214d4971fd8c0b62
1310,bc1qz6lks9udfn78vx3cju9uyc6kqk6739hndak4ct,648,119761135,119761135,2023-04-06 22:02:49,2023-01-26 14:59:39,0,outbound,32109ed86ba84fa3652b5044ea7d716c019343017b6b8c8c214d4971fd8c0b62
1311,bc1qz6lks9udfn78vx3cju9uyc6kqk6739hndak4ct,649,8934605,8934605,2022-12-28 22:03:44,2022-12-28 21:55:38,0,inbound,32109ed86ba84fa3652b5044ea7d716c019343017b6b8c8c214d4971fd8c0b62
1312,bc1qz6lks9udfn78vx3cju9uyc6kqk6739hndak4ct,650,1173661,1173661,2022-12-29 00:10:14,2022-12-28 21:55:38,0,inbound,32109ed86ba84fa3652b5044ea7d716c019343017b6b8c8c214d4971fd8c0b62
1313,bc1qz6lks9udfn78vx3cju9uyc6kqk6739hndak4ct,651,209824,209824,2023-01-03 11:43:26,2022-12-28 21:55:38,0,inbound,32109ed86ba84fa3652b5044ea7d716c019343017b6b8c8c214d4971fd8c0b62
1314,bc1qz6lks9udfn78vx3cju9uyc6kqk6739hndak4ct,652,1173842,1173842,2023-01-19 09:38:43,2022-12-28 21:55:38,0,inbound,32109ed86ba84fa3652b5044ea7d716c019343017b6b8c8c214d4971fd8c0b62
1315,bc1qz6lks9udfn78vx3cju9uyc6kqk6739hndak4ct,653,163536,163536,2022-12-29 01:03:44,2022-12-28 21:55:38,0,inbound,32109ed86ba84fa3652b5044ea7d716c019343017b6b8c8c214d4971fd8c0b62
1316,bc1qz6lks9udfn78vx3cju9uyc6kqk6739hndak4ct,654,881198712,864212762,2023-04-05 07:18:21,2023-03-19 14:53:49,16985950,outbound,32109ed86ba84fa3652b5044ea7d716c019343017b6b8c8c214d4971fd8c0b62
1317,bc1qz6lks9udfn78vx3cju9uyc6kqk6739hndak4ct,655,740438,740438,2022-12-28 22:20:40,2022-12-28 21:55:38,0,inbound,32109ed86ba84fa3652b5044ea7d716c019343017b6b8c8c214d4971fd8c0b62
1318,bc1qz6lks9udfn78vx3cju9uyc6kqk6739hndak4ct,656,341789,341789,2022-12-29 01:03:44,2022-12-28 21:55:38,0,inbound,32109ed86ba84fa3652b5044ea7d716c019343017b6b8c8c214d4971fd8c0b62
1319,bc1qz6lks9udfn78vx3cju9uyc6kqk6739hndak4ct,657,18647622,18647622,2023-02-04 23:26:39,2022-12-02 13:39:22,0,inbound,32109ed86ba84fa3652b5044ea7d716c019343017b6b8c8c214d4971fd8c0b62
1320,bc1qz6lks9udfn78vx3cju9uyc6kqk6739hndak4ct,658,135590741,135583677,2023-03-29 16:57:11,2022-12-07 04:24:24,7064,inbound,32109ed86ba84fa3652b5044ea7d716c019343017b6b8c8c214d4971fd8c0b62
1321,bc1qz6lks9udfn78vx3cju9uyc6kqk6739hndak4ct,659,1445024,1445024,2022-12-27 15:32:29,2022-12-26 19:27:29,0,inbound,32109ed86ba84fa3652b5044ea7d716c019343017b6b8c8c214d4971fd8c0b62
1322,bc1qz6lks9udfn78vx3cju9uyc6kqk6739hndak4ct,660,15712526735,15712526735,2023-04-10 15:22:23,2023-04-07 20:46:41,0,inbound,32109ed86ba84fa3652b5044ea7d716c019343017b6b8c8c214d4971fd8c0b62
1323,bc1qz6lks9udfn78vx3cju9uyc6kqk6739hndak4ct,661,13742627371,13740806835,2023-04-10 14:52:50,2023-04-05 22:37:48,1820536,inbound,32109ed86ba84fa3652b5044ea7d716c019343017b6b8c8c214d4971fd8c0b62
1324,bc1qz6lks9udfn78vx3cju9uyc6kqk6739hndak4ct,662,39382384,39382384,2023-01-06 00:06:32,2022-09-08 10:39:55,0,inbound,32109ed86ba84fa3652b5044ea7d716c019343017b6b8c8c214d4971fd8c0b62
1325,bc1qz6lks9udfn78vx3cju9uyc6kqk6739hndak4ct,663,750041311,749577018,2023-04-08 19:20:58,2022-10-14 01:04:27,464293,inbound,32109ed86ba84fa3652b5044ea7d716c019343017b6b8c8c214d4971fd8c0b62
1326,bc1qz6lks9udfn78vx3cju9uyc6kqk6739hndak4ct,664,88616,88616,2023-01-04 00:36:24,2022-12-26 19:27:29,0,inbound,32109ed86ba84fa3652b5044ea7d716c019343017b6b8c8c214d4971fd8c0b62
1327,bc1qz6lks9udfn78vx3cju9uyc6kqk6739hndak4ct,665,9904,9904,2022-12-26 19:58:08,2022-12-26 19:27:29,0,inbound,32109ed86ba84fa3652b5044ea7d716c019343017b6b8c8c214d4971fd8c0b62
1328,bc1qz6lks9udfn78vx3cju9uyc6kqk6739hndak4ct,666,1335830,1335830,2022-12-27 10:00:47,2022-12-26 19:27:29,0,inbound,32109ed86ba84fa3652b5044ea7d716c019343017b6b8c8c214d4971fd8c0b62
1329,bc1qz6lks9udfn78vx3cju9uyc6kqk6739hndak4ct,1031,1926780,1926780,2022-12-23 06:19:13,2022-12-22 23:44:44,0,inbound,32109ed86ba84fa3652b5044ea7d716c019343017b6b8c8c214d4971fd8c0b62
1330,bc1qz6lks9udfn78vx3cju9uyc6kqk6739hndak4ct,1032,29779937,29767597,2023-03-22 18:53:04,2022-08-11 09:35:06,12340,inbound,32109ed86ba84fa3652b5044ea7d716c019343017b6b8c8c214d4971fd8c0b62
1331,bc1qz6lks9udfn78vx3cju9uyc6kqk6739hndak4ct,1033,594429,594429,2022-12-24 00:09:40,2022-12-22 23:44:44,0,inbound,32109ed86ba84fa3652b5044ea7d716c019343017b6b8c8c214d4971fd8c0b62
1332,bc1qz6lks9udfn78vx3cju9uyc6kqk6739hndak4ct,1034,570063,570063,2022-12-23 12:02:11,2022-12-22 23:44:44,0,inbound,32109ed86ba84fa3652b5044ea7d716c019343017b6b8c8c214d4971fd8c0b62
1333,bc1qz6lks9udfn78vx3cju9uyc6kqk6739hndak4ct,1035,45177,45177,2022-12-23 13:10:50,2022-12-22 23:44:44,0,inbound,32109ed86ba84fa3652b5044ea7d716c019343017b6b8c8c214d4971fd8c0b62
1334,bc1qz6lks9udfn78vx3cju9uyc6kqk6739hndak4ct,1036,105226,105226,2022-12-23 06:03:50,2022-12-22 23:44:44,0,inbound,32109ed86ba84fa3652b5044ea7d716c019343017b6b8c8c214d4971fd8c0b62
1335,bc1qz6lks9udfn78vx3cju9uyc6kqk6739hndak4ct,1037,12975387,12975387,2023-02-23 14:03:38,2022-12-17 00:08:07,0,inbound,32109ed86ba84fa3652b5044ea7d716c019343017b6b8c8c214d4971fd8c0b62
1336,bc1qz6lks9udfn78vx3cju9uyc6kqk6739hndak4ct,1038,7591756,7591756,2023-03-02 17:00:21,2022-11-06 02:34:42,0,inbound,32109ed86ba84fa3652b5044ea7d716c019343017b6b8c8c214d4971fd8c0b62
1337,bc1qz6lks9udfn78vx3cju9uyc6kqk6739hndak4ct,1039,49510072,49510072,2023-04-09 14:49:49,2023-02-21 14:29:18,0,outbound,32109ed86ba84fa3652b5044ea7d716c019343017b6b8c8c214d4971fd8c0b62
1338,bc1qz6lks9udfn78vx3cju9uyc6kqk6739hndak4ct,1040,662447,662447,2022-12-23 12:32:13,2022-12-22 23:44:44,0,inbound,32109ed86ba84fa3652b5044ea7d716c019343017b6b8c8c214d4971fd8c0b62
1339,bc1qz6lks9udfn78vx3cju9uyc6kqk6739hndak4ct,1041,2906164,2906164,2022-12-23 05:56:15,2022-12-22 23:44:44,0,inbound,32109ed86ba84fa3652b5044ea7d716c019343017b6b8c8c214d4971fd8c0b62
1340,bc1qz6lks9udfn78vx3cju9uyc6kqk6739hndak4ct,1042,279390,279390,2022-12-23 00:33:56,2022-12-22 23:44:44,0,inbound,32109ed86ba84fa3652b5044ea7d716c019343017b6b8c8c214d4971fd8c0b62
1341,bc1qz6lks9udfn78vx3cju9uyc6kqk6739hndak4ct,1043,57125754,57125754,2023-01-15 11:49:45,2022-12-11 16:34:49,0,inbound,32109ed86ba84fa3652b5044ea7d716c019343017b6b8c8c214d4971fd8c0b62
1342,bc1qz6lks9udfn78vx3cju9uyc6kqk6739hndak4ct,1044,160683340,160683340,2023-01-06 20:37:07,2022-12-06 05:26:48,0,outbound,32109ed86ba84fa3652b5044ea7d716c019343017b6b8c8c214d4971fd8c0b62
1343,bc1qz6lks9udfn78vx3cju9uyc6kqk6739hndak4ct,1045,248816,248816,2022-12-23 06:03:52,2022-12-22 23:44:44,0,inbound,32109ed86ba84fa3652b5044ea7d716c019343017b6b8c8c214d4971fd8c0b62
1344,bc1qz6lks9udfn78vx3cju9uyc6kqk6739hndak4ct,1046,5950062,5770570,2023-03-18 00:38:01,2022-12-15 14:07:22,179492,inbound,32109ed86ba84fa3652b5044ea7d716c019343017b6b8c8c214d4971fd8c0b62
1345,bc1qz6lks9udfn78vx3cju9uyc6kqk6739hndak4ct,1047,292112395,292112395,2023-04-07 03:29:17,2023-01-06 16:50:17,0,outbound,32109ed86ba84fa3652b5044ea7d716c019343017b6b8c8c214d4971fd8c0b62
1346,bc1qz6lks9udfn78vx3cju9uyc6kqk6739hndak4ct,1048,364959,364959,2022-12-23 06:03:52,2022-12-22 23:44:44,0,inbound,32109ed86ba84fa3652b5044ea7d716c019343017b6b8c8c214d4971fd8c0b62
1347,bc1qz6lks9udfn78vx3cju9uyc6kqk6739hndak4ct,1049,236322228,236310064,2023-04-05 04:20:22,2022-11-05 17:06:39,12164,outbound,32109ed86ba84fa3652b5044ea7d716c019343017b6b8c8c214d4971fd8c0b62
1348,bc1qz6lks9udfn78vx3cju9uyc6kqk6739hndak4ct,1050,886815408,886815408,2023-04-07 00:02:07,2023-01-05 03:35:09,0,inbound,32109ed86ba84fa3652b5044ea7d716c019343017b6b8c8c214d4971fd8c0b62
1349,bc1qz6lks9udfn78vx3cju9uyc6kqk6739hndak4ct,1051,7893897,7893897,2022-12-29 16:35:54,2022-12-22 23:44:44,0,inbound,32109ed86ba84fa3652b5044ea7d716c019343017b6b8c8c214d4971fd8c0b62
1350,bc1qz6lks9udfn78vx3cju9uyc6kqk6739hndak4ct,1052,132594,132594,2022-12-23 06:03:51,2022-12-22 23:44:44,0,inbound,32109ed86ba84fa3652b5044ea7d716c019343017b6b8c8c214d4971fd8c0b62
1351,bc1qz6lks9udfn78vx3cju9uyc6kqk6739hndak4ct,1053,3795140,3307327,2023-04-02 10:52:22,2023-02-23 10:32:03,487813,inbound,32109ed86ba84fa3652b5044ea7d716c019343017b6b8c8c214d4971fd8c0b62
1352,bc1qz6lks9udfn78vx3cju9uyc6kqk6739hndak4ct,1054,132582,132582,2022-12-23 05:01:44,2022-12-22 23:44:44,0,inbound,32109ed86ba84fa3652b5044ea7d716c019343017b6b8c8c214d4971fd8c0b62
1353,bc1qz6lks9udfn78vx3cju9uyc6kqk6739hndak4ct,1055,223867,223867,2022-12-23 06:03:52,2022-12-22 23:44:44,0,inbound,32109ed86ba84fa3652b5044ea7d716c019343017b6b8c8c214d4971fd8c0b62
1354,bc1qz6lks9udfn78vx3cju9uyc6kqk6739hndak4ct,1056,52891290,52891290,2023-03-17 19:10:12,2022-12-24 03:39:45,0,inbound,32109ed86ba84fa3652b5044ea7d716c019343017b6b8c8c214d4971fd8c0b62
1355,bc1qz6lks9udfn78vx3cju9uyc6kqk6739hndak4ct,1057,3437445,3437445,2023-03-27 16:41:12,2022-11-02 15:00:41,0,inbound,32109ed86ba84fa3652b5044ea7d716c019343017b6b8c8c214d4971fd8c0b62
1356,bc1qz6lks9udfn78vx3cju9uyc6kqk6739hndak4ct,1058,336000,336000,2022-12-23 05:01:40,2022-12-22 23:44:44,0,inbound,32109ed86ba84fa3652b5044ea7d716c019343017b6b8c8c214d4971fd8c0b62
1357,bc1qz6lks9udfn78vx3cju9uyc6kqk6739hndak4ct,1059,335889,335889,2022-12-23 08:00:36,2022-12-22 23:44:44,0,inbound,32109ed86ba84fa3652b5044ea7d716c019343017b6b8c8c214d4971fd8c0b62
1358,bc1qz6lks9udfn78vx3cju9uyc6kqk6739hndak4ct,1060,118888,118888,2022-12-30 09:16:57,2022-12-22 23:44:44,0,inbound,32109ed86ba84fa3652b5044ea7d716c019343017b6b8c8c214d4971fd8c0b62
1359,bc1qz6lks9udfn78vx3cju9uyc6kqk6739hndak4ct,1061,103501,103501,2023-01-31 06:49:15,2022-12-22 23:44:44,0,inbound,32109ed86ba84fa3652b5044ea7d716c019343017b6b8c8c214d4971fd8c0b62
1360,bc1qz6lks9udfn78vx3cju9uyc6kqk6739hndak4ct,1333,257546,257546,2022-12-20 07:33:24,2022-12-17 01:29:03,0,inbound,32109ed86ba84fa3652b5044ea7d716c019343017b6b8c8c214d4971fd8c0b62
1361,bc1qz6lks9udfn78vx3cju9uyc6kqk6739hndak4ct,1334,133405,133405,2022-12-20 21:42:36,2022-12-17 01:29:03,0,inbound,32109ed86ba84fa3652b5044ea7d716c019343017b6b8c8c214d4971fd8c0b62
1362,bc1qz6lks9udfn78vx3cju9uyc6kqk6739hndak4ct,1335,426780361,422228779,2023-04-10 10:40:32,2023-04-07 14:38:58,4551582,outbound,32109ed86ba84fa3652b5044ea7d716c019343017b6b8c8c214d4971fd8c0b62
1363,bc1qz6lks9udfn78vx3cju9uyc6kqk6739hndak4ct,1336,572328,572328,2022-12-17 18:23:58,2022-12-17 01:29:03,0,inbound,32109ed86ba84fa3652b5044ea7d716c019343017b6b8c8c214d4971fd8c0b62
1364,bc1qz6lks9udfn78vx3cju9uyc6kqk6739hndak4ct,1337,197771,197771,2022-12-17 01:33:52,2022-12-17 01:29:03,0,inbound,32109ed86ba84fa3652b5044ea7d716c019343017b6b8c8c214d4971fd8c0b62
1365,bc1qz6lks9udfn78vx3cju9uyc6kqk6739hndak4ct,1338,143760082,143760082,2022-12-18 13:44:33,2022-08-30 17:33:09,0,inbound,32109ed86ba84fa3652b5044ea7d716c019343017b6b8c8c214d4971fd8c0b62
1366,bc1qz6lks9udfn78vx3cju9uyc6kqk6739hndak4ct,1339,74841,74841,2022-12-20 04:12:32,2022-12-17 01:29:03,0,inbound,32109ed86ba84fa3652b5044ea7d716c019343017b6b8c8c214d4971fd8c0b62
1367,bc1qz6lks9udfn78vx3cju9uyc6kqk6739hndak4ct,1340,20391239,20391239,2022-12-20 20:34:25,2022-11-28 19:57:19,0,inbound,32109ed86ba84fa3652b5044ea7d716c019343017b6b8c8c214d4971fd8c0b62
1368,bc1qz6lks9udfn78vx3cju9uyc6kqk6739hndak4ct,1341,455656,455656,2022-12-17 20:51:39,2022-12-17 01:29:03,0,inbound,32109ed86ba84fa3652b5044ea7d716c019343017b6b8c8c214d4971fd8c0b62
1369,bc1qz6lks9udfn78vx3cju9uyc6kqk6739hndak4ct,1342,179374206,177210500,2023-04-08 21:41:37,2022-06-17 19:21:41,2163706,outbound,32109ed86ba84fa3652b5044ea7d716c019343017b6b8c8c214d4971fd8c0b62
1370,bc1qz6lks9udfn78vx3cju9uyc6kqk6739hndak4ct,1343,209540,209540,2022-12-17 01:30:46,2022-12-17 01:02:19,0,inbound,32109ed86ba84fa3652b5044ea7d716c019343017b6b8c8c214d4971fd8c0b62
1371,bc1qz6lks9udfn78vx3cju9uyc6kqk6739hndak4ct,1344,437647,437647,2022-12-17 03:05:12,2022-12-17 01:29:03,0,inbound,32109ed86ba84fa3652b5044ea7d716c019343017b6b8c8c214d4971fd8c0b62
1372,bc1qz6lks9udfn78vx3cju9uyc6kqk6739hndak4ct,1345,74830,74830,2022-12-17 01:32:51,2022-12-17 01:29:04,0,inbound,32109ed86ba84fa3652b5044ea7d716c019343017b6b8c8c214d4971fd8c0b62
1373,bc1qz6lks9udfn78vx3cju9uyc6kqk6739hndak4ct,1346,510067128,510067128,2023-04-04 13:44:25,2022-05-01 22:49:32,0,inbound,32109ed86ba84fa3652b5044ea7d716c019343017b6b8c8c214d4971fd8c0b62
1374,bc1qz6lks9udfn78vx3cju9uyc6kqk6739hndak4ct,1347,203318720,203318720,2023-04-03 13:45:01,2022-12-15 18:46:54,0,inbound,32109ed86ba84fa3652b5044ea7d716c019343017b6b8c8c214d4971fd8c0b62
1375,bc1qz6lks9udfn78vx3cju9uyc6kqk6739hndak4ct,1348,139279,139279,2022-12-17 05:13:30,2022-12-17 01:29:04,0,inbound,32109ed86ba84fa3652b5044ea7d716c019343017b6b8c8c214d4971fd8c0b62
1376,bc1qz6lks9udfn78vx3cju9uyc6kqk6739hndak4ct,1349,113031470,111465755,2023-04-10 08:25:23,2023-03-20 12:16:53,1565715,inbound,32109ed86ba84fa3652b5044ea7d716c019343017b6b8c8c214d4971fd8c0b62
1377,bc1qz6lks9udfn78vx3cju9uyc6kqk6739hndak4ct,1350,32772242,32772242,2023-04-07 00:13:44,2022-11-16 14:14:46,0,inbound,32109ed86ba84fa3652b5044ea7d716c019343017b6b8c8c214d4971fd8c0b62
1378,bc1qz6lks9udfn78vx3cju9uyc6kqk6739hndak4ct,1351,303621892,303621892,2023-03-15 00:02:42,2023-01-02 16:03:03,0,outbound,32109ed86ba84fa3652b5044ea7d716c019343017b6b8c8c214d4971fd8c0b62
1379,bc1qz6lks9udfn78vx3cju9uyc6kqk6739hndak4ct,1352,46415872,46415872,2023-03-02 16:09:14,2023-02-04 12:56:20,0,inbound,32109ed86ba84fa3652b5044ea7d716c019343017b6b8c8c214d4971fd8c0b62
1380,bc1qz6lks9udfn78vx3cju9uyc6kqk6739hndak4ct,1353,117901,117901,2022-12-27 17:27:11,2022-12-17 01:29:03,0,inbound,32109ed86ba84fa3652b5044ea7d716c019343017b6b8c8c214d4971fd8c0b62
1381,bc1qz6lks9udfn78vx3cju9uyc6kqk6739hndak4ct,1354,2392000,2392000,2022-12-17 18:53:53,2022-12-17 01:29:04,0,inbound,32109ed86ba84fa3652b5044ea7d716c019343017b6b8c8c214d4971fd8c0b62
1382,bc1qz6lks9udfn78vx3cju9uyc6kqk6739hndak4ct,1355,487376677,487376677,2023-04-06 21:31:16,2022-12-22 16:06:22,0,inbound,32109ed86ba84fa3652b5044ea7d716c019343017b6b8c8c214d4971fd8c0b62
1383,bc1qz6lks9udfn78vx3cju9uyc6kqk6739hndak4ct,1356,1479870,1479870,2023-03-31 03:18:00,2022-11-26 18:24:44,0,inbound,32109ed86ba84fa3652b5044ea7d716c019343017b6b8c8c214d4971fd8c0b62
1384,bc1qz6lks9udfn78vx3cju9uyc6kqk6739hndak4ct,1357,133411,133411,2022-12-20 21:42:36,2022-12-17 01:29:04,0,inbound,32109ed86ba84fa3652b5044ea7d716c019343017b6b8c8c214d4971fd8c0b62
1385,bc1qz6lks9udfn78vx3cju9uyc6kqk6739hndak4ct,1358,2927758,2927758,2022-12-20 09:22:32,2022-12-17 01:29:03,0,inbound,32109ed86ba84fa3652b5044ea7d716c019343017b6b8c8c214d4971fd8c0b62
1386,bc1qz6lks9udfn78vx3cju9uyc6kqk6739hndak4ct,1359,5049331079,5049331079,2023-04-10 16:00:52,2023-03-23 05:50:56,0,inbound,32109ed86ba84fa3652b5044ea7d716c019343017b6b8c8c214d4971fd8c0b62
1387,bc1qz6lks9udfn78vx3cju9uyc6kqk6739hndak4ct,1360,2153000,2153000,2022-12-17 03:00:57,2022-12-17 01:29:03,0,inbound,32109ed86ba84fa3652b5044ea7d716c019343017b6b8c8c214d4971fd8c0b62
1388,bc1qz6lks9udfn78vx3cju9uyc6kqk6739hndak4ct,1361,604695,604695,2023-01-16 09:56:18,2022-12-17 01:29:03,0,inbound,32109ed86ba84fa3652b5044ea7d716c019343017b6b8c8c214d4971fd8c0b62
1389,bc1qz6lks9udfn78vx3cju9uyc6kqk6739hndak4ct,1362,9410099,9410099,2022-12-20 08:00:45,2022-10-02 08:05:56,0,inbound,32109ed86ba84fa3652b5044ea7d716c019343017b6b8c8c214d4971fd8c0b62
1390,bc1qz6lks9udfn78vx3cju9uyc6kqk6739hndak4ct,1363,1652256021,1650905326,2023-04-05 10:10:54,2023-02-05 19:10:21,1350695,inbound,32109ed86ba84fa3652b5044ea7d716c019343017b6b8c8c214d4971fd8c0b62
1391,bc1qz6lks9udfn78vx3cju9uyc6kqk6739hndak4ct,667,397712,397712,2023-01-03 17:01:10,2022-12-26 19:27:29,0,inbound,c2f4dbb9490cf97c844557b34d53b0ec77b334a23b334bde3eebd456c4c023af
1392,bc1qz6lks9udfn78vx3cju9uyc6kqk6739hndak4ct,1062,49047,49047,2022-12-23 01:45:51,2022-12-22 23:44:44,0,inbound,c2f4dbb9490cf97c844557b34d53b0ec77b334a23b334bde3eebd456c4c023af
1393,bc1qz6lks9udfn78vx3cju9uyc6kqk6739hndak4ct,1364,227031,227031,2022-12-21 04:46:23,2022-12-17 01:29:03,0,inbound,c2f4dbb9490cf97c844557b34d53b0ec77b334a23b334bde3eebd456c4c023af
1394,bc1qz6lks9udfn78vx3cju9uyc6kqk6739hndak4ct,668,269863,269863,2022-12-27 11:28:53,2022-12-26 19:27:29,0,inbound,25770c89c6e8e19f2c88a5b6c95685124e67186d3b9b626afab1add34f26d526
1395,bc1qz6lks9udfn78vx3cju9uyc6kqk6739hndak4ct,669,24045,24045,2022-12-27 00:05:19,2022-12-26 19:27:29,0,inbound,25770c89c6e8e19f2c88a5b6c95685124e67186d3b9b626afab1add34f26d526
1396,bc1qz6lks9udfn78vx3cju9uyc6kqk6739hndak4ct,670,288646,288646,2022-12-26 19:31:53,2022-12-26 19:27:29,0,inbound,25770c89c6e8e19f2c88a5b6c95685124e67186d3b9b626afab1add34f26d526
1397,bc1qz6lks9udfn78vx3cju9uyc6kqk6739hndak4ct,671,73316548,73316548,2023-04-09 20:06:39,2022-11-03 22:14:02,0,inbound,25770c89c6e8e19f2c88a5b6c95685124e67186d3b9b626afab1add34f26d526
1398,bc1qz6lks9udfn78vx3cju9uyc6kqk6739hndak4ct,672,375641,375641,2023-01-07 23:46:42,2022-12-26 19:27:29,0,inbound,25770c89c6e8e19f2c88a5b6c95685124e67186d3b9b626afab1add34f26d526
1399,bc1qz6lks9udfn78vx3cju9uyc6kqk6739hndak4ct,673,8606933,8155684,2023-04-10 08:25:38,2022-11-28 23:13:18,451249,inbound,25770c89c6e8e19f2c88a5b6c95685124e67186d3b9b626afab1add34f26d526
1400,bc1qz6lks9udfn78vx3cju9uyc6kqk6739hndak4ct,674,483533846,483119640,2023-03-23 06:01:47,2022-12-20 16:53:37,414206,outbound,25770c89c6e8e19f2c88a5b6c95685124e67186d3b9b626afab1add34f26d526
1401,bc1qz6lks9udfn78vx3cju9uyc6kqk6739hndak4ct,675,154365,154365,2023-01-05 00:44:29,2022-12-26 19:27:29,0,inbound,25770c89c6e8e19f2c88a5b6c95685124e67186d3b9b626afab1add34f26d526
1402,bc1qz6lks9udfn78vx3cju9uyc6kqk6739hndak4ct,676,597793,597793,2022-12-27 17:46:24,2022-12-26 19:27:29,0,inbound,25770c89c6e8e19f2c88a5b6c95685124e67186d3b9b626afab1add34f26d526
1403,bc1qz6lks9udfn78vx3cju9uyc6kqk6739hndak4ct,677,277064,277064,2022-12-29 04:23:19,2022-12-26 19:27:29,0,inbound,25770c89c6e8e19f2c88a5b6c95685124e67186d3b9b626afab1add34f26d526
1404,bc1qz6lks9udfn78vx3cju9uyc6kqk6739hndak4ct,678,69300187,69202433,2023-04-08 22:35:56,2022-12-06 23:51:21,97754,inbound,25770c89c6e8e19f2c88a5b6c95685124e67186d3b9b626afab1add34f26d526
1405,bc1qz6lks9udfn78vx3cju9uyc6kqk6739hndak4ct,1063,131872460,131872460,2023-04-10 10:02:20,2023-02-28 22:01:03,0,inbound,25770c89c6e8e19f2c88a5b6c95685124e67186d3b9b626afab1add34f26d526
1406,bc1qz6lks9udfn78vx3cju9uyc6kqk6739hndak4ct,1064,847939,847939,2022-12-26 18:15:34,2022-12-22 22:33:01,0,inbound,25770c89c6e8e19f2c88a5b6c95685124e67186d3b9b626afab1add34f26d526
1407,bc1qz6lks9udfn78vx3cju9uyc6kqk6739hndak4ct,1065,150002,150002,2022-12-24 00:09:40,2022-12-22 23:44:44,0,inbound,25770c89c6e8e19f2c88a5b6c95685124e67186d3b9b626afab1add34f26d526
1408,bc1qz6lks9udfn78vx3cju9uyc6kqk6739hndak4ct,1066,235405,235405,2022-12-29 05:29:16,2022-12-22 23:44:44,0,inbound,25770c89c6e8e19f2c88a5b6c95685124e67186d3b9b626afab1add34f26d526
1409,bc1qz6lks9udfn78vx3cju9uyc6kqk6739hndak4ct,1067,1421051601,1421048093,2023-03-10 06:01:46,2023-03-17 12:37:10,3508,inbound,25770c89c6e8e19f2c88a5b6c95685124e67186d3b9b626afab1add34f26d526
1410,bc1qz6lks9udfn78vx3cju9uyc6kqk6739hndak4ct,1068,132543,132543,2022-12-29 02:30:26,2022-12-22 23:44:44,0,inbound,25770c89c6e8e19f2c88a5b6c95685124e67186d3b9b626afab1add34f26d526
1411,bc1qz6lks9udfn78vx3cju9uyc6kqk6739hndak4ct,1069,1323659,1317718,2023-02-23 20:24:25,2022-11-12 15:17:59,5941,inbound,25770c89c6e8e19f2c88a5b6c95685124e67186d3b9b626afab1add34f26d526
1412,bc1qz6lks9udfn78vx3cju9uyc6kqk6739hndak4ct,1070,277891,277891,2022-12-23 06:30:28,2022-12-22 23:44:44,0,inbound,25770c89c6e8e19f2c88a5b6c95685124e67186d3b9b626afab1add34f26d526
1413,bc1qz6lks9udfn78vx3cju9uyc6kqk6739hndak4ct,1071,595000,595000,2022-12-23 00:55:59,2022-12-22 23:44:44,0,inbound,25770c89c6e8e19f2c88a5b6c95685124e67186d3b9b626afab1add34f26d526
1414,bc1qz6lks9udfn78vx3cju9uyc6kqk6739hndak4ct,1072,118425867,118425867,2023-02-07 00:49:33,2022-12-14 05:12:13,0,outbound,25770c89c6e8e19f2c88a5b6c95685124e67186d3b9b626afab1add34f26d526
1415,bc1qz6lks9udfn78vx3cju9uyc6kqk6739hndak4ct,1073,132705,132705,2022-12-23 05:01:46,2022-12-22 23:44:44,0,inbound,25770c89c6e8e19f2c88a5b6c95685124e67186d3b9b626afab1add34f26d526
1416,bc1qz6lks9udfn78vx3cju9uyc6kqk6739hndak4ct,1365,162608,162608,2022-12-17 13:01:47,2022-12-17 01:29:04,0,inbound,25770c89c6e8e19f2c88a5b6c95685124e67186d3b9b626afab1add34f26d526
1417,bc1qz6lks9udfn78vx3cju9uyc6kqk6739hndak4ct,1366,21879757,21879757,2022-12-29 12:02:47,2022-10-26 21:49:23,0,inbound,25770c89c6e8e19f2c88a5b6c95685124e67186d3b9b626afab1add34f26d526
1418,bc1qz6lks9udfn78vx3cju9uyc6kqk6739hndak4ct,1367,868256,868256,2022-12-17 05:01:44,2022-12-17 01:29:03,0,inbound,25770c89c6e8e19f2c88a5b6c95685124e67186d3b9b626afab1add34f26d526
1419,bc1qz6lks9udfn78vx3cju9uyc6kqk6739hndak4ct,1368,118984363,118658526,2023-03-30 13:52:39,2023-03-09 06:39:04,325837,inbound,25770c89c6e8e19f2c88a5b6c95685124e67186d3b9b626afab1add34f26d526
1420,bc1qz6lks9udfn78vx3cju9uyc6kqk6739hndak4ct,1369,599063,599063,2022-12-17 10:01:24,2022-12-17 01:29:03,0,inbound,25770c89c6e8e19f2c88a5b6c95685124e67186d3b9b626afab1add34f26d526
1421,bc1qz6lks9udfn78vx3cju9uyc6kqk6739hndak4ct,1370,3207877,3207877,2023-03-20 19:40:31,2022-12-17 01:29:03,0,inbound,25770c89c6e8e19f2c88a5b6c95685124e67186d3b9b626afab1add34f26d526
1422,bc1qz6lks9udfn78vx3cju9uyc6kqk6739hndak4ct,1371,60482,60482,2022-12-21 04:14:01,2022-12-17 01:29:03,0,inbound,25770c89c6e8e19f2c88a5b6c95685124e67186d3b9b626afab1add34f26d526
1423,bc1qz6lks9udfn78vx3cju9uyc6kqk6739hndak4ct,1372,20286687,20286687,2023-02-16 01:35:37,2022-07-27 18:23:41,0,outbound,25770c89c6e8e19f2c88a5b6c95685124e67186d3b9b626afab1add34f26d526
1424,bc1qz6lks9udfn78vx3cju9uyc6kqk6739hndak4ct,1373,367443,367443,2022-12-17 05:01:32,2022-12-17 01:29:03,0,inbound,25770c89c6e8e19f2c88a5b6c95685124e67186d3b9b626afab1add34f26d526
1425,bc1qz6lks9udfn78vx3cju9uyc6kqk6739hndak4ct,1374,135984,135984,2022-12-17 04:43:09,2022-12-17 01:29:03,0,inbound,25770c89c6e8e19f2c88a5b6c95685124e67186d3b9b626afab1add34f26d526
1426,bc1qz6lks9udfn78vx3cju9uyc6kqk6739hndak4ct,1375,119824,119824,2022-12-27 17:27:02,2022-12-17 01:29:03,0,inbound,25770c89c6e8e19f2c88a5b6c95685124e67186d3b9b626afab1add34f26d526
1427,bc1qz6lks9udfn78vx3cju9uyc6kqk6739hndak4ct,679,108755,108755,2022-12-27 03:09:28,2022-12-26 19:27:29,0,inbound,cb0e5b807a8831cd1ca2474c57ea1cd0467b2611938d78a1cfdf948a49b5f7e6
1428,bc1qz6lks9udfn78vx3cju9uyc6kqk6739hndak4ct,680,11592320,11592320,2023-01-07 16:08:42,2022-09-15 15:53:58,0,inbound,cb0e5b807a8831cd1ca2474c57ea1cd0467b2611938d78a1cfdf948a49b5f7e6
1429,bc1qz6lks9udfn78vx3cju9uyc6kqk6739hndak4ct,681,3062000,3062000,2022-12-26 20:23:29,2022-12-26 19:27:29,0,inbound,cb0e5b807a8831cd1ca2474c57ea1cd0467b2611938d78a1cfdf948a49b5f7e6
1430,bc1qz6lks9udfn78vx3cju9uyc6kqk6739hndak4ct,682,20192417,20192417,2023-01-16 13:40:25,2022-12-10 00:26:57,0,inbound,cb0e5b807a8831cd1ca2474c57ea1cd0467b2611938d78a1cfdf948a49b5f7e6
1431,bc1qz6lks9udfn78vx3cju9uyc6kqk6739hndak4ct,683,90000,90000,2022-12-27 04:42:54,2022-12-26 19:27:29,0,inbound,cb0e5b807a8831cd1ca2474c57ea1cd0467b2611938d78a1cfdf948a49b5f7e6
1432,bc1qz6lks9udfn78vx3cju9uyc6kqk6739hndak4ct,684,69089806,69089806,2023-03-28 02:41:08,2023-01-28 14:48:53,0,inbound,cb0e5b807a8831cd1ca2474c57ea1cd0467b2611938d78a1cfdf948a49b5f7e6
1433,bc1qz6lks9udfn78vx3cju9uyc6kqk6739hndak4ct,685,306043,306043,2022-12-27 00:07:45,2022-12-26 19:27:29,0,inbound,cb0e5b807a8831cd1ca2474c57ea1cd0467b2611938d78a1cfdf948a49b5f7e6
1434,bc1qz6lks9udfn78vx3cju9uyc6kqk6739hndak4ct,686,60870489,60870489,2023-04-05 20:13:20,2022-11-10 04:23:50,0,inbound,cb0e5b807a8831cd1ca2474c57ea1cd0467b2611938d78a1cfdf948a49b5f7e6
1435,bc1qz6lks9udfn78vx3cju9uyc6kqk6739hndak4ct,687,120351851,118784310,2023-04-10 08:26:32,2023-03-15 03:19:11,1567541,inbound,cb0e5b807a8831cd1ca2474c57ea1cd0467b2611938d78a1cfdf948a49b5f7e6
1436,bc1qz6lks9udfn78vx3cju9uyc6kqk6739hndak4ct,688,178399,178399,2023-01-03 17:43:43,2022-12-26 19:27:29,0,inbound,cb0e5b807a8831cd1ca2474c57ea1cd0467b2611938d78a1cfdf948a49b5f7e6
1437,bc1qz6lks9udfn78vx3cju9uyc6kqk6739hndak4ct,689,13089429,12600034,2023-04-10 08:26:02,2023-01-24 06:01:57,489395,outbound,cb0e5b807a8831cd1ca2474c57ea1cd0467b2611938d78a1cfdf948a49b5f7e6
1438,bc1qz6lks9udfn78vx3cju9uyc6kqk6739hndak4ct,690,100931,100931,2022-12-27 00:07:42,2022-12-26 19:27:29,0,inbound,cb0e5b807a8831cd1ca2474c57ea1cd0467b2611938d78a1cfdf948a49b5f7e6
1439,bc1qz6lks9udfn78vx3cju9uyc6kqk6739hndak4ct,691,1187403,1187403,2022-12-26 19:54:15,2022-12-26 19:27:29,0,inbound,cb0e5b807a8831cd1ca2474c57ea1cd0467b2611938d78a1cfdf948a49b5f7e6
1440,bc1qz6lks9udfn78vx3cju9uyc6kqk6739hndak4ct,692,173942058,173942058,2023-04-09 20:17:08,2023-01-28 18:52:02,0,inbound,cb0e5b807a8831cd1ca2474c57ea1cd0467b2611938d78a1cfdf948a49b5f7e6
1441,bc1qz6lks9udfn78vx3cju9uyc6kqk6739hndak4ct,693,2659644053,2659644053,2023-03-05 18:01:55,2023-02-12 02:31:41,0,inbound,cb0e5b807a8831cd1ca2474c57ea1cd0467b2611938d78a1cfdf948a49b5f7e6
1442,bc1qz6lks9udfn78vx3cju9uyc6kqk6739hndak4ct,694,71042,71042,2022-12-27 00:01:56,2022-12-26 19:27:29,0,inbound,cb0e5b807a8831cd1ca2474c57ea1cd0467b2611938d78a1cfdf948a49b5f7e6
1443,bc1qz6lks9udfn78vx3cju9uyc6kqk6739hndak4ct,695,1820151,1818940,2022-12-26 22:23:00,2022-02-13 21:53:47,1211,inbound,cb0e5b807a8831cd1ca2474c57ea1cd0467b2611938d78a1cfdf948a49b5f7e6
1444,bc1qz6lks9udfn78vx3cju9uyc6kqk6739hndak4ct,696,118742,118742,2023-01-10 00:26:26,2022-12-26 19:27:29,0,inbound,cb0e5b807a8831cd1ca2474c57ea1cd0467b2611938d78a1cfdf948a49b5f7e6
1445,bc1qz6lks9udfn78vx3cju9uyc6kqk6739hndak4ct,697,362157,362157,2022-12-27 05:01:34,2022-12-26 19:27:29,0,inbound,cb0e5b807a8831cd1ca2474c57ea1cd0467b2611938d78a1cfdf948a49b5f7e6
1446,bc1qz6lks9udfn78vx3cju9uyc6kqk6739hndak4ct,698,89055,89055,2022-12-27 00:05:14,2022-12-26 19:27:29,0,inbound,cb0e5b807a8831cd1ca2474c57ea1cd0467b2611938d78a1cfdf948a49b5f7e6
1447,bc1qz6lks9udfn78vx3cju9uyc6kqk6739hndak4ct,699,340077449,335090053,2023-03-03 22:00:14,2023-02-24 21:55:09,4987396,inbound,cb0e5b807a8831cd1ca2474c57ea1cd0467b2611938d78a1cfdf948a49b5f7e6
1448,bc1qz6lks9udfn78vx3cju9uyc6kqk6739hndak4ct,1074,219679,219679,2022-12-23 14:03:42,2022-12-22 23:44:44,0,inbound,cb0e5b807a8831cd1ca2474c57ea1cd0467b2611938d78a1cfdf948a49b5f7e6
1449,bc1qz6lks9udfn78vx3cju9uyc6kqk6739hndak4ct,1075,16086,16086,2022-12-23 20:46:13,2022-12-22 23:44:44,0,inbound,cb0e5b807a8831cd1ca2474c57ea1cd0467b2611938d78a1cfdf948a49b5f7e6
1450,bc1qz6lks9udfn78vx3cju9uyc6kqk6739hndak4ct,1076,110439,110439,2023-01-18 01:16:12,2022-12-22 23:44:44,0,inbound,cb0e5b807a8831cd1ca2474c57ea1cd0467b2611938d78a1cfdf948a49b5f7e6
1451,bc1qz6lks9udfn78vx3cju9uyc6kqk6739hndak4ct,1077,17881936,17881936,2023-03-17 03:40:25,2022-11-13 17:21:14,0,inbound,cb0e5b807a8831cd1ca2474c57ea1cd0467b2611938d78a1cfdf948a49b5f7e6
1452,bc1qz6lks9udfn78vx3cju9uyc6kqk6739hndak4ct,1078,150134,150134,2022-12-23 06:02:06,2022-12-22 23:44:44,0,inbound,cb0e5b807a8831cd1ca2474c57ea1cd0467b2611938d78a1cfdf948a49b5f7e6
1453,bc1qz6lks9udfn78vx3cju9uyc6kqk6739hndak4ct,1079,301096,301096,2022-12-29 02:30:26,2022-12-22 23:44:44,0,inbound,cb0e5b807a8831cd1ca2474c57ea1cd0467b2611938d78a1cfdf948a49b5f7e6
1454,bc1qz6lks9udfn78vx3cju9uyc6kqk6739hndak4ct,1080,197718506,197718506,2023-04-10 16:12:12,2023-03-20 20:06:57,0,outbound,cb0e5b807a8831cd1ca2474c57ea1cd0467b2611938d78a1cfdf948a49b5f7e6
1455,bc1qz6lks9udfn78vx3cju9uyc6kqk6739hndak4ct,1081,628116,628116,2022-12-23 00:18:21,2022-12-22 23:44:44,0,inbound,cb0e5b807a8831cd1ca2474c57ea1cd0467b2611938d78a1cfdf948a49b5f7e6
1456,bc1qz6lks9udfn78vx3cju9uyc6kqk6739hndak4ct,1082,20004289,20004289,2023-02-06 15:04:38,2022-12-14 03:40:24,0,inbound,cb0e5b807a8831cd1ca2474c57ea1cd0467b2611938d78a1cfdf948a49b5f7e6
1457,bc1qz6lks9udfn78vx3cju9uyc6kqk6739hndak4ct,1083,135129291,135018334,2023-03-14 14:26:21,2023-02-22 00:11:05,110957,outbound,cb0e5b807a8831cd1ca2474c57ea1cd0467b2611938d78a1cfdf948a49b5f7e6
1458,bc1qz6lks9udfn78vx3cju9uyc6kqk6739hndak4ct,1084,208000,208000,2022-12-23 00:50:11,2022-12-22 23:44:44,0,inbound,cb0e5b807a8831cd1ca2474c57ea1cd0467b2611938d78a1cfdf948a49b5f7e6
1459,bc1qz6lks9udfn78vx3cju9uyc6kqk6739hndak4ct,1085,103502,103502,2022-12-23 06:03:50,2022-12-22 23:44:44,0,inbound,cb0e5b807a8831cd1ca2474c57ea1cd0467b2611938d78a1cfdf948a49b5f7e6
1460,bc1qz6lks9udfn78vx3cju9uyc6kqk6739hndak4ct,1086,134880649,134880649,2023-04-10 10:04:04,2023-03-23 08:11:25,0,outbound,cb0e5b807a8831cd1ca2474c57ea1cd0467b2611938d78a1cfdf948a49b5f7e6
1461,bc1qz6lks9udfn78vx3cju9uyc6kqk6739hndak4ct,1087,28182516,28182516,2023-01-30 19:44:06,2022-11-23 03:26:19,0,inbound,cb0e5b807a8831cd1ca2474c57ea1cd0467b2611938d78a1cfdf948a49b5f7e6
1462,bc1qz6lks9udfn78vx3cju9uyc6kqk6739hndak4ct,1088,3536624,3536624,2023-01-10 08:57:53,2022-12-22 17:36:11,0,inbound,cb0e5b807a8831cd1ca2474c57ea1cd0467b2611938d78a1cfdf948a49b5f7e6
1463,bc1qz6lks9udfn78vx3cju9uyc6kqk6739hndak4ct,1089,132583,132583,2022-12-26 23:42:16,2022-12-22 23:44:44,0,inbound,cb0e5b807a8831cd1ca2474c57ea1cd0467b2611938d78a1cfdf948a49b5f7e6
1464,bc1qz6lks9udfn78vx3cju9uyc6kqk6739hndak4ct,1090,611716,0,2022-12-22 23:44:44,2022-12-22 23:44:44,611716,inbound,cb0e5b807a8831cd1ca2474c57ea1cd0467b2611938d78a1cfdf948a49b5f7e6
1465,bc1qz6lks9udfn78vx3cju9uyc6kqk6739hndak4ct,1091,166494253,166494253,2023-04-10 14:07:07,2023-02-21 05:26:35,0,inbound,cb0e5b807a8831cd1ca2474c57ea1cd0467b2611938d78a1cfdf948a49b5f7e6
1466,bc1qz6lks9udfn78vx3cju9uyc6kqk6739hndak4ct,1092,370864,370864,2022-12-23 06:03:52,2022-12-22 23:44:44,0,inbound,cb0e5b807a8831cd1ca2474c57ea1cd0467b2611938d78a1cfdf948a49b5f7e6
1467,bc1qz6lks9udfn78vx3cju9uyc6kqk6739hndak4ct,1093,61684171,61675562,2023-03-23 08:59:25,2022-03-11 18:50:06,8609,inbound,cb0e5b807a8831cd1ca2474c57ea1cd0467b2611938d78a1cfdf948a49b5f7e6
1468,bc1qz6lks9udfn78vx3cju9uyc6kqk6739hndak4ct,1094,594446,594446,2022-12-23 08:07:35,2022-12-22 23:44:44,0,inbound,cb0e5b807a8831cd1ca2474c57ea1cd0467b2611938d78a1cfdf948a49b5f7e6
1469,bc1qz6lks9udfn78vx3cju9uyc6kqk6739hndak4ct,1095,114282565,114282565,2023-01-31 18:01:58,2022-11-28 01:00:45,0,outbound,cb0e5b807a8831cd1ca2474c57ea1cd0467b2611938d78a1cfdf948a49b5f7e6
1470,bc1qz6lks9udfn78vx3cju9uyc6kqk6739hndak4ct,1096,13743051,13743051,2023-03-31 19:33:33,2022-07-06 10:01:53,0,inbound,cb0e5b807a8831cd1ca2474c57ea1cd0467b2611938d78a1cfdf948a49b5f7e6
1471,bc1qz6lks9udfn78vx3cju9uyc6kqk6739hndak4ct,1097,115076,115076,2022-12-23 06:03:50,2022-12-22 23:44:44,0,inbound,cb0e5b807a8831cd1ca2474c57ea1cd0467b2611938d78a1cfdf948a49b5f7e6
1472,bc1qz6lks9udfn78vx3cju9uyc6kqk6739hndak4ct,1098,3910165,3910165,2023-01-26 06:58:52,2022-04-16 06:20:03,0,inbound,cb0e5b807a8831cd1ca2474c57ea1cd0467b2611938d78a1cfdf948a49b5f7e6
1473,bc1qz6lks9udfn78vx3cju9uyc6kqk6739hndak4ct,1099,68575,68575,2022-12-23 02:51:22,2022-12-22 23:44:44,0,inbound,cb0e5b807a8831cd1ca2474c57ea1cd0467b2611938d78a1cfdf948a49b5f7e6
1474,bc1qz6lks9udfn78vx3cju9uyc6kqk6739hndak4ct,1100,308939476,308939476,2023-03-28 13:32:58,2022-12-13 07:15:47,0,inbound,cb0e5b807a8831cd1ca2474c57ea1cd0467b2611938d78a1cfdf948a49b5f7e6
1475,bc1qz6lks9udfn78vx3cju9uyc6kqk6739hndak4ct,1101,616563,616563,2022-12-29 02:30:26,2022-12-22 23:44:44,0,inbound,cb0e5b807a8831cd1ca2474c57ea1cd0467b2611938d78a1cfdf948a49b5f7e6
1476,bc1qz6lks9udfn78vx3cju9uyc6kqk6739hndak4ct,1102,657211,657211,2022-12-23 06:03:55,2022-12-22 23:44:44,0,inbound,cb0e5b807a8831cd1ca2474c57ea1cd0467b2611938d78a1cfdf948a49b5f7e6
1477,bc1qz6lks9udfn78vx3cju9uyc6kqk6739hndak4ct,1103,103504,103504,2022-12-23 06:41:04,2022-12-22 23:44:44,0,inbound,cb0e5b807a8831cd1ca2474c57ea1cd0467b2611938d78a1cfdf948a49b5f7e6
1478,bc1qz6lks9udfn78vx3cju9uyc6kqk6739hndak4ct,1104,151592,151592,2022-12-23 14:03:42,2022-12-22 23:44:44,0,inbound,cb0e5b807a8831cd1ca2474c57ea1cd0467b2611938d78a1cfdf948a49b5f7e6
1479,bc1qz6lks9udfn78vx3cju9uyc6kqk6739hndak4ct,1105,33385,33385,2022-12-23 04:40:13,2022-12-22 23:44:44,0,inbound,cb0e5b807a8831cd1ca2474c57ea1cd0467b2611938d78a1cfdf948a49b5f7e6
1480,bc1qz6lks9udfn78vx3cju9uyc6kqk6739hndak4ct,1106,301021,301021,2022-12-23 06:03:52,2022-12-22 23:44:44,0,inbound,cb0e5b807a8831cd1ca2474c57ea1cd0467b2611938d78a1cfdf948a49b5f7e6
1481,bc1qz6lks9udfn78vx3cju9uyc6kqk6739hndak4ct,1107,214002,214002,2022-12-23 06:02:05,2022-12-22 23:44:44,0,inbound,cb0e5b807a8831cd1ca2474c57ea1cd0467b2611938d78a1cfdf948a49b5f7e6
1482,bc1qz6lks9udfn78vx3cju9uyc6kqk6739hndak4ct,1108,219747,219747,2022-12-23 05:00:17,2022-12-22 23:44:44,0,inbound,cb0e5b807a8831cd1ca2474c57ea1cd0467b2611938d78a1cfdf948a49b5f7e6
1483,bc1qz6lks9udfn78vx3cju9uyc6kqk6739hndak4ct,1109,161562,161562,2022-12-23 05:01:43,2022-12-22 23:44:44,0,inbound,cb0e5b807a8831cd1ca2474c57ea1cd0467b2611938d78a1cfdf948a49b5f7e6
1484,bc1qz6lks9udfn78vx3cju9uyc6kqk6739hndak4ct,1110,304581830,303484731,2023-04-08 02:14:27,2023-01-13 12:18:00,1097099,outbound,cb0e5b807a8831cd1ca2474c57ea1cd0467b2611938d78a1cfdf948a49b5f7e6
1485,bc1qz6lks9udfn78vx3cju9uyc6kqk6739hndak4ct,1111,796593,796593,2022-12-23 06:03:52,2022-12-22 23:44:44,0,inbound,cb0e5b807a8831cd1ca2474c57ea1cd0467b2611938d78a1cfdf948a49b5f7e6
1486,bc1qz6lks9udfn78vx3cju9uyc6kqk6739hndak4ct,1112,103509,103509,2022-12-27 00:17:08,2022-12-22 23:44:44,0,inbound,cb0e5b807a8831cd1ca2474c57ea1cd0467b2611938d78a1cfdf948a49b5f7e6
1487,bc1qz6lks9udfn78vx3cju9uyc6kqk6739hndak4ct,1113,160501,160501,2022-12-23 14:18:58,2022-12-22 23:44:44,0,inbound,cb0e5b807a8831cd1ca2474c57ea1cd0467b2611938d78a1cfdf948a49b5f7e6
1488,bc1qz6lks9udfn78vx3cju9uyc6kqk6739hndak4ct,1114,136297,136297,2022-12-22 23:54:33,2022-12-22 23:44:44,0,inbound,cb0e5b807a8831cd1ca2474c57ea1cd0467b2611938d78a1cfdf948a49b5f7e6
1489,bc1qz6lks9udfn78vx3cju9uyc6kqk6739hndak4ct,1115,306908,306908,2022-12-27 09:30:12,2022-12-22 23:44:44,0,inbound,cb0e5b807a8831cd1ca2474c57ea1cd0467b2611938d78a1cfdf948a49b5f7e6
1490,bc1qz6lks9udfn78vx3cju9uyc6kqk6739hndak4ct,1116,686918053,684727489,2023-04-10 14:24:58,2023-03-21 06:30:54,2190564,inbound,cb0e5b807a8831cd1ca2474c57ea1cd0467b2611938d78a1cfdf948a49b5f7e6
1491,bc1qz6lks9udfn78vx3cju9uyc6kqk6739hndak4ct,1117,522500,522500,2022-12-27 18:21:22,2022-12-22 23:44:44,0,inbound,cb0e5b807a8831cd1ca2474c57ea1cd0467b2611938d78a1cfdf948a49b5f7e6
1492,bc1qz6lks9udfn78vx3cju9uyc6kqk6739hndak4ct,1118,36792043,36792043,2023-04-08 22:25:50,2022-12-06 17:10:22,0,outbound,cb0e5b807a8831cd1ca2474c57ea1cd0467b2611938d78a1cfdf948a49b5f7e6
1493,bc1qz6lks9udfn78vx3cju9uyc6kqk6739hndak4ct,1119,6471759,6328006,2023-04-09 14:00:03,2022-12-31 20:40:30,143753,inbound,cb0e5b807a8831cd1ca2474c57ea1cd0467b2611938d78a1cfdf948a49b5f7e6
1494,bc1qz6lks9udfn78vx3cju9uyc6kqk6739hndak4ct,1120,301195329,299823726,2023-04-06 05:10:44,2023-01-16 14:42:13,1371603,inbound,cb0e5b807a8831cd1ca2474c57ea1cd0467b2611938d78a1cfdf948a49b5f7e6
1495,bc1qz6lks9udfn78vx3cju9uyc6kqk6739hndak4ct,1121,826313,826313,2022-12-23 08:07:33,2022-12-22 23:44:44,0,inbound,cb0e5b807a8831cd1ca2474c57ea1cd0467b2611938d78a1cfdf948a49b5f7e6
1496,bc1qz6lks9udfn78vx3cju9uyc6kqk6739hndak4ct,1122,148609,148609,2022-12-23 05:01:45,2022-12-22 23:44:44,0,inbound,cb0e5b807a8831cd1ca2474c57ea1cd0467b2611938d78a1cfdf948a49b5f7e6
1497,bc1qz6lks9udfn78vx3cju9uyc6kqk6739hndak4ct,1376,179655,179655,2022-12-17 06:00:36,2022-12-17 01:29:03,0,inbound,cb0e5b807a8831cd1ca2474c57ea1cd0467b2611938d78a1cfdf948a49b5f7e6
1498,bc1qz6lks9udfn78vx3cju9uyc6kqk6739hndak4ct,1377,162508,162508,2022-12-17 05:01:34,2022-12-17 01:29:03,0,inbound,cb0e5b807a8831cd1ca2474c57ea1cd0467b2611938d78a1cfdf948a49b5f7e6
1499,bc1qz6lks9udfn78vx3cju9uyc6kqk6739hndak4ct,1378,10806063,10806063,2023-03-15 21:16:18,2022-12-07 05:51:36,0,inbound,cb0e5b807a8831cd1ca2474c57ea1cd0467b2611938d78a1cfdf948a49b5f7e6
1500,bc1qz6lks9udfn78vx3cju9uyc6kqk6739hndak4ct,1379,163260,163260,2022-12-27 17:27:11,2022-12-17 01:29:03,0,inbound,cb0e5b807a8831cd1ca2474c57ea1cd0467b2611938d78a1cfdf948a49b5f7e6
1501,bc1qz6lks9udfn78vx3cju9uyc6kqk6739hndak4ct,1380,67881543,67881543,2023-04-02 16:16:47,2023-02-15 19:31:34,0,inbound,cb0e5b807a8831cd1ca2474c57ea1cd0467b2611938d78a1cfdf948a49b5f7e6
1502,bc1qz6lks9udfn78vx3cju9uyc6kqk6739hndak4ct,1381,143027607,143027607,2023-04-04 08:05:12,2023-01-22 21:32:17,0,inbound,cb0e5b807a8831cd1ca2474c57ea1cd0467b2611938d78a1cfdf948a49b5f7e6
1503,bc1qz6lks9udfn78vx3cju9uyc6kqk6739hndak4ct,1382,864926,864926,2022-12-17 05:02:14,2022-12-17 01:29:04,0,inbound,cb0e5b807a8831cd1ca2474c57ea1cd0467b2611938d78a1cfdf948a49b5f7e6
1504,bc1qz6lks9udfn78vx3cju9uyc6kqk6739hndak4ct,1383,106914084,106914084,2023-03-17 14:39:24,2022-09-09 08:23:39,0,inbound,cb0e5b807a8831cd1ca2474c57ea1cd0467b2611938d78a1cfdf948a49b5f7e6
1505,bc1qz6lks9udfn78vx3cju9uyc6kqk6739hndak4ct,1384,314766,314766,2022-12-19 15:18:25,2022-12-17 01:29:03,0,inbound,cb0e5b807a8831cd1ca2474c57ea1cd0467b2611938d78a1cfdf948a49b5f7e6
1506,bc1qz6lks9udfn78vx3cju9uyc6kqk6739hndak4ct,1385,71278,71278,2022-12-17 05:01:34,2022-12-17 01:29:03,0,inbound,cb0e5b807a8831cd1ca2474c57ea1cd0467b2611938d78a1cfdf948a49b5f7e6
1507,bc1qz6lks9udfn78vx3cju9uyc6kqk6739hndak4ct,1386,55947,55947,2023-02-27 07:04:23,2022-12-17 01:29:03,0,inbound,cb0e5b807a8831cd1ca2474c57ea1cd0467b2611938d78a1cfdf948a49b5f7e6
1508,bc1qz6lks9udfn78vx3cju9uyc6kqk6739hndak4ct,1387,838110,838110,2022-12-17 01:46:19,2022-12-17 01:29:03,0,inbound,cb0e5b807a8831cd1ca2474c57ea1cd0467b2611938d78a1cfdf948a49b5f7e6
1509,bc1qz6lks9udfn78vx3cju9uyc6kqk6739hndak4ct,1388,311590,311590,2022-12-17 17:49:00,2022-12-17 01:29:03,0,inbound,cb0e5b807a8831cd1ca2474c57ea1cd0467b2611938d78a1cfdf948a49b5f7e6
1510,bc1qz6lks9udfn78vx3cju9uyc6kqk6739hndak4ct,1389,22781168,22287296,2023-04-06 07:31:59,2023-02-22 08:12:55,493872,inbound,cb0e5b807a8831cd1ca2474c57ea1cd0467b2611938d78a1cfdf948a49b5f7e6
1511,bc1qz6lks9udfn78vx3cju9uyc6kqk6739hndak4ct,1390,285536,285536,2022-12-17 07:15:02,2022-12-17 01:29:03,0,inbound,cb0e5b807a8831cd1ca2474c57ea1cd0467b2611938d78a1cfdf948a49b5f7e6
1512,bc1qz6lks9udfn78vx3cju9uyc6kqk6739hndak4ct,1391,445690,445690,2022-12-20 17:29:09,2022-12-17 01:29:03,0,inbound,cb0e5b807a8831cd1ca2474c57ea1cd0467b2611938d78a1cfdf948a49b5f7e6
1513,bc1qz6lks9udfn78vx3cju9uyc6kqk6739hndak4ct,1392,107783,0,2022-12-17 01:29:03,2022-12-17 01:29:03,107783,inbound,cb0e5b807a8831cd1ca2474c57ea1cd0467b2611938d78a1cfdf948a49b5f7e6
1514,bc1qz6lks9udfn78vx3cju9uyc6kqk6739hndak4ct,1393,186053467,185874749,2023-03-26 05:08:44,2022-09-13 18:06:24,178718,outbound,cb0e5b807a8831cd1ca2474c57ea1cd0467b2611938d78a1cfdf948a49b5f7e6
1515,bc1qz6lks9udfn78vx3cju9uyc6kqk6739hndak4ct,1394,101838,101838,2022-12-17 02:10:33,2022-12-17 01:29:04,0,inbound,cb0e5b807a8831cd1ca2474c57ea1cd0467b2611938d78a1cfdf948a49b5f7e6
1516,bc1qz6lks9udfn78vx3cju9uyc6kqk6739hndak4ct,1395,2410781,2410781,2022-12-20 05:02:34,2022-12-17 01:29:03,0,inbound,cb0e5b807a8831cd1ca2474c57ea1cd0467b2611938d78a1cfdf948a49b5f7e6
1517,bc1qz6lks9udfn78vx3cju9uyc6kqk6739hndak4ct,1396,41336814,41336814,2023-03-15 13:01:22,2022-02-18 20:00:45,0,inbound,cb0e5b807a8831cd1ca2474c57ea1cd0467b2611938d78a1cfdf948a49b5f7e6
1518,bc1qz6lks9udfn78vx3cju9uyc6kqk6739hndak4ct,1397,28163629,27879168,2023-04-01 15:39:38,2022-07-23 04:14:52,284461,outbound,cb0e5b807a8831cd1ca2474c57ea1cd0467b2611938d78a1cfdf948a49b5f7e6
1519,bc1qz6lks9udfn78vx3cju9uyc6kqk6739hndak4ct,1398,6715054,6715054,2023-01-18 19:32:42,2022-12-16 00:14:11,0,inbound,cb0e5b807a8831cd1ca2474c57ea1cd0467b2611938d78a1cfdf948a49b5f7e6
1520,bc1qz6lks9udfn78vx3cju9uyc6kqk6739hndak4ct,1399,346621108,346621108,2023-04-10 15:06:29,2023-03-09 17:38:33,0,inbound,cb0e5b807a8831cd1ca2474c57ea1cd0467b2611938d78a1cfdf948a49b5f7e6
1521,bc1qz6lks9udfn78vx3cju9uyc6kqk6739hndak4ct,1400,76363209,76363209,2023-03-31 05:11:41,2023-01-08 12:02:12,0,outbound,cb0e5b807a8831cd1ca2474c57ea1cd0467b2611938d78a1cfdf948a49b5f7e6
1522,bc1qz6lks9udfn78vx3cju9uyc6kqk6739hndak4ct,1401,221183,221183,2022-12-17 02:00:44,2022-12-17 01:29:03,0,inbound,cb0e5b807a8831cd1ca2474c57ea1cd0467b2611938d78a1cfdf948a49b5f7e6
1523,bc1qz6lks9udfn78vx3cju9uyc6kqk6739hndak4ct,1402,39124102410,39079622493,2023-04-10 15:21:45,2023-04-09 08:12:09,44479917,inbound,cb0e5b807a8831cd1ca2474c57ea1cd0467b2611938d78a1cfdf948a49b5f7e6
1524,bc1qz6lks9udfn78vx3cju9uyc6kqk6739hndak4ct,1403,107786,107786,2023-01-18 12:52:13,2022-12-17 01:29:03,0,inbound,cb0e5b807a8831cd1ca2474c57ea1cd0467b2611938d78a1cfdf948a49b5f7e6
1525,bc1qz6lks9udfn78vx3cju9uyc6kqk6739hndak4ct,1404,33252228,31315388,2023-04-10 08:26:13,2023-03-06 23:15:41,1936840,inbound,cb0e5b807a8831cd1ca2474c57ea1cd0467b2611938d78a1cfdf948a49b5f7e6
1526,bc1qz6lks9udfn78vx3cju9uyc6kqk6739hndak4ct,1405,221191,221191,2022-12-17 20:58:58,2022-12-17 01:29:03,0,inbound,cb0e5b807a8831cd1ca2474c57ea1cd0467b2611938d78a1cfdf948a49b5f7e6
1527,bc1qz6lks9udfn78vx3cju9uyc6kqk6739hndak4ct,1406,149642,149642,2022-12-21 04:46:23,2022-12-17 01:29:03,0,inbound,cb0e5b807a8831cd1ca2474c57ea1cd0467b2611938d78a1cfdf948a49b5f7e6
1528,bc1qz6lks9udfn78vx3cju9uyc6kqk6739hndak4ct,1407,478657,478657,2022-12-17 07:57:20,2022-12-17 01:29:03,0,inbound,cb0e5b807a8831cd1ca2474c57ea1cd0467b2611938d78a1cfdf948a49b5f7e6
1529,bc1qz6lks9udfn78vx3cju9uyc6kqk6739hndak4ct,1408,1161810,1161810,2022-12-17 05:01:44,2022-12-17 01:29:03,0,inbound,cb0e5b807a8831cd1ca2474c57ea1cd0467b2611938d78a1cfdf948a49b5f7e6
1530,bc1qz6lks9udfn78vx3cju9uyc6kqk6739hndak4ct,1409,104118,0,2022-12-17 01:29:04,2022-12-17 01:29:04,104118,inbound,cb0e5b807a8831cd1ca2474c57ea1cd0467b2611938d78a1cfdf948a49b5f7e6
1531,bc1qz6lks9udfn78vx3cju9uyc6kqk6739hndak4ct,1410,179621,179621,2022-12-27 17:33:15,2022-12-17 01:29:03,0,inbound,cb0e5b807a8831cd1ca2474c57ea1cd0467b2611938d78a1cfdf948a49b5f7e6
1532,bc1qz6lks9udfn78vx3cju9uyc6kqk6739hndak4ct,1411,113744,113744,2022-12-17 04:30:25,2022-12-17 01:29:03,0,inbound,cb0e5b807a8831cd1ca2474c57ea1cd0467b2611938d78a1cfdf948a49b5f7e6
1533,bc1qz6lks9udfn78vx3cju9uyc6kqk6739hndak4ct,1412,9637168,7198504,2023-02-08 21:07:14,2022-05-08 20:21:50,2438664,inbound,cb0e5b807a8831cd1ca2474c57ea1cd0467b2611938d78a1cfdf948a49b5f7e6
1534,bc1qz6lks9udfn78vx3cju9uyc6kqk6739hndak4ct,1413,133406,133406,2022-12-17 07:00:48,2022-12-17 01:29:03,0,inbound,cb0e5b807a8831cd1ca2474c57ea1cd0467b2611938d78a1cfdf948a49b5f7e6
1535,bc1qz6lks9udfn78vx3cju9uyc6kqk6739hndak4ct,1414,299393,299393,2022-12-17 16:28:49,2022-12-17 01:29:03,0,inbound,cb0e5b807a8831cd1ca2474c57ea1cd0467b2611938d78a1cfdf948a49b5f7e6
1536,bc1qz6lks9udfn78vx3cju9uyc6kqk6739hndak4ct,1415,497820948,497820948,2023-03-20 04:08:19,2023-02-11 15:07:03,0,inbound,cb0e5b807a8831cd1ca2474c57ea1cd0467b2611938d78a1cfdf948a49b5f7e6
1537,bc1qz6lks9udfn78vx3cju9uyc6kqk6739hndak4ct,1416,299492,0,2022-12-17 01:29:03,2022-12-17 01:29:03,299492,inbound,cb0e5b807a8831cd1ca2474c57ea1cd0467b2611938d78a1cfdf948a49b5f7e6
1538,bc1qz6lks9udfn78vx3cju9uyc6kqk6739hndak4ct,1417,119752,119752,2022-12-27 17:27:02,2022-12-17 01:29:03,0,inbound,cb0e5b807a8831cd1ca2474c57ea1cd0467b2611938d78a1cfdf948a49b5f7e6
1539,bc1qz6lks9udfn78vx3cju9uyc6kqk6739hndak4ct,1418,104130,104130,2022-12-17 07:00:48,2022-12-17 01:29:03,0,inbound,cb0e5b807a8831cd1ca2474c57ea1cd0467b2611938d78a1cfdf948a49b5f7e6
1540,bc1qz6lks9udfn78vx3cju9uyc6kqk6739hndak4ct,1419,20027721,20027721,2023-01-28 00:01:58,2022-12-06 08:11:35,0,inbound,cb0e5b807a8831cd1ca2474c57ea1cd0467b2611938d78a1cfdf948a49b5f7e6
1541,bc1qz6lks9udfn78vx3cju9uyc6kqk6739hndak4ct,1420,2092106230,2088295645,2023-04-10 16:36:03,2023-03-31 02:02:01,3810585,outbound,cb0e5b807a8831cd1ca2474c57ea1cd0467b2611938d78a1cfdf948a49b5f7e6
1542,bc1qz6lks9udfn78vx3cju9uyc6kqk6739hndak4ct,1421,299399,299399,2022-12-17 01:32:58,2022-12-17 01:29:03,0,inbound,cb0e5b807a8831cd1ca2474c57ea1cd0467b2611938d78a1cfdf948a49b5f7e6
1543,bc1qz6lks9udfn78vx3cju9uyc6kqk6739hndak4ct,1422,60217,60217,2022-12-17 06:00:51,2022-12-17 01:29:03,0,inbound,cb0e5b807a8831cd1ca2474c57ea1cd0467b2611938d78a1cfdf948a49b5f7e6
1544,bc1qz6lks9udfn78vx3cju9uyc6kqk6739hndak4ct,1423,49763279,49763279,2023-04-07 10:05:46,2023-01-17 12:53:59,0,inbound,cb0e5b807a8831cd1ca2474c57ea1cd0467b2611938d78a1cfdf948a49b5f7e6
1545,bc1qz6lks9udfn78vx3cju9uyc6kqk6739hndak4ct,1424,113689290,113689290,2023-02-22 04:37:05,2022-11-14 13:31:37,0,inbound,cb0e5b807a8831cd1ca2474c57ea1cd0467b2611938d78a1cfdf948a49b5f7e6
1546,bc1qz6lks9udfn78vx3cju9uyc6kqk6739hndak4ct,1123,326335116,322011675,2023-04-06 16:07:32,2022-08-20 18:00:11,4323441,inbound,4f685781dfc711b7104b2d83c780905995db2be5d12359e32d681256651b422a
1547,bc1qz6lks9udfn78vx3cju9uyc6kqk6739hndak4ct,1425,74848,74848,2022-12-17 12:01:33,2022-12-17 01:29:03,0,inbound,4f685781dfc711b7104b2d83c780905995db2be5d12359e32d681256651b422a
1548,bc1qz6lks9udfn78vx3cju9uyc6kqk6739hndak4ct,1124,103489,103489,2022-12-23 14:13:44,2022-12-22 23:44:44,0,inbound,316fb96f4f81adc32c089e4c79f83f28b16231738db08ad39374a8d05e3fa552
1549,bc1qz6lks9udfn78vx3cju9uyc6kqk6739hndak4ct,1426,65584234,65584234,2023-03-14 12:39:27,2022-11-14 10:00:49,0,outbound,316fb96f4f81adc32c089e4c79f83f28b16231738db08ad39374a8d05e3fa552
1550,bc1qz6lks9udfn78vx3cju9uyc6kqk6739hndak4ct,1125,154596,154596,2022-12-23 06:00:39,2022-12-22 23:44:44,0,inbound,d6111b826e2fcebde14333370e1da3b3e8d44dca81ddd2d86d0136ecd223d328
1551,bc1qz6lks9udfn78vx3cju9uyc6kqk6739hndak4ct,1126,2016688290,2016158353,2023-04-10 08:27:36,2023-03-22 15:28:13,529937,inbound,d6111b826e2fcebde14333370e1da3b3e8d44dca81ddd2d86d0136ecd223d328
1552,bc1qz6lks9udfn78vx3cju9uyc6kqk6739hndak4ct,1127,77279,77279,2022-12-25 13:26:42,2022-12-22 23:44:44,0,inbound,d6111b826e2fcebde14333370e1da3b3e8d44dca81ddd2d86d0136ecd223d328
1553,bc1qz6lks9udfn78vx3cju9uyc6kqk6739hndak4ct,1128,133006,133006,2022-12-29 18:12:12,2022-12-22 23:44:44,0,inbound,d6111b826e2fcebde14333370e1da3b3e8d44dca81ddd2d86d0136ecd223d328
1554,bc1qz6lks9udfn78vx3cju9uyc6kqk6739hndak4ct,1129,452235,452235,2022-12-23 08:19:51,2022-12-22 23:44:44,0,inbound,d6111b826e2fcebde14333370e1da3b3e8d44dca81ddd2d86d0136ecd223d328
1555,bc1qz6lks9udfn78vx3cju9uyc6kqk6739hndak4ct,1130,402884,402884,2022-12-23 05:24:09,2022-12-22 23:44:44,0,inbound,d6111b826e2fcebde14333370e1da3b3e8d44dca81ddd2d86d0136ecd223d328
1556,bc1qz6lks9udfn78vx3cju9uyc6kqk6739hndak4ct,1131,564686,564686,2022-12-24 00:09:40,2022-12-22 23:44:44,0,inbound,d6111b826e2fcebde14333370e1da3b3e8d44dca81ddd2d86d0136ecd223d328
1557,bc1qz6lks9udfn78vx3cju9uyc6kqk6739hndak4ct,1132,2992630,2992630,2022-12-30 04:41:19,2022-12-22 15:12:08,0,inbound,d6111b826e2fcebde14333370e1da3b3e8d44dca81ddd2d86d0136ecd223d328
1558,bc1qz6lks9udfn78vx3cju9uyc6kqk6739hndak4ct,1133,4405769,4405769,2023-03-28 15:29:17,2022-05-07 17:49:34,0,inbound,d6111b826e2fcebde14333370e1da3b3e8d44dca81ddd2d86d0136ecd223d328
1559,bc1qz6lks9udfn78vx3cju9uyc6kqk6739hndak4ct,1134,462512,462512,2023-02-14 10:06:39,2022-10-28 06:04:05,0,inbound,d6111b826e2fcebde14333370e1da3b3e8d44dca81ddd2d86d0136ecd223d328
1560,bc1qz6lks9udfn78vx3cju9uyc6kqk6739hndak4ct,1135,1843380,1843380,2022-12-28 19:33:31,2022-12-22 23:44:44,0,inbound,d6111b826e2fcebde14333370e1da3b3e8d44dca81ddd2d86d0136ecd223d328
1561,bc1qz6lks9udfn78vx3cju9uyc6kqk6739hndak4ct,1136,277827,277827,2022-12-23 00:25:30,2022-12-22 23:44:44,0,inbound,d6111b826e2fcebde14333370e1da3b3e8d44dca81ddd2d86d0136ecd223d328
1562,bc1qz6lks9udfn78vx3cju9uyc6kqk6739hndak4ct,1137,555708,555708,2022-12-23 01:08:50,2022-12-22 23:44:44,0,inbound,d6111b826e2fcebde14333370e1da3b3e8d44dca81ddd2d86d0136ecd223d328
1563,bc1qz6lks9udfn78vx3cju9uyc6kqk6739hndak4ct,1138,394113,394113,2022-12-23 06:03:52,2022-12-22 23:44:44,0,inbound,d6111b826e2fcebde14333370e1da3b3e8d44dca81ddd2d86d0136ecd223d328
1564,bc1qz6lks9udfn78vx3cju9uyc6kqk6739hndak4ct,1139,85836089,85836089,2023-01-30 19:09:19,2022-10-19 00:50:43,0,outbound,d6111b826e2fcebde14333370e1da3b3e8d44dca81ddd2d86d0136ecd223d328
1565,bc1qz6lks9udfn78vx3cju9uyc6kqk6739hndak4ct,1140,568518,568518,2022-12-23 14:55:12,2022-12-22 23:44:44,0,inbound,d6111b826e2fcebde14333370e1da3b3e8d44dca81ddd2d86d0136ecd223d328
1566,bc1qz6lks9udfn78vx3cju9uyc6kqk6739hndak4ct,1141,225515,225515,2022-12-29 02:30:26,2022-12-22 23:44:44,0,inbound,d6111b826e2fcebde14333370e1da3b3e8d44dca81ddd2d86d0136ecd223d328
1567,bc1qz6lks9udfn78vx3cju9uyc6kqk6739hndak4ct,1142,277872,277872,2022-12-23 06:03:52,2022-12-22 23:44:44,0,inbound,d6111b826e2fcebde14333370e1da3b3e8d44dca81ddd2d86d0136ecd223d328
1568,bc1qz6lks9udfn78vx3cju9uyc6kqk6739hndak4ct,1143,21146966,20813789,2023-04-02 09:18:50,2022-09-24 01:05:03,333177,outbound,d6111b826e2fcebde14333370e1da3b3e8d44dca81ddd2d86d0136ecd223d328
1569,bc1qz6lks9udfn78vx3cju9uyc6kqk6739hndak4ct,1144,7799284,7799284,2022-12-24 07:29:31,2022-12-21 22:37:10,0,inbound,d6111b826e2fcebde14333370e1da3b3e8d44dca81ddd2d86d0136ecd223d328
1570,bc1qz6lks9udfn78vx3cju9uyc6kqk6739hndak4ct,1145,338827,338827,2022-12-23 09:37:22,2022-12-22 23:44:44,0,inbound,d6111b826e2fcebde14333370e1da3b3e8d44dca81ddd2d86d0136ecd223d328
1571,bc1qz6lks9udfn78vx3cju9uyc6kqk6739hndak4ct,1146,595996,595996,2022-12-23 05:21:11,2022-12-22 23:44:44,0,inbound,d6111b826e2fcebde14333370e1da3b3e8d44dca81ddd2d86d0136ecd223d328
1572,bc1qz6lks9udfn78vx3cju9uyc6kqk6739hndak4ct,1147,1968314,1968314,2022-12-26 12:29:09,2022-12-22 23:44:44,0,inbound,d6111b826e2fcebde14333370e1da3b3e8d44dca81ddd2d86d0136ecd223d328
1573,bc1qz6lks9udfn78vx3cju9uyc6kqk6739hndak4ct,1148,17883172,17883172,2023-04-02 14:12:00,2022-12-06 22:10:20,0,inbound,d6111b826e2fcebde14333370e1da3b3e8d44dca81ddd2d86d0136ecd223d328
1574,bc1qz6lks9udfn78vx3cju9uyc6kqk6739hndak4ct,1149,325969341,325969341,2023-04-03 06:04:32,2023-02-01 12:04:22,0,outbound,d6111b826e2fcebde14333370e1da3b3e8d44dca81ddd2d86d0136ecd223d328
1575,bc1qz6lks9udfn78vx3cju9uyc6kqk6739hndak4ct,1150,4771445,4771445,2022-12-24 10:07:22,2022-12-22 23:20:55,0,inbound,d6111b826e2fcebde14333370e1da3b3e8d44dca81ddd2d86d0136ecd223d328
1576,bc1qz6lks9udfn78vx3cju9uyc6kqk6739hndak4ct,1151,4470205,4470205,2022-12-23 05:32:18,2022-12-22 23:44:44,0,inbound,d6111b826e2fcebde14333370e1da3b3e8d44dca81ddd2d86d0136ecd223d328
1577,bc1qz6lks9udfn78vx3cju9uyc6kqk6739hndak4ct,1152,411570,411570,2022-12-24 01:40:16,2022-12-22 23:44:44,0,inbound,d6111b826e2fcebde14333370e1da3b3e8d44dca81ddd2d86d0136ecd223d328
1578,bc1qz6lks9udfn78vx3cju9uyc6kqk6739hndak4ct,1153,182967771,182967771,2023-02-02 20:47:49,2023-01-09 14:51:02,0,inbound,d6111b826e2fcebde14333370e1da3b3e8d44dca81ddd2d86d0136ecd223d328
1579,bc1qz6lks9udfn78vx3cju9uyc6kqk6739hndak4ct,1154,41616,41616,2022-12-23 06:03:49,2022-12-22 23:44:44,0,inbound,d6111b826e2fcebde14333370e1da3b3e8d44dca81ddd2d86d0136ecd223d328
1580,bc1qz6lks9udfn78vx3cju9uyc6kqk6739hndak4ct,1155,593142,593142,2022-12-23 11:12:13,2022-12-22 23:44:44,0,inbound,d6111b826e2fcebde14333370e1da3b3e8d44dca81ddd2d86d0136ecd223d328
1581,bc1qz6lks9udfn78vx3cju9uyc6kqk6739hndak4ct,1156,277887,277887,2022-12-29 03:41:49,2022-12-22 23:44:44,0,inbound,d6111b826e2fcebde14333370e1da3b3e8d44dca81ddd2d86d0136ecd223d328
1582,bc1qz6lks9udfn78vx3cju9uyc6kqk6739hndak4ct,1157,46637868,46637868,2023-03-23 15:41:26,2023-01-28 19:59:36,0,inbound,d6111b826e2fcebde14333370e1da3b3e8d44dca81ddd2d86d0136ecd223d328
1583,bc1qz6lks9udfn78vx3cju9uyc6kqk6739hndak4ct,1158,265465253,265465253,2022-12-23 00:02:40,2022-12-22 23:44:44,0,inbound,d6111b826e2fcebde14333370e1da3b3e8d44dca81ddd2d86d0136ecd223d328
1584,bc1qz6lks9udfn78vx3cju9uyc6kqk6739hndak4ct,1159,279991,279991,2022-12-28 14:33:13,2022-12-22 23:44:44,0,inbound,d6111b826e2fcebde14333370e1da3b3e8d44dca81ddd2d86d0136ecd223d328
1585,bc1qz6lks9udfn78vx3cju9uyc6kqk6739hndak4ct,1160,2484933584,2477605040,2023-04-10 15:59:46,2023-04-09 21:50:13,7328544,inbound,d6111b826e2fcebde14333370e1da3b3e8d44dca81ddd2d86d0136ecd223d328
1586,bc1qz6lks9udfn78vx3cju9uyc6kqk6739hndak4ct,1161,575626,575626,2022-12-23 00:24:47,2022-12-22 23:44:44,0,inbound,d6111b826e2fcebde14333370e1da3b3e8d44dca81ddd2d86d0136ecd223d328
1587,bc1qz6lks9udfn78vx3cju9uyc6kqk6739hndak4ct,1162,1189100,1189100,2022-12-23 06:03:52,2022-12-22 23:44:44,0,inbound,d6111b826e2fcebde14333370e1da3b3e8d44dca81ddd2d86d0136ecd223d328
1588,bc1qz6lks9udfn78vx3cju9uyc6kqk6739hndak4ct,1163,208034,208034,2022-12-23 01:26:14,2022-12-22 23:44:44,0,inbound,d6111b826e2fcebde14333370e1da3b3e8d44dca81ddd2d86d0136ecd223d328
1589,bc1qz6lks9udfn78vx3cju9uyc6kqk6739hndak4ct,1164,585644,585644,2022-12-23 08:07:35,2022-12-22 23:44:44,0,inbound,d6111b826e2fcebde14333370e1da3b3e8d44dca81ddd2d86d0136ecd223d328
1590,bc1qz6lks9udfn78vx3cju9uyc6kqk6739hndak4ct,1165,56453940,56139622,2023-03-28 23:35:52,2022-09-06 01:00:13,314318,inbound,d6111b826e2fcebde14333370e1da3b3e8d44dca81ddd2d86d0136ecd223d328
1591,bc1qz6lks9udfn78vx3cju9uyc6kqk6739hndak4ct,1427,2128541052,2128541052,2023-04-01 04:27:31,2022-11-28 16:21:16,0,outbound,d6111b826e2fcebde14333370e1da3b3e8d44dca81ddd2d86d0136ecd223d328
1592,bc1qz6lks9udfn78vx3cju9uyc6kqk6739hndak4ct,1428,296682050,293094987,2023-03-30 18:53:07,2022-07-25 23:04:56,3587063,inbound,d6111b826e2fcebde14333370e1da3b3e8d44dca81ddd2d86d0136ecd223d328
1593,bc1qz6lks9udfn78vx3cju9uyc6kqk6739hndak4ct,1429,597207,597207,2022-12-17 22:16:00,2022-12-17 01:29:03,0,inbound,d6111b826e2fcebde14333370e1da3b3e8d44dca81ddd2d86d0136ecd223d328
1594,bc1qz6lks9udfn78vx3cju9uyc6kqk6739hndak4ct,1430,105069,105069,2022-12-17 07:00:48,2022-12-17 01:29:03,0,inbound,d6111b826e2fcebde14333370e1da3b3e8d44dca81ddd2d86d0136ecd223d328
1595,bc1qz6lks9udfn78vx3cju9uyc6kqk6739hndak4ct,1431,572571,572571,2022-12-19 05:42:39,2022-12-17 01:29:03,0,inbound,d6111b826e2fcebde14333370e1da3b3e8d44dca81ddd2d86d0136ecd223d328
1596,bc1qz6lks9udfn78vx3cju9uyc6kqk6739hndak4ct,1432,113768,113768,2023-01-03 21:59:12,2022-12-17 01:29:03,0,inbound,d6111b826e2fcebde14333370e1da3b3e8d44dca81ddd2d86d0136ecd223d328
1597,bc1qz6lks9udfn78vx3cju9uyc6kqk6739hndak4ct,1433,628919,628919,2022-12-17 04:00:46,2022-12-17 01:29:03,0,inbound,d6111b826e2fcebde14333370e1da3b3e8d44dca81ddd2d86d0136ecd223d328
1598,bc1qz6lks9udfn78vx3cju9uyc6kqk6739hndak4ct,1434,188324530,188324530,2023-03-11 06:01:47,2023-01-12 00:02:18,0,outbound,d6111b826e2fcebde14333370e1da3b3e8d44dca81ddd2d86d0136ecd223d328
1599,bc1qz6lks9udfn78vx3cju9uyc6kqk6739hndak4ct,1435,13302465,13302465,2022-12-18 02:02:36,2022-11-01 22:05:54,0,inbound,d6111b826e2fcebde14333370e1da3b3e8d44dca81ddd2d86d0136ecd223d328
1600,bc1qz6lks9udfn78vx3cju9uyc6kqk6739hndak4ct,1436,106288,106288,2022-12-17 07:00:54,2022-12-17 01:29:03,0,inbound,d6111b826e2fcebde14333370e1da3b3e8d44dca81ddd2d86d0136ecd223d328
1601,bc1qz6lks9udfn78vx3cju9uyc6kqk6739hndak4ct,1437,10041058,10041058,2023-01-18 01:38:32,2022-08-13 04:39:01,0,outbound,d6111b826e2fcebde14333370e1da3b3e8d44dca81ddd2d86d0136ecd223d328
1602,bc1qz6lks9udfn78vx3cju9uyc6kqk6739hndak4ct,1438,134579,134579,2023-02-27 07:54:16,2022-12-17 01:29:03,0,inbound,d6111b826e2fcebde14333370e1da3b3e8d44dca81ddd2d86d0136ecd223d328
1603,bc1qz6lks9udfn78vx3cju9uyc6kqk6739hndak4ct,1439,45636,45636,2022-12-21 04:46:23,2022-12-17 01:29:03,0,inbound,d6111b826e2fcebde14333370e1da3b3e8d44dca81ddd2d86d0136ecd223d328
1604,bc1qz6lks9udfn78vx3cju9uyc6kqk6739hndak4ct,1440,822507469,822507469,2023-04-09 15:49:18,2023-02-12 17:53:38,0,inbound,d6111b826e2fcebde14333370e1da3b3e8d44dca81ddd2d86d0136ecd223d328
1605,bc1qz6lks9udfn78vx3cju9uyc6kqk6739hndak4ct,1441,340887,340887,2022-12-17 02:21:16,2022-12-17 01:29:04,0,inbound,d6111b826e2fcebde14333370e1da3b3e8d44dca81ddd2d86d0136ecd223d328
1606,bc1qz6lks9udfn78vx3cju9uyc6kqk6739hndak4ct,1442,104116,104116,2022-12-17 07:00:48,2022-12-17 01:29:03,0,inbound,d6111b826e2fcebde14333370e1da3b3e8d44dca81ddd2d86d0136ecd223d328
1607,bc1qz6lks9udfn78vx3cju9uyc6kqk6739hndak4ct,1443,191331571,191331571,2023-01-08 06:06:14,2022-09-15 18:47:35,0,inbound,d6111b826e2fcebde14333370e1da3b3e8d44dca81ddd2d86d0136ecd223d328
1608,bc1qz6lks9udfn78vx3cju9uyc6kqk6739hndak4ct,1444,75751,75751,2022-12-25 20:15:38,2022-12-17 01:29:03,0,inbound,d6111b826e2fcebde14333370e1da3b3e8d44dca81ddd2d86d0136ecd223d328
1609,bc1qz6lks9udfn78vx3cju9uyc6kqk6739hndak4ct,1445,23553061,23553061,2023-01-04 04:37:03,2022-12-10 09:39:39,0,inbound,d6111b826e2fcebde14333370e1da3b3e8d44dca81ddd2d86d0136ecd223d328
1610,bc1qz6lks9udfn78vx3cju9uyc6kqk6739hndak4ct,1446,1993196844,1852087291,2023-03-29 11:34:27,2022-12-17 12:39:50,141109553,outbound,d6111b826e2fcebde14333370e1da3b3e8d44dca81ddd2d86d0136ecd223d328
1611,bc1qz6lks9udfn78vx3cju9uyc6kqk6739hndak4ct,1447,48550832,47184832,2023-04-03 01:28:28,2022-12-16 16:47:04,1366000,inbound,d6111b826e2fcebde14333370e1da3b3e8d44dca81ddd2d86d0136ecd223d328
1612,bc1qz6lks9udfn78vx3cju9uyc6kqk6739hndak4ct,1448,187654,187654,2022-12-17 08:26:28,2022-11-24 00:06:04,0,inbound,d6111b826e2fcebde14333370e1da3b3e8d44dca81ddd2d86d0136ecd223d328
1613,bc1qz6lks9udfn78vx3cju9uyc6kqk6739hndak4ct,1449,549429337,549429337,2023-01-25 11:47:02,2022-12-11 01:50:54,0,inbound,d6111b826e2fcebde14333370e1da3b3e8d44dca81ddd2d86d0136ecd223d328
1614,bc1qz6lks9udfn78vx3cju9uyc6kqk6739hndak4ct,1450,20877714,19291229,2023-04-09 02:46:45,2022-12-03 18:48:56,1586485,inbound,d6111b826e2fcebde14333370e1da3b3e8d44dca81ddd2d86d0136ecd223d328
1615,bc1qz6lks9udfn78vx3cju9uyc6kqk6739hndak4ct,1451,20783287,20783287,2022-12-31 20:42:59,2022-11-20 11:33:22,0,inbound,d6111b826e2fcebde14333370e1da3b3e8d44dca81ddd2d86d0136ecd223d328
1616,bc1qz6lks9udfn78vx3cju9uyc6kqk6739hndak4ct,1452,31141632,29633414,2023-04-10 08:25:59,2023-03-09 22:21:02,1508218,inbound,d6111b826e2fcebde14333370e1da3b3e8d44dca81ddd2d86d0136ecd223d328
1617,bc1qz6lks9udfn78vx3cju9uyc6kqk6739hndak4ct,1453,65800,65800,2022-12-17 01:30:37,2022-12-17 01:29:03,0,inbound,d6111b826e2fcebde14333370e1da3b3e8d44dca81ddd2d86d0136ecd223d328
1618,bc1qz6lks9udfn78vx3cju9uyc6kqk6739hndak4ct,1454,59865,0,2022-12-17 01:29:03,2022-12-17 01:29:03,59865,inbound,d6111b826e2fcebde14333370e1da3b3e8d44dca81ddd2d86d0136ecd223d328
1619,bc1qz6lks9udfn78vx3cju9uyc6kqk6739hndak4ct,1455,98258,98258,2022-12-21 04:46:23,2022-12-17 01:29:03,0,inbound,d6111b826e2fcebde14333370e1da3b3e8d44dca81ddd2d86d0136ecd223d328
1620,bc1qz6lks9udfn78vx3cju9uyc6kqk6739hndak4ct,1456,45351002,44077729,2023-03-31 05:12:09,2023-02-13 06:34:43,1273273,outbound,d6111b826e2fcebde14333370e1da3b3e8d44dca81ddd2d86d0136ecd223d328
1621,bc1qz6lks9udfn78vx3cju9uyc6kqk6739hndak4ct,1457,338195,338195,2022-12-17 21:11:02,2022-12-17 01:29:03,0,inbound,d6111b826e2fcebde14333370e1da3b3e8d44dca81ddd2d86d0136ecd223d328
1622,bc1qz6lks9udfn78vx3cju9uyc6kqk6739hndak4ct,1458,104122,104122,2022-12-17 05:01:34,2022-12-17 01:29:03,0,inbound,d6111b826e2fcebde14333370e1da3b3e8d44dca81ddd2d86d0136ecd223d328
1623,bc1qz6lks9udfn78vx3cju9uyc6kqk6739hndak4ct,1459,45639,45639,2022-12-17 06:00:51,2022-12-17 01:29:03,0,inbound,d6111b826e2fcebde14333370e1da3b3e8d44dca81ddd2d86d0136ecd223d328
1624,bc1qz6lks9udfn78vx3cju9uyc6kqk6739hndak4ct,1460,2215481,2215481,2022-12-21 00:31:42,2022-12-17 01:29:03,0,inbound,d6111b826e2fcebde14333370e1da3b3e8d44dca81ddd2d86d0136ecd223d328
1625,bc1qz6lks9udfn78vx3cju9uyc6kqk6739hndak4ct,1461,592599,592599,2022-12-17 20:51:39,2022-12-17 01:29:03,0,inbound,d6111b826e2fcebde14333370e1da3b3e8d44dca81ddd2d86d0136ecd223d328
1626,bc1qz6lks9udfn78vx3cju9uyc6kqk6739hndak4ct,1462,104110,104110,2022-12-17 02:15:46,2022-12-17 01:29:03,0,inbound,d6111b826e2fcebde14333370e1da3b3e8d44dca81ddd2d86d0136ecd223d328
1627,bc1qz6lks9udfn78vx3cju9uyc6kqk6739hndak4ct,1463,600158,600158,2022-12-21 04:46:23,2022-12-17 01:29:03,0,inbound,d6111b826e2fcebde14333370e1da3b3e8d44dca81ddd2d86d0136ecd223d328
1628,bc1qz6lks9udfn78vx3cju9uyc6kqk6739hndak4ct,1464,3632467,3632467,2023-04-02 09:18:49,2022-11-30 16:25:53,0,inbound,d6111b826e2fcebde14333370e1da3b3e8d44dca81ddd2d86d0136ecd223d328
1629,bc1qz6lks9udfn78vx3cju9uyc6kqk6739hndak4ct,1465,714666,714666,2022-12-17 06:42:13,2022-12-17 01:29:03,0,inbound,d6111b826e2fcebde14333370e1da3b3e8d44dca81ddd2d86d0136ecd223d328
1630,bc1qz6lks9udfn78vx3cju9uyc6kqk6739hndak4ct,1466,107831,107831,2022-12-17 07:00:48,2022-12-17 01:29:03,0,inbound,d6111b826e2fcebde14333370e1da3b3e8d44dca81ddd2d86d0136ecd223d328
1631,bc1qz6lks9udfn78vx3cju9uyc6kqk6739hndak4ct,1467,2457969,2457969,2022-12-17 07:09:47,2022-08-27 00:12:12,0,inbound,d6111b826e2fcebde14333370e1da3b3e8d44dca81ddd2d86d0136ecd223d328
1632,bc1qz6lks9udfn78vx3cju9uyc6kqk6739hndak4ct,1468,1222389,1222389,2022-12-19 15:18:25,2022-12-17 01:29:03,0,inbound,d6111b826e2fcebde14333370e1da3b3e8d44dca81ddd2d86d0136ecd223d328
1633,bc1qz6lks9udfn78vx3cju9uyc6kqk6739hndak4ct,1469,113446179,113394167,2023-04-05 06:53:28,2023-03-05 09:47:45,52012,outbound,d6111b826e2fcebde14333370e1da3b3e8d44dca81ddd2d86d0136ecd223d328
1634,bc1qz6lks9udfn78vx3cju9uyc6kqk6739hndak4ct,1470,179167078,179167078,2022-12-17 01:29:45,2022-12-17 01:29:03,0,inbound,d6111b826e2fcebde14333370e1da3b3e8d44dca81ddd2d86d0136ecd223d328
1635,bc1qz6lks9udfn78vx3cju9uyc6kqk6739hndak4ct,1471,133374,133374,2022-12-17 07:00:48,2022-12-17 01:29:03,0,inbound,d6111b826e2fcebde14333370e1da3b3e8d44dca81ddd2d86d0136ecd223d328
1636,bc1qz6lks9udfn78vx3cju9uyc6kqk6739hndak4ct,1472,215314,215314,2022-12-17 16:56:23,2022-12-17 01:29:03,0,inbound,d6111b826e2fcebde14333370e1da3b3e8d44dca81ddd2d86d0136ecd223d328
1637,bc1qz6lks9udfn78vx3cju9uyc6kqk6739hndak4ct,1473,193424302,193424302,2023-04-09 02:09:29,2022-12-31 15:29:10,0,inbound,d6111b826e2fcebde14333370e1da3b3e8d44dca81ddd2d86d0136ecd223d328
1638,bc1qz6lks9udfn78vx3cju9uyc6kqk6739hndak4ct,1474,221173,221173,2022-12-17 05:01:31,2022-12-17 01:29:03,0,inbound,d6111b826e2fcebde14333370e1da3b3e8d44dca81ddd2d86d0136ecd223d328
1639,bc1qz6lks9udfn78vx3cju9uyc6kqk6739hndak4ct,1475,1380732,1380732,2022-12-16 20:01:49,2021-10-12 19:07:22,0,inbound,d6111b826e2fcebde14333370e1da3b3e8d44dca81ddd2d86d0136ecd223d328
1640,bc1qz6lks9udfn78vx3cju9uyc6kqk6739hndak4ct,1476,1814500000,1814500000,2022-12-16 20:28:05,2022-12-16 17:42:54,0,inbound,d6111b826e2fcebde14333370e1da3b3e8d44dca81ddd2d86d0136ecd223d328
1641,bc1qz6lks9udfn78vx3cju9uyc6kqk6739hndak4ct,1477,768009852,644258305,2023-04-01 07:35:58,2022-07-11 07:32:06,123751547,inbound,d6111b826e2fcebde14333370e1da3b3e8d44dca81ddd2d86d0136ecd223d328
1642,bc1qz6lks9udfn78vx3cju9uyc6kqk6739hndak4ct,1478,51100000,999000,2023-01-04 04:22:44,2022-11-18 14:15:56,50101000,inbound,d6111b826e2fcebde14333370e1da3b3e8d44dca81ddd2d86d0136ecd223d328
1643,bc1qz6lks9udfn78vx3cju9uyc6kqk6739hndak4ct,1479,3240849198,3240849198,2023-03-11 08:46:55,2015-12-15 13:18:16,0,inbound,d6111b826e2fcebde14333370e1da3b3e8d44dca81ddd2d86d0136ecd223d328
1644,bc1qz6lks9udfn78vx3cju9uyc6kqk6739hndak4ct,1480,12054000,0,2022-12-16 17:42:54,2022-12-16 17:42:54,12054000,inbound,d6111b826e2fcebde14333370e1da3b3e8d44dca81ddd2d86d0136ecd223d328
1645,bc1qz6lks9udfn78vx3cju9uyc6kqk6739hndak4ct,1481,10733955757,10678587429,2023-04-10 00:00:11,2022-12-30 15:31:05,55368328,outbound,d6111b826e2fcebde14333370e1da3b3e8d44dca81ddd2d86d0136ecd223d328
1646,bc1qz6lks9udfn78vx3cju9uyc6kqk6739hndak4ct,1482,1370770000,1263987000,2023-01-17 17:24:02,2021-03-31 14:15:05,106783000,inbound,d6111b826e2fcebde14333370e1da3b3e8d44dca81ddd2d86d0136ecd223d328
1647,bc1qz6lks9udfn78vx3cju9uyc6kqk6739hndak4ct,1483,787000,787000,2022-12-16 18:15:24,2022-12-13 18:11:03,0,inbound,d6111b826e2fcebde14333370e1da3b3e8d44dca81ddd2d86d0136ecd223d328
1648,bc1qz6lks9udfn78vx3cju9uyc6kqk6739hndak4ct,1484,142791948,142791948,2023-02-16 13:09:34,2022-07-12 08:11:45,0,inbound,d6111b826e2fcebde14333370e1da3b3e8d44dca81ddd2d86d0136ecd223d328
1649,bc1qz6lks9udfn78vx3cju9uyc6kqk6739hndak4ct,1485,254616826,254616826,2023-02-15 18:11:19,2022-10-15 02:08:11,0,inbound,d6111b826e2fcebde14333370e1da3b3e8d44dca81ddd2d86d0136ecd223d328
1650,bc1qz6lks9udfn78vx3cju9uyc6kqk6739hndak4ct,1486,380835,380835,2022-12-16 20:51:47,2022-12-16 17:42:53,0,inbound,d6111b826e2fcebde14333370e1da3b3e8d44dca81ddd2d86d0136ecd223d328
1651,bc1qz6lks9udfn78vx3cju9uyc6kqk6739hndak4ct,1487,221136647107,220928863745,2023-04-10 13:20:13,2023-04-06 22:55:13,207783362,outbound,d6111b826e2fcebde14333370e1da3b3e8d44dca81ddd2d86d0136ecd223d328
1652,bc1qz6lks9udfn78vx3cju9uyc6kqk6739hndak4ct,1488,746000,0,2022-12-16 17:42:53,2022-12-16 17:42:53,746000,inbound,baad8bfb7356156fe529bc5a64f0fd6ea35091d8808a7a14963d7938ffe8f5e9
1653,bc1qz6lks9udfn78vx3cju9uyc6kqk6739hndak4ct,1489,1271239261,1260286136,2023-04-06 15:48:30,2022-10-20 21:33:17,10953125,inbound,baad8bfb7356156fe529bc5a64f0fd6ea35091d8808a7a14963d7938ffe8f5e9
1654,bc1qz6lks9udfn78vx3cju9uyc6kqk6739hndak4ct,1490,17377000,17377000,2023-04-01 10:18:10,2022-01-07 14:51:37,0,inbound,baad8bfb7356156fe529bc5a64f0fd6ea35091d8808a7a14963d7938ffe8f5e9
1655,bc1qz6lks9udfn78vx3cju9uyc6kqk6739hndak4ct,1491,80998000,0,2023-01-26 14:50:18,2022-12-16 17:42:54,80998000,inbound,baad8bfb7356156fe529bc5a64f0fd6ea35091d8808a7a14963d7938ffe8f5e9
1656,bc1qz6lks9udfn78vx3cju9uyc6kqk6739hndak4ct,1492,3850000,3850000,2023-01-04 07:52:12,2022-12-16 17:42:53,0,inbound,baad8bfb7356156fe529bc5a64f0fd6ea35091d8808a7a14963d7938ffe8f5e9
1657,bc1qz6lks9udfn78vx3cju9uyc6kqk6739hndak4ct,1493,43048781915,43048781915,2023-04-10 06:02:46,2023-02-24 14:02:25,0,outbound,baad8bfb7356156fe529bc5a64f0fd6ea35091d8808a7a14963d7938ffe8f5e9
1658,bc1qz6lks9udfn78vx3cju9uyc6kqk6739hndak4ct,1494,9997120,9997120,2023-02-01 10:19:53,2022-12-08 23:40:06,0,inbound,baad8bfb7356156fe529bc5a64f0fd6ea35091d8808a7a14963d7938ffe8f5e9
1659,bc1qz6lks9udfn78vx3cju9uyc6kqk6739hndak4ct,1495,2693351552,2693351552,2023-02-28 17:20:36,2022-10-05 20:17:17,0,inbound,baad8bfb7356156fe529bc5a64f0fd6ea35091d8808a7a14963d7938ffe8f5e9
1660,bc1qz6lks9udfn78vx3cju9uyc6kqk6739hndak4ct,1496,4486442,4486442,2023-02-20 19:38:31,2022-11-29 08:41:25,0,inbound,baad8bfb7356156fe529bc5a64f0fd6ea35091d8808a7a14963d7938ffe8f5e9
1661,bc1qz6lks9udfn78vx3cju9uyc6kqk6739hndak4ct,1497,4229596,4229596,2022-12-16 18:03:01,2022-12-16 17:42:54,0,inbound,baad8bfb7356156fe529bc5a64f0fd6ea35091d8808a7a14963d7938ffe8f5e9
1662,bc1qz6lks9udfn78vx3cju9uyc6kqk6739hndak4ct,1498,2249724912,2249724912,2023-02-09 09:33:08,2022-06-30 15:15:26,0,inbound,baad8bfb7356156fe529bc5a64f0fd6ea35091d8808a7a14963d7938ffe8f5e9
1663,bc1qz6lks9udfn78vx3cju9uyc6kqk6739hndak4ct,1499,168413847162,168377453351,2023-02-27 22:26:08,2023-04-06 18:37:34,36393811,outbound,baad8bfb7356156fe529bc5a64f0fd6ea35091d8808a7a14963d7938ffe8f5e9
1664,bc1qz6lks9udfn78vx3cju9uyc6kqk6739hndak4ct,1500,9685077245,9685077245,2022-12-16 19:23:02,2022-12-16 17:42:53,0,inbound,baad8bfb7356156fe529bc5a64f0fd6ea35091d8808a7a14963d7938ffe8f5e9
1665,bc1qz6lks9udfn78vx3cju9uyc6kqk6739hndak4ct,1501,1986828,1986828,2023-01-12 01:38:36,2022-12-02 22:04:08,0,inbound,baad8bfb7356156fe529bc5a64f0fd6ea35091d8808a7a14963d7938ffe8f5e9
1666,bc1qz6lks9udfn78vx3cju9uyc6kqk6739hndak4ct,1502,38484735,38484735,2023-03-20 14:09:23,2022-11-19 18:14:49,0,outbound,baad8bfb7356156fe529bc5a64f0fd6ea35091d8808a7a14963d7938ffe8f5e9
1667,bc1qz6lks9udfn78vx3cju9uyc6kqk6739hndak4ct,1503,555752,555752,2022-12-14 15:48:10,2022-12-14 14:44:10,0,inbound,baad8bfb7356156fe529bc5a64f0fd6ea35091d8808a7a14963d7938ffe8f5e9
1668,bc1qz6lks9udfn78vx3cju9uyc6kqk6739hndak4ct,1504,13175869,13175869,2023-03-11 22:16:27,2022-10-28 14:45:11,0,inbound,baad8bfb7356156fe529bc5a64f0fd6ea35091d8808a7a14963d7938ffe8f5e9
1669,bc1qz6lks9udfn78vx3cju9uyc6kqk6739hndak4ct,1505,3136252,3136252,2022-12-15 19:28:14,2022-12-14 14:44:10,0,inbound,baad8bfb7356156fe529bc5a64f0fd6ea35091d8808a7a14963d7938ffe8f5e9
1670,bc1qz6lks9udfn78vx3cju9uyc6kqk6739hndak4ct,1506,221493389,220508289,2023-04-10 11:23:01,2022-12-07 13:18:13,985100,outbound,baad8bfb7356156fe529bc5a64f0fd6ea35091d8808a7a14963d7938ffe8f5e9
1671,bc1qz6lks9udfn78vx3cju9uyc6kqk6739hndak4ct,1507,101884474,101884474,2022-12-14 15:18:08,2022-12-14 14:44:10,0,inbound,baad8bfb7356156fe529bc5a64f0fd6ea35091d8808a7a14963d7938ffe8f5e9
1672,bc1qz6lks9udfn78vx3cju9uyc6kqk6739hndak4ct,1508,420689,420689,2022-12-14 15:35:14,2022-12-14 14:44:10,0,inbound,baad8bfb7356156fe529bc5a64f0fd6ea35091d8808a7a14963d7938ffe8f5e9
1673,bc1qz6lks9udfn78vx3cju9uyc6kqk6739hndak4ct,1509,732368,732368,2022-12-14 15:53:39,2022-12-14 14:44:10,0,inbound,baad8bfb7356156fe529bc5a64f0fd6ea35091d8808a7a14963d7938ffe8f5e9
1674,bc1qz6lks9udfn78vx3cju9uyc6kqk6739hndak4ct,1510,59445845478,58888520021,2023-04-10 15:31:18,2023-03-13 21:08:23,557325457,inbound,baad8bfb7356156fe529bc5a64f0fd6ea35091d8808a7a14963d7938ffe8f5e9
1675,bc1qz6lks9udfn78vx3cju9uyc6kqk6739hndak4ct,1511,2916613,2916613,2022-12-14 15:33:12,2022-12-14 14:44:10,0,inbound,baad8bfb7356156fe529bc5a64f0fd6ea35091d8808a7a14963d7938ffe8f5e9
1676,bc1qz6lks9udfn78vx3cju9uyc6kqk6739hndak4ct,1512,446913039,446913039,2022-12-28 08:54:45,2022-07-20 21:43:36,0,inbound,baad8bfb7356156fe529bc5a64f0fd6ea35091d8808a7a14963d7938ffe8f5e9
1677,bc1qz6lks9udfn78vx3cju9uyc6kqk6739hndak4ct,1513,2313450,2313450,2022-12-16 05:44:28,2022-12-11 18:10:15,0,inbound,baad8bfb7356156fe529bc5a64f0fd6ea35091d8808a7a14963d7938ffe8f5e9
1678,bc1qz6lks9udfn78vx3cju9uyc6kqk6739hndak4ct,1514,718547341,718547341,2023-04-10 15:44:22,2022-12-23 06:13:07,0,inbound,baad8bfb7356156fe529bc5a64f0fd6ea35091d8808a7a14963d7938ffe8f5e9
1679,bc1qz6lks9udfn78vx3cju9uyc6kqk6739hndak4ct,1515,8241493,8241493,2022-12-14 15:49:31,2022-07-09 20:25:31,0,inbound,baad8bfb7356156fe529bc5a64f0fd6ea35091d8808a7a14963d7938ffe8f5e9
1680,bc1qz6lks9udfn78vx3cju9uyc6kqk6739hndak4ct,1516,795158,795158,2022-12-14 15:40:06,2022-12-14 14:44:10,0,inbound,baad8bfb7356156fe529bc5a64f0fd6ea35091d8808a7a14963d7938ffe8f5e9
1681,bc1qz6lks9udfn78vx3cju9uyc6kqk6739hndak4ct,1517,7060427,7060427,2023-04-08 08:19:19,2022-06-05 10:43:16,0,inbound,baad8bfb7356156fe529bc5a64f0fd6ea35091d8808a7a14963d7938ffe8f5e9
1682,bc1qz6lks9udfn78vx3cju9uyc6kqk6739hndak4ct,1518,780431,780431,2022-12-14 14:53:14,2022-12-14 14:44:10,0,inbound,baad8bfb7356156fe529bc5a64f0fd6ea35091d8808a7a14963d7938ffe8f5e9
1683,bc1qz6lks9udfn78vx3cju9uyc6kqk6739hndak4ct,1519,20766002,20766002,2023-02-04 00:29:49,2022-06-18 22:02:45,0,outbound,baad8bfb7356156fe529bc5a64f0fd6ea35091d8808a7a14963d7938ffe8f5e9
1684,bc1qz6lks9udfn78vx3cju9uyc6kqk6739hndak4ct,1520,502409,502409,2022-12-14 15:35:14,2022-12-14 14:44:10,0,inbound,baad8bfb7356156fe529bc5a64f0fd6ea35091d8808a7a14963d7938ffe8f5e9
1685,bc1qz6lks9udfn78vx3cju9uyc6kqk6739hndak4ct,1521,105486,105486,2023-02-24 10:08:15,2022-12-14 14:44:10,0,inbound,baad8bfb7356156fe529bc5a64f0fd6ea35091d8808a7a14963d7938ffe8f5e9
1686,bc1qz6lks9udfn78vx3cju9uyc6kqk6739hndak4ct,1522,8700362,0,2022-12-14 15:39:52,2022-12-14 14:44:10,8700362,inbound,baad8bfb7356156fe529bc5a64f0fd6ea35091d8808a7a14963d7938ffe8f5e9
1687,bc1qz6lks9udfn78vx3cju9uyc6kqk6739hndak4ct,1523,1110072,1110072,2022-12-14 16:21:01,2022-12-14 14:44:10,0,inbound,baad8bfb7356156fe529bc5a64f0fd6ea35091d8808a7a14963d7938ffe8f5e9
1688,bc1qz6lks9udfn78vx3cju9uyc6kqk6739hndak4ct,1524,169709,169709,2022-12-15 01:05:01,2022-12-14 14:44:10,0,inbound,baad8bfb7356156fe529bc5a64f0fd6ea35091d8808a7a14963d7938ffe8f5e9
1689,bc1qz6lks9udfn78vx3cju9uyc6kqk6739hndak4ct,1525,1698837,1698837,2022-12-19 21:42:29,2022-12-14 14:44:10,0,inbound,baad8bfb7356156fe529bc5a64f0fd6ea35091d8808a7a14963d7938ffe8f5e9
1690,bc1qz6lks9udfn78vx3cju9uyc6kqk6739hndak4ct,1526,543935,543935,2022-12-14 15:35:14,2022-12-14 14:44:10,0,inbound,baad8bfb7356156fe529bc5a64f0fd6ea35091d8808a7a14963d7938ffe8f5e9
1691,bc1qz6lks9udfn78vx3cju9uyc6kqk6739hndak4ct,1527,12800556,12776905,2022-12-14 14:44:10,2022-01-16 12:09:36,23651,inbound,baad8bfb7356156fe529bc5a64f0fd6ea35091d8808a7a14963d7938ffe8f5e9
1692,bc1qz6lks9udfn78vx3cju9uyc6kqk6739hndak4ct,1528,136579,136579,2022-12-23 17:29:33,2022-12-14 14:44:10,0,inbound,baad8bfb7356156fe529bc5a64f0fd6ea35091d8808a7a14963d7938ffe8f5e9
1693,bc1qz6lks9udfn78vx3cju9uyc6kqk6739hndak4ct,1529,555509,555509,2022-12-20 21:01:52,2022-12-14 14:44:10,0,inbound,baad8bfb7356156fe529bc5a64f0fd6ea35091d8808a7a14963d7938ffe8f5e9
1694,bc1qz6lks9udfn78vx3cju9uyc6kqk6739hndak4ct,1530,17381664,15157638,2023-04-10 08:25:43,2023-03-17 02:29:05,2224026,inbound,baad8bfb7356156fe529bc5a64f0fd6ea35091d8808a7a14963d7938ffe8f5e9
1695,bc1qz6lks9udfn78vx3cju9uyc6kqk6739hndak4ct,1531,88936192,88936192,2023-01-11 06:46:45,2022-05-09 00:31:06,0,inbound,baad8bfb7356156fe529bc5a64f0fd6ea35091d8808a7a14963d7938ffe8f5e9
1696,bc1qz6lks9udfn78vx3cju9uyc6kqk6739hndak4ct,1532,838049,838049,2022-12-14 15:26:08,2022-12-14 14:44:10,0,inbound,baad8bfb7356156fe529bc5a64f0fd6ea35091d8808a7a14963d7938ffe8f5e9
1697,bc1qz6lks9udfn78vx3cju9uyc6kqk6739hndak4ct,1533,28677744,28677744,2023-01-22 00:03:05,2022-12-15 03:01:36,0,outbound,baad8bfb7356156fe529bc5a64f0fd6ea35091d8808a7a14963d7938ffe8f5e9
1698,bc1qz6lks9udfn78vx3cju9uyc6kqk6739hndak4ct,1534,32013005,32013005,2023-04-09 14:00:34,2022-12-30 07:49:44,0,outbound,baad8bfb7356156fe529bc5a64f0fd6ea35091d8808a7a14963d7938ffe8f5e9
1699,bc1qz6lks9udfn78vx3cju9uyc6kqk6739hndak4ct,1535,111429,111429,2023-01-05 19:30:28,2022-12-14 14:44:10,0,inbound,baad8bfb7356156fe529bc5a64f0fd6ea35091d8808a7a14963d7938ffe8f5e9
1700,bc1qz6lks9udfn78vx3cju9uyc6kqk6739hndak4ct,1536,414565,414565,2022-12-14 16:02:16,2022-12-01 17:30:17,0,inbound,baad8bfb7356156fe529bc5a64f0fd6ea35091d8808a7a14963d7938ffe8f5e9
1701,bc1qz6lks9udfn78vx3cju9uyc6kqk6739hndak4ct,1537,54568516,54406650,2023-01-14 05:15:53,2022-02-03 12:33:32,161866,inbound,baad8bfb7356156fe529bc5a64f0fd6ea35091d8808a7a14963d7938ffe8f5e9
1702,bc1qz6lks9udfn78vx3cju9uyc6kqk6739hndak4ct,1538,10001104,10001104,2023-03-29 02:54:55,2022-11-09 11:38:07,0,inbound,f3f783e66b62c9525fbcbc9ab3eceb0273e777fe4c23633485b14aadfdc151b8
1703,bc1qz6lks9udfn78vx3cju9uyc6kqk6739hndak4ct,1539,17000000,17000000,2022-12-19 16:53:41,2022-12-14 14:44:10,0,inbound,cee5383c2dd172b0b1500993598051cc24a1391866f952556eb2b38ab579c7da
1704,bc1qz6lks9udfn78vx3cju9uyc6kqk6739hndak4ct,1540,12082362,12082362,2022-12-31 18:20:50,2022-12-05 01:26:09,0,inbound,cee5383c2dd172b0b1500993598051cc24a1391866f952556eb2b38ab579c7da
1705,bc1qz6lks9udfn78vx3cju9uyc6kqk6739hndak4ct,1541,95409,95409,2023-03-23 00:21:15,2022-12-14 14:44:10,0,inbound,cee5383c2dd172b0b1500993598051cc24a1391866f952556eb2b38ab579c7da
1706,bc1qz6lks9udfn78vx3cju9uyc6kqk6739hndak4ct,1542,17670,17670,2022-12-14 16:03:42,2022-12-14 14:44:10,0,inbound,a723fc0eb99d50bd4a4861d548a1dc6adfe9d52da6519ffe4ff29a6b3f1a48b8
1707,bc1qz6lks9udfn78vx3cju9uyc6kqk6739hndak4ct,1543,80960,80960,2022-12-14 15:59:59,2022-12-01 21:32:07,0,inbound,a723fc0eb99d50bd4a4861d548a1dc6adfe9d52da6519ffe4ff29a6b3f1a48b8
1708,bc1qz6lks9udfn78vx3cju9uyc6kqk6739hndak4ct,1544,101602,0,2022-12-14 14:44:10,2022-12-14 14:44:10,101602,inbound,a723fc0eb99d50bd4a4861d548a1dc6adfe9d52da6519ffe4ff29a6b3f1a48b8
1709,bc1qz6lks9udfn78vx3cju9uyc6kqk6739hndak4ct,1545,3715252,3715252,2022-12-16 08:22:05,2022-12-14 14:44:10,0,inbound,a723fc0eb99d50bd4a4861d548a1dc6adfe9d52da6519ffe4ff29a6b3f1a48b8
1710,bc1qz6lks9udfn78vx3cju9uyc6kqk6739hndak4ct,1546,67612,67612,2022-12-14 15:59:15,2022-12-14 14:44:10,0,inbound,a723fc0eb99d50bd4a4861d548a1dc6adfe9d52da6519ffe4ff29a6b3f1a48b8
1711,bc1qz6lks9udfn78vx3cju9uyc6kqk6739hndak4ct,1547,25305868,24067144,2023-02-11 20:17:09,2022-12-05 05:58:07,1238724,inbound,a723fc0eb99d50bd4a4861d548a1dc6adfe9d52da6519ffe4ff29a6b3f1a48b8
1712,bc1qz6lks9udfn78vx3cju9uyc6kqk6739hndak4ct,1548,421282,421282,2022-12-14 20:01:07,2022-12-14 14:29:09,0,inbound,a723fc0eb99d50bd4a4861d548a1dc6adfe9d52da6519ffe4ff29a6b3f1a48b8
1713,bc1qz6lks9udfn78vx3cju9uyc6kqk6739hndak4ct,1549,424097,424097,2022-12-14 15:01:41,2022-12-14 14:44:10,0,inbound,a723fc0eb99d50bd4a4861d548a1dc6adfe9d52da6519ffe4ff29a6b3f1a48b8
1714,bc1qz6lks9udfn78vx3cju9uyc6kqk6739hndak4ct,1550,751140,751140,2022-12-23 19:00:37,2022-11-09 13:13:10,0,inbound,a723fc0eb99d50bd4a4861d548a1dc6adfe9d52da6519ffe4ff29a6b3f1a48b8
1715,bc1qz6lks9udfn78vx3cju9uyc6kqk6739hndak4ct,1551,58029,58029,2022-12-14 15:59:59,2022-12-14 14:44:10,0,inbound,a723fc0eb99d50bd4a4861d548a1dc6adfe9d52da6519ffe4ff29a6b3f1a48b8
1716,bc1qz6lks9udfn78vx3cju9uyc6kqk6739hndak4ct,1552,11021297,11021297,2023-02-28 22:02:11,2022-06-15 18:24:06,0,inbound,a723fc0eb99d50bd4a4861d548a1dc6adfe9d52da6519ffe4ff29a6b3f1a48b8
1717,bc1qz6lks9udfn78vx3cju9uyc6kqk6739hndak4ct,1553,92968,92968,2023-02-10 09:44:57,2022-12-14 14:44:10,0,inbound,a723fc0eb99d50bd4a4861d548a1dc6adfe9d52da6519ffe4ff29a6b3f1a48b8
1718,bc1qz6lks9udfn78vx3cju9uyc6kqk6739hndak4ct,1554,136645,136645,2022-12-15 04:36:48,2022-12-14 14:44:10,0,inbound,a723fc0eb99d50bd4a4861d548a1dc6adfe9d52da6519ffe4ff29a6b3f1a48b8
1719,bc1qz6lks9udfn78vx3cju9uyc6kqk6739hndak4ct,1555,138745,138745,2023-02-20 03:01:44,2022-12-14 14:44:10,0,inbound,a723fc0eb99d50bd4a4861d548a1dc6adfe9d52da6519ffe4ff29a6b3f1a48b8
1720,bc1qz6lks9udfn78vx3cju9uyc6kqk6739hndak4ct,1556,765275479,764998779,2023-04-10 13:15:10,2023-04-05 10:46:25,276700,inbound,a723fc0eb99d50bd4a4861d548a1dc6adfe9d52da6519ffe4ff29a6b3f1a48b8
1721,bc1qz6lks9udfn78vx3cju9uyc6kqk6739hndak4ct,1557,180709,180709,2022-12-23 17:29:33,2022-12-14 14:44:10,0,inbound,a723fc0eb99d50bd4a4861d548a1dc6adfe9d52da6519ffe4ff29a6b3f1a48b8
1722,bc1qz6lks9udfn78vx3cju9uyc6kqk6739hndak4ct,1558,11100,11100,2023-02-22 11:51:35,2022-12-14 14:44:10,0,inbound,a723fc0eb99d50bd4a4861d548a1dc6adfe9d52da6519ffe4ff29a6b3f1a48b8
1723,bc1qz6lks9udfn78vx3cju9uyc6kqk6739hndak4ct,1559,217626369,217626369,2023-03-31 06:25:58,2023-02-15 02:09:18,0,inbound,a723fc0eb99d50bd4a4861d548a1dc6adfe9d52da6519ffe4ff29a6b3f1a48b8
1724,bc1qz6lks9udfn78vx3cju9uyc6kqk6739hndak4ct,1560,28661909,28661909,2023-03-14 23:09:56,2022-09-25 05:09:43,0,inbound,ef4bcd11f632d0393e6cef244c2db6512f0e55ce610cd66cff7795e167b60834
1725,bc1qz6lks9udfn78vx3cju9uyc6kqk6739hndak4ct,1561,47973,47973,2022-12-21 04:45:29,2022-12-14 14:44:10,0,inbound,ef4bcd11f632d0393e6cef244c2db6512f0e55ce610cd66cff7795e167b60834
1726,bc1qz6lks9udfn78vx3cju9uyc6kqk6739hndak4ct,1562,6759503,6759503,2022-12-23 16:24:03,2022-12-13 23:30:16,0,inbound,ef0135b597d647703c2847d1f3a283caf89cd8fb39d0ad96528cb7cc84e03025
1727,bc1qz6lks9udfn78vx3cju9uyc6kqk6739hndak4ct,1563,2000000,2000000,2022-12-14 22:40:39,2022-12-14 13:38:30,0,inbound,ef0135b597d647703c2847d1f3a283caf89cd8fb39d0ad96528cb7cc84e03025
1728,bc1qz6lks9udfn78vx3cju9uyc6kqk6739hndak4ct,1564,103208994,103208994,2023-01-12 07:23:17,2022-12-14 13:38:20,0,inbound,ef0135b597d647703c2847d1f3a283caf89cd8fb39d0ad96528cb7cc84e03025
1729,bc1qz6lks9udfn78vx3cju9uyc6kqk6739hndak4ct,1565,366341151,366341151,2023-04-05 12:09:20,2022-08-27 23:49:10,0,inbound,ef0135b597d647703c2847d1f3a283caf89cd8fb39d0ad96528cb7cc84e03025
1730,bc1qz6lks9udfn78vx3cju9uyc6kqk6739hndak4ct,1566,38367,0,2022-12-14 13:38:30,2022-12-14 13:38:30,38367,inbound,ef0135b597d647703c2847d1f3a283caf89cd8fb39d0ad96528cb7cc84e03025
1731,bc1qz6lks9udfn78vx3cju9uyc6kqk6739hndak4ct,1567,419407,0,2022-12-14 13:38:09,2022-12-14 13:35:10,419407,inbound,445073af9be5f425321e7fa5d7472488810a1625e4c062e5b1997b2cf12bcfab
1732,bc1qz6lks9udfn78vx3cju9uyc6kqk6739hndak4ct,1568,97174,97174,2022-12-15 02:51:30,2022-12-14 13:38:16,0,inbound,445073af9be5f425321e7fa5d7472488810a1625e4c062e5b1997b2cf12bcfab
1733,bc1qz6lks9udfn78vx3cju9uyc6kqk6739hndak4ct,1569,223746391,10973561,2023-04-10 12:36:05,2023-03-24 23:52:46,212772830,inbound,445073af9be5f425321e7fa5d7472488810a1625e4c062e5b1997b2cf12bcfab
1734,bc1qz6lks9udfn78vx3cju9uyc6kqk6739hndak4ct,1570,1074642195,1074642195,2023-03-31 10:16:58,2023-02-12 14:08:16,0,inbound,445073af9be5f425321e7fa5d7472488810a1625e4c062e5b1997b2cf12bcfab
1735,bc1qz6lks9udfn78vx3cju9uyc6kqk6739hndak4ct,1571,140413,140413,2022-12-15 00:10:18,2022-12-07 23:12:10,0,inbound,445073af9be5f425321e7fa5d7472488810a1625e4c062e5b1997b2cf12bcfab
1736,bc1qz6lks9udfn78vx3cju9uyc6kqk6739hndak4ct,1572,15497665935,15497665935,2023-03-12 14:46:59,2023-01-07 14:02:05,0,outbound,445073af9be5f425321e7fa5d7472488810a1625e4c062e5b1997b2cf12bcfab
1737,bc1qz6lks9udfn78vx3cju9uyc6kqk6739hndak4ct,1573,9342489,9342489,2023-04-03 15:33:06,2022-12-07 18:33:11,0,outbound,445073af9be5f425321e7fa5d7472488810a1625e4c062e5b1997b2cf12bcfab
1738,bc1qz6lks9udfn78vx3cju9uyc6kqk6739hndak4ct,1574,250356171,250356171,2023-01-17 14:25:12,2022-11-16 15:26:10,0,inbound,445073af9be5f425321e7fa5d7472488810a1625e4c062e5b1997b2cf12bcfab
1739,bc1qz6lks9udfn78vx3cju9uyc6kqk6739hndak4ct,1575,5319119,5226281,2023-04-05 10:02:49,2020-04-09 16:39:40,92838,inbound,445073af9be5f425321e7fa5d7472488810a1625e4c062e5b1997b2cf12bcfab
1740,bc1qz6lks9udfn78vx3cju9uyc6kqk6739hndak4ct,1576,4935291,4935291,2022-12-29 09:26:37,2022-12-14 13:38:09,0,inbound,445073af9be5f425321e7fa5d7472488810a1625e4c062e5b1997b2cf12bcfab
1741,bc1qz6lks9udfn78vx3cju9uyc6kqk6739hndak4ct,1577,499920073,492834437,2023-04-10 05:29:57,2022-12-30 15:53:10,7085636,inbound,445073af9be5f425321e7fa5d7472488810a1625e4c062e5b1997b2cf12bcfab
1742,bc1qz6lks9udfn78vx3cju9uyc6kqk6739hndak4ct,1578,200551622,199774330,2023-04-08 21:19:09,2022-12-24 02:54:12,777292,inbound,445073af9be5f425321e7fa5d7472488810a1625e4c062e5b1997b2cf12bcfab
1743,bc1qz6lks9udfn78vx3cju9uyc6kqk6739hndak4ct,1579,411332,0,2022-12-14 13:38:30,2022-12-14 00:47:09,411332,inbound,445073af9be5f425321e7fa5d7472488810a1625e4c062e5b1997b2cf12bcfab
1744,bc1qz6lks9udfn78vx3cju9uyc6kqk6739hndak4ct,1580,16721713,16721713,2023-01-19 00:00:54,2023-01-08 04:18:08,0,inbound,445073af9be5f425321e7fa5d7472488810a1625e4c062e5b1997b2cf12bcfab
1745,bc1qz6lks9udfn78vx3cju9uyc6kqk6739hndak4ct,1581,3444554,3444554,2022-12-14 13:53:35,2022-12-09 16:46:07,0,inbound,445073af9be5f425321e7fa5d7472488810a1625e4c062e5b1997b2cf12bcfab
1746,bc1qz6lks9udfn78vx3cju9uyc6kqk6739hndak4ct,1582,12775338,12775338,2023-01-16 19:38:25,2022-01-12 22:39:36,0,inbound,445073af9be5f425321e7fa5d7472488810a1625e4c062e5b1997b2cf12bcfab
1747,bc1qz6lks9udfn78vx3cju9uyc6kqk6739hndak4ct,1583,62536,62536,2022-12-14 21:16:31,2022-12-14 13:38:30,0,inbound,445073af9be5f425321e7fa5d7472488810a1625e4c062e5b1997b2cf12bcfab
1748,bc1qz6lks9udfn78vx3cju9uyc6kqk6739hndak4ct,1584,1232368,1232368,2022-12-14 14:21:02,2022-12-14 13:38:08,0,inbound,445073af9be5f425321e7fa5d7472488810a1625e4c062e5b1997b2cf12bcfab
1749,bc1qz6lks9udfn78vx3cju9uyc6kqk6739hndak4ct,1585,34000,34000,2023-01-01 10:38:53,2022-12-14 13:38:19,0,inbound,445073af9be5f425321e7fa5d7472488810a1625e4c062e5b1997b2cf12bcfab
1750,bc1qz6lks9udfn78vx3cju9uyc6kqk6739hndak4ct,1586,318910,318910,2022-12-14 14:58:14,2022-12-14 13:38:16,0,inbound,445073af9be5f425321e7fa5d7472488810a1625e4c062e5b1997b2cf12bcfab
1751,bc1qz6lks9udfn78vx3cju9uyc6kqk6739hndak4ct,1587,901099,901099,2022-12-15 03:16:27,2022-12-14 13:38:19,0,inbound,445073af9be5f425321e7fa5d7472488810a1625e4c062e5b1997b2cf12bcfab
1752,bc1qz6lks9udfn78vx3cju9uyc6kqk6739hndak4ct,1588,426879,426879,2022-12-20 17:29:09,2022-12-14 13:38:08,0,inbound,445073af9be5f425321e7fa5d7472488810a1625e4c062e5b1997b2cf12bcfab
1753,bc1qz6lks9udfn78vx3cju9uyc6kqk6739hndak4ct,1589,263043,263043,2022-12-15 22:19:35,2022-12-14 13:38:08,0,inbound,445073af9be5f425321e7fa5d7472488810a1625e4c062e5b1997b2cf12bcfab
1754,bc1qz6lks9udfn78vx3cju9uyc6kqk6739hndak4ct,1590,589311919,589311919,2022-12-14 14:31:09,2022-12-14 13:38:08,0,inbound,445073af9be5f425321e7fa5d7472488810a1625e4c062e5b1997b2cf12bcfab
1755,bc1qz6lks9udfn78vx3cju9uyc6kqk6739hndak4ct,1591,100098639,0,2022-12-12 22:04:48,2022-12-12 21:46:50,100098639,inbound,445073af9be5f425321e7fa5d7472488810a1625e4c062e5b1997b2cf12bcfab
1756,bc1qz6lks9udfn78vx3cju9uyc6kqk6739hndak4ct,1592,41734493,41734493,2023-04-08 05:19:56,2019-12-03 13:57:30,0,inbound,445073af9be5f425321e7fa5d7472488810a1625e4c062e5b1997b2cf12bcfab
1757,bc1qz6lks9udfn78vx3cju9uyc6kqk6739hndak4ct,1593,180000,180000,2022-12-12 22:08:23,2022-12-12 22:04:48,0,inbound,445073af9be5f425321e7fa5d7472488810a1625e4c062e5b1997b2cf12bcfab
1758,bc1qz6lks9udfn78vx3cju9uyc6kqk6739hndak4ct,1594,4133000,4133000,2022-12-12 23:20:33,2022-12-12 22:04:48,0,inbound,445073af9be5f425321e7fa5d7472488810a1625e4c062e5b1997b2cf12bcfab
1759,bc1qz6lks9udfn78vx3cju9uyc6kqk6739hndak4ct,1595,109192204,0,2022-12-12 22:04:48,2022-03-17 13:37:12,109192204,inbound,445073af9be5f425321e7fa5d7472488810a1625e4c062e5b1997b2cf12bcfab
1760,bc1qz6lks9udfn78vx3cju9uyc6kqk6739hndak4ct,1596,261000,261000,2022-12-13 02:49:24,2022-12-12 22:04:48,0,inbound,445073af9be5f425321e7fa5d7472488810a1625e4c062e5b1997b2cf12bcfab
1761,bc1qz6lks9udfn78vx3cju9uyc6kqk6739hndak4ct,1597,9345704,0,2022-12-12 22:04:48,2022-12-12 22:04:48,9345704,inbound,445073af9be5f425321e7fa5d7472488810a1625e4c062e5b1997b2cf12bcfab
1762,bc1qz6lks9udfn78vx3cju9uyc6kqk6739hndak4ct,1598,6073252,0,2022-12-12 22:04:48,2022-12-12 22:04:48,6073252,inbound,445073af9be5f425321e7fa5d7472488810a1625e4c062e5b1997b2cf12bcfab
1763,bc1qz6lks9udfn78vx3cju9uyc6kqk6739hndak4ct,1599,547931,0,2022-12-12 22:04:48,2022-12-12 22:04:48,547931,inbound,445073af9be5f425321e7fa5d7472488810a1625e4c062e5b1997b2cf12bcfab
1764,bc1qz6lks9udfn78vx3cju9uyc6kqk6739hndak4ct,1600,1324219,0,2022-12-12 22:04:48,2022-12-12 22:04:48,1324219,inbound,445073af9be5f425321e7fa5d7472488810a1625e4c062e5b1997b2cf12bcfab
1765,bc1qz6lks9udfn78vx3cju9uyc6kqk6739hndak4ct,1601,7891000,7891000,2023-03-15 16:12:01,2022-12-12 22:04:48,0,inbound,445073af9be5f425321e7fa5d7472488810a1625e4c062e5b1997b2cf12bcfab
1766,bc1qz6lks9udfn78vx3cju9uyc6kqk6739hndak4ct,1602,2529999,329999,2022-12-12 22:04:48,2021-09-09 22:24:01,2200000,inbound,445073af9be5f425321e7fa5d7472488810a1625e4c062e5b1997b2cf12bcfab
1767,bc1qz6lks9udfn78vx3cju9uyc6kqk6739hndak4ct,1603,42678132,42678132,2023-01-09 22:50:41,2022-12-09 04:03:14,0,inbound,445073af9be5f425321e7fa5d7472488810a1625e4c062e5b1997b2cf12bcfab
1768,bc1qz6lks9udfn78vx3cju9uyc6kqk6739hndak4ct,1604,26274379,26274379,2023-01-02 11:23:49,2022-12-03 22:54:48,0,outbound,445073af9be5f425321e7fa5d7472488810a1625e4c062e5b1997b2cf12bcfab
1769,bc1qz6lks9udfn78vx3cju9uyc6kqk6739hndak4ct,1605,72418362,0,2023-04-02 19:38:40,2022-06-26 16:45:08,72418362,inbound,445073af9be5f425321e7fa5d7472488810a1625e4c062e5b1997b2cf12bcfab
1770,bc1qz6lks9udfn78vx3cju9uyc6kqk6739hndak4ct,1606,2899380,2899380,2023-02-01 14:52:29,2022-12-12 22:04:48,0,inbound,445073af9be5f425321e7fa5d7472488810a1625e4c062e5b1997b2cf12bcfab
1771,bc1qz6lks9udfn78vx3cju9uyc6kqk6739hndak4ct,1607,4486807,4486807,2022-12-12 22:26:42,2022-12-12 22:04:48,0,inbound,445073af9be5f425321e7fa5d7472488810a1625e4c062e5b1997b2cf12bcfab
1772,bc1qz6lks9udfn78vx3cju9uyc6kqk6739hndak4ct,1608,180000,0,2022-12-12 22:04:48,2022-12-12 22:04:48,180000,inbound,445073af9be5f425321e7fa5d7472488810a1625e4c062e5b1997b2cf12bcfab
1773,bc1qz6lks9udfn78vx3cju9uyc6kqk6739hndak4ct,1609,98000,98000,2022-12-14 02:45:00,2022-12-12 22:04:48,0,inbound,445073af9be5f425321e7fa5d7472488810a1625e4c062e5b1997b2cf12bcfab
1774,bc1qz6lks9udfn78vx3cju9uyc6kqk6739hndak4ct,1610,4182535,4182535,2022-12-12 22:26:42,2022-12-12 22:04:48,0,inbound,445073af9be5f425321e7fa5d7472488810a1625e4c062e5b1997b2cf12bcfab
1775,bc1qz6lks9udfn78vx3cju9uyc6kqk6739hndak4ct,1611,2044568,2044568,2023-01-14 10:02:44,2022-12-12 22:04:48,0,inbound,445073af9be5f425321e7fa5d7472488810a1625e4c062e5b1997b2cf12bcfab
1776,bc1qz6lks9udfn78vx3cju9uyc6kqk6739hndak4ct,1612,305970,305970,2022-12-12 22:04:50,2022-12-12 22:04:48,0,inbound,445073af9be5f425321e7fa5d7472488810a1625e4c062e5b1997b2cf12bcfab
1777,bc1qz6lks9udfn78vx3cju9uyc6kqk6739hndak4ct,1613,939555,939555,2022-12-12 22:25:03,2022-12-12 22:04:48,0,inbound,445073af9be5f425321e7fa5d7472488810a1625e4c062e5b1997b2cf12bcfab
1778,bc1qz6lks9udfn78vx3cju9uyc6kqk6739hndak4ct,1614,7754212990,7754212990,2023-03-01 08:33:26,2022-12-01 09:05:22,0,outbound,445073af9be5f425321e7fa5d7472488810a1625e4c062e5b1997b2cf12bcfab
1779,bc1qz6lks9udfn78vx3cju9uyc6kqk6739hndak4ct,1615,364435,364435,2023-02-04 00:21:22,2022-12-12 22:04:48,0,inbound,445073af9be5f425321e7fa5d7472488810a1625e4c062e5b1997b2cf12bcfab
1780,bc1qz6lks9udfn78vx3cju9uyc6kqk6739hndak4ct,1616,19895468773,19895468773,2023-01-21 02:08:27,2022-12-15 08:54:47,0,inbound,445073af9be5f425321e7fa5d7472488810a1625e4c062e5b1997b2cf12bcfab
1781,bc1qz6lks9udfn78vx3cju9uyc6kqk6739hndak4ct,1617,221980000,221980000,2023-04-08 09:30:40,2022-04-14 19:22:37,0,inbound,445073af9be5f425321e7fa5d7472488810a1625e4c062e5b1997b2cf12bcfab
1782,bc1qz6lks9udfn78vx3cju9uyc6kqk6739hndak4ct,1618,128397,128397,2022-12-12 22:25:03,2022-12-12 22:04:48,0,inbound,445073af9be5f425321e7fa5d7472488810a1625e4c062e5b1997b2cf12bcfab
1783,bc1qz6lks9udfn78vx3cju9uyc6kqk6739hndak4ct,1619,2654100,2654100,2023-01-07 09:51:16,2022-12-12 22:04:48,0,inbound,445073af9be5f425321e7fa5d7472488810a1625e4c062e5b1997b2cf12bcfab
1784,bc1qz6lks9udfn78vx3cju9uyc6kqk6739hndak4ct,1620,514601935036,514125441790,2023-04-10 14:38:43,2023-03-17 21:40:55,476493246,inbound,445073af9be5f425321e7fa5d7472488810a1625e4c062e5b1997b2cf12bcfab
1785,bc1qz6lks9udfn78vx3cju9uyc6kqk6739hndak4ct,1621,12017347,12013515,2023-01-08 10:51:57,2022-01-14 21:19:17,3832,inbound,445073af9be5f425321e7fa5d7472488810a1625e4c062e5b1997b2cf12bcfab
1786,bc1qz6lks9udfn78vx3cju9uyc6kqk6739hndak4ct,1622,83854590,83854590,2023-04-04 00:30:45,2022-12-12 22:04:48,0,inbound,445073af9be5f425321e7fa5d7472488810a1625e4c062e5b1997b2cf12bcfab
1787,bc1qz6lks9udfn78vx3cju9uyc6kqk6739hndak4ct,1623,9154742,0,2022-12-12 22:04:49,2022-12-12 22:04:49,9154742,inbound,445073af9be5f425321e7fa5d7472488810a1625e4c062e5b1997b2cf12bcfab
1788,bc1qz6lks9udfn78vx3cju9uyc6kqk6739hndak4ct,1624,11454262,10832668,2023-04-09 20:04:38,2022-11-14 02:21:00,621594,inbound,445073af9be5f425321e7fa5d7472488810a1625e4c062e5b1997b2cf12bcfab
1789,bc1qz6lks9udfn78vx3cju9uyc6kqk6739hndak4ct,1625,25582443638018,25579098658018,2023-04-10 16:38:41,2023-03-31 12:36:41,3344980000,inbound,445073af9be5f425321e7fa5d7472488810a1625e4c062e5b1997b2cf12bcfab
1790,bc1qz6lks9udfn78vx3cju9uyc6kqk6739hndak4ct,1626,388000,388000,2022-12-12 22:24:03,2022-12-12 22:04:48,0,inbound,445073af9be5f425321e7fa5d7472488810a1625e4c062e5b1997b2cf12bcfab
1791,bc1qz6lks9udfn78vx3cju9uyc6kqk6739hndak4ct,1627,35316111,35316111,2022-12-12 22:26:42,2022-12-12 22:04:48,0,inbound,445073af9be5f425321e7fa5d7472488810a1625e4c062e5b1997b2cf12bcfab
1792,bc1qz6lks9udfn78vx3cju9uyc6kqk6739hndak4ct,1628,2517952,0,2022-12-12 22:04:48,2022-12-12 22:04:48,2517952,inbound,445073af9be5f425321e7fa5d7472488810a1625e4c062e5b1997b2cf12bcfab
1793,bc1qz6lks9udfn78vx3cju9uyc6kqk6739hndak4ct,1629,177277,177277,2022-12-13 01:28:30,2022-12-12 22:04:48,0,inbound,445073af9be5f425321e7fa5d7472488810a1625e4c062e5b1997b2cf12bcfab
1794,bc1qz6lks9udfn78vx3cju9uyc6kqk6739hndak4ct,1630,1345676,1291255,2023-01-20 10:12:57,2022-12-12 22:04:48,54421,inbound,445073af9be5f425321e7fa5d7472488810a1625e4c062e5b1997b2cf12bcfab
1795,bc1qz6lks9udfn78vx3cju9uyc6kqk6739hndak4ct,1631,19148262,0,2022-12-12 22:04:48,2022-12-12 22:04:48,19148262,inbound,445073af9be5f425321e7fa5d7472488810a1625e4c062e5b1997b2cf12bcfab
1796,bc1qz6lks9udfn78vx3cju9uyc6kqk6739hndak4ct,1632,386505410,386505410,2023-02-05 13:09:20,2022-08-20 02:34:41,0,inbound,445073af9be5f425321e7fa5d7472488810a1625e4c062e5b1997b2cf12bcfab
1797,bc1qz6lks9udfn78vx3cju9uyc6kqk6739hndak4ct,1633,76474337,76474337,2022-12-13 22:33:37,2022-12-11 16:16:46,0,inbound,445073af9be5f425321e7fa5d7472488810a1625e4c062e5b1997b2cf12bcfab
1798,bc1qz6lks9udfn78vx3cju9uyc6kqk6739hndak4ct,1634,1254000,1254000,2022-12-12 22:06:29,2022-12-07 21:48:46,0,inbound,445073af9be5f425321e7fa5d7472488810a1625e4c062e5b1997b2cf12bcfab
1799,bc1qz6lks9udfn78vx3cju9uyc6kqk6739hndak4ct,1635,22373674,0,2022-12-12 22:04:48,2022-12-12 22:04:48,22373674,inbound,445073af9be5f425321e7fa5d7472488810a1625e4c062e5b1997b2cf12bcfab
1800,bc1qz6lks9udfn78vx3cju9uyc6kqk6739hndak4ct,1636,10533965,0,2022-12-12 22:04:48,2022-12-12 22:04:48,10533965,inbound,445073af9be5f425321e7fa5d7472488810a1625e4c062e5b1997b2cf12bcfab
1801,bc1qz6lks9udfn78vx3cju9uyc6kqk6739hndak4ct,1637,2609835,2609835,2022-12-29 12:35:54,2022-12-12 22:04:48,0,inbound,445073af9be5f425321e7fa5d7472488810a1625e4c062e5b1997b2cf12bcfab
1802,bc1qz6lks9udfn78vx3cju9uyc6kqk6739hndak4ct,1638,12063157,0,2022-12-12 22:04:48,2022-12-12 22:04:48,12063157,inbound,445073af9be5f425321e7fa5d7472488810a1625e4c062e5b1997b2cf12bcfab
1803,bc1qz6lks9udfn78vx3cju9uyc6kqk6739hndak4ct,1639,126269000,126269000,2022-12-13 06:58:40,2022-12-09 22:30:45,0,inbound,445073af9be5f425321e7fa5d7472488810a1625e4c062e5b1997b2cf12bcfab
1804,bc1qz6lks9udfn78vx3cju9uyc6kqk6739hndak4ct,1640,550180000,550180000,2023-03-06 12:57:55,2022-12-12 22:00:48,0,inbound,445073af9be5f425321e7fa5d7472488810a1625e4c062e5b1997b2cf12bcfab
1805,bc1qz6lks9udfn78vx3cju9uyc6kqk6739hndak4ct,1641,4869442,0,2022-12-12 22:04:48,2022-12-12 22:04:48,4869442,inbound,445073af9be5f425321e7fa5d7472488810a1625e4c062e5b1997b2cf12bcfab
1806,bc1qz6lks9udfn78vx3cju9uyc6kqk6739hndak4ct,1642,2200000,2200000,2023-01-14 20:02:06,2022-12-12 22:04:48,0,inbound,445073af9be5f425321e7fa5d7472488810a1625e4c062e5b1997b2cf12bcfab
1807,bc1qz6lks9udfn78vx3cju9uyc6kqk6739hndak4ct,1643,82595000,82595000,2023-01-14 22:06:52,2022-12-12 22:04:48,0,inbound,445073af9be5f425321e7fa5d7472488810a1625e4c062e5b1997b2cf12bcfab
1808,bc1qz6lks9udfn78vx3cju9uyc6kqk6739hndak4ct,1644,39481818,39481818,2023-02-26 02:08:43,2022-09-14 13:33:04,0,outbound,445073af9be5f425321e7fa5d7472488810a1625e4c062e5b1997b2cf12bcfab
1809,bc1qz6lks9udfn78vx3cju9uyc6kqk6739hndak4ct,1645,18913484,0,2023-02-16 19:07:20,2022-12-07 20:24:50,18913484,inbound,445073af9be5f425321e7fa5d7472488810a1625e4c062e5b1997b2cf12bcfab
1810,bc1qz6lks9udfn78vx3cju9uyc6kqk6739hndak4ct,1646,300000,0,2022-12-12 22:04:48,2022-12-12 22:04:48,300000,inbound,445073af9be5f425321e7fa5d7472488810a1625e4c062e5b1997b2cf12bcfab
1811,bc1qz6lks9udfn78vx3cju9uyc6kqk6739hndak4ct,1647,40719792,0,2022-12-12 22:04:48,2022-12-12 18:44:51,40719792,inbound,445073af9be5f425321e7fa5d7472488810a1625e4c062e5b1997b2cf12bcfab
1812,bc1qz6lks9udfn78vx3cju9uyc6kqk6739hndak4ct,1648,3032908,3032908,2023-02-23 13:24:29,2022-12-12 22:04:48,0,inbound,445073af9be5f425321e7fa5d7472488810a1625e4c062e5b1997b2cf12bcfab
1813,bc1qz6lks9udfn78vx3cju9uyc6kqk6739hndak4ct,1649,108498626,0,2023-04-05 08:08:02,2022-11-26 18:40:47,108498626,inbound,445073af9be5f425321e7fa5d7472488810a1625e4c062e5b1997b2cf12bcfab
1814,bc1qz6lks9udfn78vx3cju9uyc6kqk6739hndak4ct,1650,560000,560000,2022-12-12 22:21:10,2022-12-12 22:04:48,0,inbound,445073af9be5f425321e7fa5d7472488810a1625e4c062e5b1997b2cf12bcfab
1815,bc1qz6lks9udfn78vx3cju9uyc6kqk6739hndak4ct,1651,14053728,14053728,2022-12-14 08:45:44,2022-12-12 07:43:22,0,inbound,445073af9be5f425321e7fa5d7472488810a1625e4c062e5b1997b2cf12bcfab
1816,bc1qz6lks9udfn78vx3cju9uyc6kqk6739hndak4ct,1652,40730075,40730075,2023-02-17 01:48:37,2022-07-25 06:32:43,0,inbound,445073af9be5f425321e7fa5d7472488810a1625e4c062e5b1997b2cf12bcfab
