,address,id,total_received,total_sent,first_tx,last_tx,final_balance,direction,hash
0,bc1qz6lks9udfn78vx3cju9uyc6kqk6739hndak4ct,1,11607291250,11604653370,1680700472,1670559791,2637880,inbound,b49bf173ef46274d1e85c57b8bc2f4c3edb8dbc8890c891a94e025ee469c7b25
1,bc1qz6lks9udfn78vx3cju9uyc6kqk6739hndak4ct,2,11607291250,11604653370,1680700472,1670559791,2637880,inbound,b49bf173ef46274d1e85c57b8bc2f4c3edb8dbc8890c891a94e025ee469c7b25
2,bc1q0rmvvnux0czn4dfgxpez9qrh978ympud5j8lg9,3,474228448659,474205830004,1681095758,1681046698,22618655,outbound,b49bf173ef46274d1e85c57b8bc2f4c3edb8dbc8890c891a94e025ee469c7b25
3,bc1qxlp6ct6p4l89gdeh06k2npl05nutzcndw6xkee,151,7576930,0,1673625947,1673625947,7576930,inbound,b49bf173ef46274d1e85c57b8bc2f4c3edb8dbc8890c891a94e025ee469c7b25
4,bc1q6mwe8w8fn46xujzf45mmn0yq7ce2agnaw63h4h,152,40509276,0,1673327631,1672616563,40509276,inbound,b49bf173ef46274d1e85c57b8bc2f4c3edb8dbc8890c891a94e025ee469c7b25
5,bc1qta2kfsmqymrlu90g9qwzaggx0tplg65q52tu83h24ahwmn8hy7sq8t99c7,223,284961,284961,1672851511,1672763949,0,inbound,b49bf173ef46274d1e85c57b8bc2f4c3edb8dbc8890c891a94e025ee469c7b25
6,bc1qu2v3q3jnvhp3t6uh6x9n9l6wwsxqgrn3ad6lny,224,22420354,0,1680536290,1657650669,22420354,inbound,b49bf173ef46274d1e85c57b8bc2f4c3edb8dbc8890c891a94e025ee469c7b25
7,bc1qkj83r8ys0u7tt4hzqntjpq5kl92dez52p4rtql,246,110554716,110389444,1680851287,1674027517,165272,inbound,b49bf173ef46274d1e85c57b8bc2f4c3edb8dbc8890c891a94e025ee469c7b25
8,bc1qdlz736s2k6t3txxnaw4v5zz5ffunumlfewahdx,247,12005918,12005918,1673020594,1672763951,0,inbound,b49bf173ef46274d1e85c57b8bc2f4c3edb8dbc8890c891a94e025ee469c7b25
9,3P2jhSon6Uj2hG4pYnDTzrsNdiutR5V5bY,272,45173,45173,1672583903,1672508827,0,inbound,b49bf173ef46274d1e85c57b8bc2f4c3edb8dbc8890c891a94e025ee469c7b25
10,13U2ejfokTuVAhxBt7pFsyK6UoxSrtcyQq,273,482685,482685,1672602136,1672508827,0,inbound,b49bf173ef46274d1e85c57b8bc2f4c3edb8dbc8890c891a94e025ee469c7b25
11,176nm4c4KipzX2W1jCaTW1Ho4hoJ7tPXqT,306,60342,0,1672508827,1672508827,60342,inbound,b49bf173ef46274d1e85c57b8bc2f4c3edb8dbc8890c891a94e025ee469c7b25
12,3Cvowy4mAB1gU5UdSkDX5rmyiCpRP4v9aS,307,261331296,260660430,1680427162,1679028429,670866,inbound,b49bf173ef46274d1e85c57b8bc2f4c3edb8dbc8890c891a94e025ee469c7b25
13,3FuCWC2dN9bP1GToW5XEVT7r3jbPmhVP4g,424,1120832,1120832,1672430733,1672264538,0,inbound,b49bf173ef46274d1e85c57b8bc2f4c3edb8dbc8890c891a94e025ee469c7b25
14,bc1q36grw83p9z572ae0hh7hsze7faq7762qhvaynx,425,531318,531318,1672272793,1672264538,0,inbound,b49bf173ef46274d1e85c57b8bc2f4c3edb8dbc8890c891a94e025ee469c7b25
15,34edjyPHsyYjfxqY2YetGDKbC3g5bUQBrS,435,1173768,1173768,1672757802,1672264538,0,inbound,b49bf173ef46274d1e85c57b8bc2f4c3edb8dbc8890c891a94e025ee469c7b25
16,bc1qm96jccpq5tua5pruv9kwqx2r34pd9nem99lt4p,436,227017753,227017753,1672278673,1672264538,0,inbound,b49bf173ef46274d1e85c57b8bc2f4c3edb8dbc8890c891a94e025ee469c7b25
17,bc1qcfckw3csfvgrs5fqr2kc7kj92zxtz9c69d3pwa,464,1267350756,1267350756,1681096521,1676616220,0,inbound,b49bf173ef46274d1e85c57b8bc2f4c3edb8dbc8890c891a94e025ee469c7b25
18,3JcUcAnGfHaNQ9xk2q7Jio8S21iLyan1Kd,465,121171,121171,1672333001,1672264538,0,inbound,b49bf173ef46274d1e85c57b8bc2f4c3edb8dbc8890c891a94e025ee469c7b25
19,3QhDC3zvMTkpApyBrCd5XjeSE6hvBNTy3K,469,363477,363477,1672836431,1672264538,0,inbound,b49bf173ef46274d1e85c57b8bc2f4c3edb8dbc8890c891a94e025ee469c7b25
20,3Mc77A6QPUWoEi52zj45GDFB6KsdQVvLao,470,46552177,46552177,1678380133,1672360171,0,inbound,b49bf173ef46274d1e85c57b8bc2f4c3edb8dbc8890c891a94e025ee469c7b25
21,bc1qnykuy6z980fg4tu2s8dmngzskdwnzxwa09gyyf,700,398792308,398792308,1675450588,1673211733,0,outbound,b49bf173ef46274d1e85c57b8bc2f4c3edb8dbc8890c891a94e025ee469c7b25
22,1CaTSSWkWQizgdKZ1SVtyAyMGmqACXYwiQ,701,23187812,23187812,1676916093,1666245690,0,outbound,b49bf173ef46274d1e85c57b8bc2f4c3edb8dbc8890c891a94e025ee469c7b25
23,3HmEJoU37GaaqzqzwMUwzDBwZvmEExCoTK,860,5945000,5945000,1672085203,1672082849,0,inbound,b49bf173ef46274d1e85c57b8bc2f4c3edb8dbc8890c891a94e025ee469c7b25
24,1Nvq2qhBomxNjArhSP2HrCMSCU1pgYpAE6,861,417777247,417777247,1680538282,1672427624,0,inbound,b49bf173ef46274d1e85c57b8bc2f4c3edb8dbc8890c891a94e025ee469c7b25
25,bc1qhcxvnwaj5sc7pzxpzfuxzp5rk70aru5przmfzs,864,92788063,92788063,1673599671,1669805600,0,inbound,b49bf173ef46274d1e85c57b8bc2f4c3edb8dbc8890c891a94e025ee469c7b25
26,bc1qr84k05mst0ghtf827leac70mqarpvx6e3xdkrj,865,3215460,3208595,1680299952,1670300165,6865,inbound,b49bf173ef46274d1e85c57b8bc2f4c3edb8dbc8890c891a94e025ee469c7b25
27,bc1q60ycxeldtk4a0mzc2necawu70dg45xwjut07en,1166,85096209,85096209,1672477679,1671665977,0,inbound,b49bf173ef46274d1e85c57b8bc2f4c3edb8dbc8890c891a94e025ee469c7b25
28,1HbJfkB3PmKgpN3dVDMRKjmAjQtxWf4Tee,1167,145117511,144603494,1681063294,1678581378,514017,inbound,b49bf173ef46274d1e85c57b8bc2f4c3edb8dbc8890c891a94e025ee469c7b25
29,32VTZWV7cRY9yQFzUeiHWcbnhWWjqt6CVn,1653,108600,108600,1670848446,1670831806,0,inbound,b49bf173ef46274d1e85c57b8bc2f4c3edb8dbc8890c891a94e025ee469c7b25
30,bc1qf4ygy69laltvrra8jm9mpxvph7323fucnqdkf6,1654,1494335,1494335,1670941255,1670831806,0,inbound,b49bf173ef46274d1e85c57b8bc2f4c3edb8dbc8890c891a94e025ee469c7b25
31,bc1q43p7mmcavc0mzqdxltkn5h9m5dg0w6mnh7698c,4,855935786,855935786,1680694817,1659457883,0,inbound,0f29ee96114823ff226a01da3c5fdb0bba83179bc275a7f92e1f05963c6d49ef
32,3KXh1gJtDKY8uottd6cENF9dYSiwSQwZy9,153,6024893,5114174,1680080638,1673327631,910719,inbound,0f29ee96114823ff226a01da3c5fdb0bba83179bc275a7f92e1f05963c6d49ef
33,1AZRJYWN2ZeFg8mUf7ErLSaFU6Y6fVEB5b,225,1866730354,1866730354,1679551259,1609790601,0,outbound,0f29ee96114823ff226a01da3c5fdb0bba83179bc275a7f92e1f05963c6d49ef
34,bc1qqusjr9hx9ujn4swx38d8nu4678e5gje2c7ard5,248,472530195,472529550,1676113005,1640210654,645,inbound,0f29ee96114823ff226a01da3c5fdb0bba83179bc275a7f92e1f05963c6d49ef
35,36Uv4FB9XKxAoRzsXCT76D5rEXtpVcywLj,274,115528684,113873905,1681051498,1675931382,1654779,inbound,0f29ee96114823ff226a01da3c5fdb0bba83179bc275a7f92e1f05963c6d49ef
36,3JYYEJGMgDL1gRy1jYeHooeQpcxhJCJ6pk,308,804936,804936,1672519816,1671812105,0,inbound,0f29ee96114823ff226a01da3c5fdb0bba83179bc275a7f92e1f05963c6d49ef
37,1M1C6A2SvqNzMC1eGQ8o6ojGoi1NkFEJYa,426,981687269,981687269,1680833004,1676591468,0,inbound,0f29ee96114823ff226a01da3c5fdb0bba83179bc275a7f92e1f05963c6d49ef
38,1LwswUB9HLC2wg5HUqZB9X5md5YxhHYeGv,437,200230148,200230148,1679096323,1671759195,0,inbound,0f29ee96114823ff226a01da3c5fdb0bba83179bc275a7f92e1f05963c6d49ef
39,3AthwgMdxmupRDzZk2XTRjqWnEQLo4iQ4P,466,545052,0,1672264538,1672264538,545052,inbound,0f29ee96114823ff226a01da3c5fdb0bba83179bc275a7f92e1f05963c6d49ef
40,14DNaaPbv9RxXsHYRoMmfdi52c3G28S6TS,471,240783869,240783869,1680933839,1679536383,0,inbound,0f29ee96114823ff226a01da3c5fdb0bba83179bc275a7f92e1f05963c6d49ef
41,1K69RkjV5Woe3Pvk81Qg2YUAZidwB7WJV1,702,2494878,2494878,1672084751,1672082849,0,inbound,0f29ee96114823ff226a01da3c5fdb0bba83179bc275a7f92e1f05963c6d49ef
42,bc1q9kmrtn0egnnpf0xxtqch9c3cq6fetj7muavnsc,862,131759338,131759338,1672102763,1655313041,0,inbound,0f29ee96114823ff226a01da3c5fdb0bba83179bc275a7f92e1f05963c6d49ef
43,361QWQ3KLdNuBfmVix9HtJsSqww3TNhcW3,866,1455259,1455259,1671944501,1671903850,0,inbound,0f29ee96114823ff226a01da3c5fdb0bba83179bc275a7f92e1f05963c6d49ef
44,339gkPWHDjzgT2cwcXPCpomnV8gvJtqb6Y,1168,132115,132115,1672171381,1671752684,0,inbound,0f29ee96114823ff226a01da3c5fdb0bba83179bc275a7f92e1f05963c6d49ef
45,1J3oQpxWFXuXvuaVinbJ1vEfUcscLZMcS,1655,980000,0,1670831806,1670831806,980000,inbound,0f29ee96114823ff226a01da3c5fdb0bba83179bc275a7f92e1f05963c6d49ef
46,bc1q0sx7q9rkqc3qdv4pha4u0fgtqmx385vzltt4gn,5,135241591,133995812,1681032077,1665640534,1245779,inbound,311307dd00a85d0c2d6173d4a0d4dba77a760bd708a7446fb4699883860156d2
47,bc1qzqqth9y602qmughxzwfslsquzdqp63lerpkjk6,6,35506615,33941442,1680978476,1680446422,1565173,inbound,311307dd00a85d0c2d6173d4a0d4dba77a760bd708a7446fb4699883860156d2
48,bc1qr5sprkq3t8yy2n9cxhtc4g2vj8lkmtde4npy7q,7,6483019706,6477538307,1681079996,1680229560,5481399,outbound,311307dd00a85d0c2d6173d4a0d4dba77a760bd708a7446fb4699883860156d2
49,bc1qesjkw9r8mq0n3pk7p7amsfz9mdjpg2kn9yl2v9,8,4597670157,4531287656,1681070174,1676834068,66382501,inbound,311307dd00a85d0c2d6173d4a0d4dba77a760bd708a7446fb4699883860156d2
50,bc1qyxkjhpaa65h6yzrt59k3etp796xltz6ghq2g8t,154,2816851,0,1673327631,1673327631,2816851,inbound,311307dd00a85d0c2d6173d4a0d4dba77a760bd708a7446fb4699883860156d2
51,bc1quq29mutxkgxmjfdr7ayj3zd9ad0ld5mrhh89l2,155,443971955895071,443770356606890,1681096967,1681071882,201599288181,outbound,311307dd00a85d0c2d6173d4a0d4dba77a760bd708a7446fb4699883860156d2
52,bc1qdtn29dx5pcgshxhaustjwj00kk06m3tpywjj6r,156,613242,613242,1673244039,1673239716,0,inbound,311307dd00a85d0c2d6173d4a0d4dba77a760bd708a7446fb4699883860156d2
53,bc1qw8wrek2m7nlqldll66ajnwr9mh64syvkt67zlu,157,237170856808226,236984122336847,1681097223,1681082544,186734471379,outbound,311307dd00a85d0c2d6173d4a0d4dba77a760bd708a7446fb4699883860156d2
54,bc1q4eav5zjzta6t8kjhgsspmfasnyp3ua9hgjpv02,226,1712541,0,1672763949,1672763949,1712541,inbound,311307dd00a85d0c2d6173d4a0d4dba77a760bd708a7446fb4699883860156d2
55,3KHFZJteddp8iGb3Dzri4wEHjDazFqo82y,227,165900,165900,1672769029,1672763949,0,inbound,311307dd00a85d0c2d6173d4a0d4dba77a760bd708a7446fb4699883860156d2
56,3DjMMHZXaP72nyGpVeoxrpFjeapwmdwA2o,228,4933011,4933011,1672777169,1662920710,0,inbound,311307dd00a85d0c2d6173d4a0d4dba77a760bd708a7446fb4699883860156d2
57,375Tj2AucqXnSSH2hxtDWDk3kXtptE4nis,229,6912708,6912708,1678328786,1633800611,0,inbound,311307dd00a85d0c2d6173d4a0d4dba77a760bd708a7446fb4699883860156d2
58,bc1qu88skz8ueurn8plpcw39cutjj22evz8wc8dqej,249,6063768,5171609,1675172577,1672699546,892159,inbound,311307dd00a85d0c2d6173d4a0d4dba77a760bd708a7446fb4699883860156d2
59,bc1qzu8c7qnlmw8lrhhntfxp73hzwg2c87mk562n9x,250,327673,327673,1672765637,1672764254,0,inbound,311307dd00a85d0c2d6173d4a0d4dba77a760bd708a7446fb4699883860156d2
60,39r1TYjoN8Dete374CcogtM9LuPThZpWQt,251,1803346,0,1672763951,1672763951,1803346,inbound,311307dd00a85d0c2d6173d4a0d4dba77a760bd708a7446fb4699883860156d2
61,3Qsh33ro7BMvB6hvuA7GZBsQgqgVYeXcYq,252,112000,112000,1675684459,1649506569,0,inbound,311307dd00a85d0c2d6173d4a0d4dba77a760bd708a7446fb4699883860156d2
62,1AvH6pZzEdxDEE4usTnyj7zG4f5o9DxoyT,275,225088,225088,1672677615,1672508827,0,inbound,311307dd00a85d0c2d6173d4a0d4dba77a760bd708a7446fb4699883860156d2
63,bc1q9qhltplmjhkea64paywg86ajqnmfy5jl2cl0xu,276,14810289,14807501,1676632845,1662808720,2788,inbound,311307dd00a85d0c2d6173d4a0d4dba77a760bd708a7446fb4699883860156d2
64,38KSp6udytb6eumsEMvpwarC133eZ6ZaiS,277,1448286,1448286,1672726148,1672508827,0,inbound,311307dd00a85d0c2d6173d4a0d4dba77a760bd708a7446fb4699883860156d2
65,bc1qq92gfec3cddqf2p4lted0z2793caswz203tgxe,278,25690504,25690504,1680666773,1674074960,0,outbound,311307dd00a85d0c2d6173d4a0d4dba77a760bd708a7446fb4699883860156d2
66,38Cj2SiL2Fusp9DaFPjxAZXcXXMaWTcRNL,309,819977,819977,1672512617,1672508827,0,inbound,311307dd00a85d0c2d6173d4a0d4dba77a760bd708a7446fb4699883860156d2
67,15qyCfBGZcPi2dS5TyTWme4Q4j8XxKDLRa,310,386182,386182,1672635617,1672508827,0,inbound,311307dd00a85d0c2d6173d4a0d4dba77a760bd708a7446fb4699883860156d2
68,35f1gU2Bay6zMBCGLA7zycZVQU4TG7LDeh,311,187130388,187130388,1676993456,1674776106,0,inbound,311307dd00a85d0c2d6173d4a0d4dba77a760bd708a7446fb4699883860156d2
69,1Q4MRhncAhnL31BnyC8n14oqzaC6o3EHZN,312,1147465,1147465,1672636812,1672508827,0,inbound,311307dd00a85d0c2d6173d4a0d4dba77a760bd708a7446fb4699883860156d2
70,1DyKZaitkbZtE8ZfDe1NrbnLXFfRu8YoB4,427,945972,945972,1672272617,1672264538,0,inbound,311307dd00a85d0c2d6173d4a0d4dba77a760bd708a7446fb4699883860156d2
71,13Ukx9rtruMcJrRA63Q7baR4eqz7emsfCf,428,587489,587489,1672766010,1672264538,0,inbound,311307dd00a85d0c2d6173d4a0d4dba77a760bd708a7446fb4699883860156d2
72,bc1qn7a2007fagjuh62yxuajqw9f6yf4ns6nm0laj2,429,28149461,28148782,1680152735,1656528887,679,inbound,311307dd00a85d0c2d6173d4a0d4dba77a760bd708a7446fb4699883860156d2
73,3MKrUG1Si2VeKrLM9sz6ZpPojVvDqdjpZA,430,20887528,20887528,1678795207,1639419882,0,inbound,311307dd00a85d0c2d6173d4a0d4dba77a760bd708a7446fb4699883860156d2
74,3QumXpeuGZDvZSRkzg9JEcca4YBdHc9Xv7,438,164060,164060,1672772267,1672264538,0,inbound,311307dd00a85d0c2d6173d4a0d4dba77a760bd708a7446fb4699883860156d2
75,34wVLncy5dr114eznUqvJ9dt4kCU6cX2Rf,439,282577,282577,1672272143,1672264538,0,inbound,311307dd00a85d0c2d6173d4a0d4dba77a760bd708a7446fb4699883860156d2
76,3HBBADQnTUfoef65PMpqhCryoca7GNJEve,440,54250670,54250670,1677773467,1677180817,0,inbound,311307dd00a85d0c2d6173d4a0d4dba77a760bd708a7446fb4699883860156d2
77,3AhgsMABvG7ZhjVLcqnyx1KsdqDmSzsgL5,441,333136,333136,1672524025,1672264538,0,inbound,311307dd00a85d0c2d6173d4a0d4dba77a760bd708a7446fb4699883860156d2
78,1Hdy1zEqKaJQCCyWY9DuAg7v5cKQ6EUAtR,467,397750,0,1672264538,1672264538,397750,inbound,311307dd00a85d0c2d6173d4a0d4dba77a760bd708a7446fb4699883860156d2
79,1FuNqSjjpZovuiRB8Vv8Rw6Ck6HDhYDWNP,468,98949,98949,1672264572,1672264538,0,inbound,311307dd00a85d0c2d6173d4a0d4dba77a760bd708a7446fb4699883860156d2
80,35uSufUiRXU99wrVWTotHtK9hznZsiDzZ7,472,104915,104915,1672788274,1672264538,0,inbound,311307dd00a85d0c2d6173d4a0d4dba77a760bd708a7446fb4699883860156d2
81,bc1qa70heaqstclw3akrq69hj9ufyj3jltjusnupp7,473,211711,0,1672264538,1672264538,211711,inbound,311307dd00a85d0c2d6173d4a0d4dba77a760bd708a7446fb4699883860156d2
82,bc1qkrr5nyap9h49sk7rdpp5zarxy4qyx0tdnthfwam24r95k79xlxcs3jr59r,474,1815031,1815031,1672524025,1672264538,0,inbound,311307dd00a85d0c2d6173d4a0d4dba77a760bd708a7446fb4699883860156d2
83,19HtDbhhp23EH6xc7YizJyp8Afvm5eziGW,475,30573166,30573166,1679285468,1669808869,0,inbound,311307dd00a85d0c2d6173d4a0d4dba77a760bd708a7446fb4699883860156d2
84,31s2SDGBzGpoNz2X5gfWSmdxNn9SheWpB9,703,277066,277066,1672117294,1672082849,0,inbound,311307dd00a85d0c2d6173d4a0d4dba77a760bd708a7446fb4699883860156d2
85,bc1q9aw778px7pctkz398lwu4tl3vx2t25ctyq2k7q,704,16785713,16783498,1676138552,1669751179,2215,inbound,311307dd00a85d0c2d6173d4a0d4dba77a760bd708a7446fb4699883860156d2
86,bc1q2wcy62frv3jzdnlh433v5s0pugehc6mg4zp85d,705,2374817,2374817,1672104952,1672082849,0,inbound,311307dd00a85d0c2d6173d4a0d4dba77a760bd708a7446fb4699883860156d2
87,324g4BvTmuSkBs2vpc7fcJSfSQJ8zJViSU,706,230637,230637,1672165588,1672082849,0,inbound,311307dd00a85d0c2d6173d4a0d4dba77a760bd708a7446fb4699883860156d2
88,34TMCimEEaRxqtwuD9RtYP86xj7kcodtJi,863,135435,135435,1672117297,1672082849,0,inbound,311307dd00a85d0c2d6173d4a0d4dba77a760bd708a7446fb4699883860156d2
89,3ANMWVAvAzun15yb7hbktbjeiPQLQihqNF,867,441351,441351,1671904921,1671899529,0,inbound,311307dd00a85d0c2d6173d4a0d4dba77a760bd708a7446fb4699883860156d2
90,3LkJZgtH3aMyVyxYsdkTiQUfT4T3SqCJ5Y,868,118814,118814,1671926574,1671903850,0,inbound,311307dd00a85d0c2d6173d4a0d4dba77a760bd708a7446fb4699883860156d2
91,131pSuz7Q3eYccfynAcTeMhkGguKNLqMK2,869,743004,743004,1671982211,1671903850,0,inbound,311307dd00a85d0c2d6173d4a0d4dba77a760bd708a7446fb4699883860156d2
92,1GdmW49W9VgXTRFLwGdPr8XRHgQo8GSRs4,870,135395,135395,1672332320,1671903850,0,inbound,311307dd00a85d0c2d6173d4a0d4dba77a760bd708a7446fb4699883860156d2
93,bc1qlazkz22najzkhfqd7er30su7sz0wkt6ecfvnp0,1169,872876,872876,1671788662,1671752684,0,inbound,311307dd00a85d0c2d6173d4a0d4dba77a760bd708a7446fb4699883860156d2
94,3NJYDdwFhgBBJQE3iVJM3x5jwJurx1DJHV,1170,73210,73210,1672281026,1671752684,0,inbound,311307dd00a85d0c2d6173d4a0d4dba77a760bd708a7446fb4699883860156d2
95,32iyrA5LxY4BGWLLy6D4eXHgRjqDfkXX7w,1171,556811,556811,1671782856,1671752684,0,inbound,311307dd00a85d0c2d6173d4a0d4dba77a760bd708a7446fb4699883860156d2
96,1CAkUbLAHVGz5i4kY7S6WUiUJ3e77KeEM1,1172,161607,161607,1671866295,1671752684,0,inbound,311307dd00a85d0c2d6173d4a0d4dba77a760bd708a7446fb4699883860156d2
97,bc1qtlg8tqe0alqkldf0d2x44n7v5p0l052wqnzxk2,1656,1791102379,1791102379,1673526306,1668754848,0,inbound,311307dd00a85d0c2d6173d4a0d4dba77a760bd708a7446fb4699883860156d2
98,141WHEmuyYTQJxGLBYnYjNqosVgWZnZ9Yf,1657,65393599806,55468471909,1681056290,1671463808,9925127897,inbound,311307dd00a85d0c2d6173d4a0d4dba77a760bd708a7446fb4699883860156d2
99,bc1qglkqmqhejysqmlw76p48wechnnh3zmccydfqjd,1658,275235,0,1670831806,1670831806,275235,inbound,311307dd00a85d0c2d6173d4a0d4dba77a760bd708a7446fb4699883860156d2
100,12DRj7YA5Zieg1pxd1LuNrq4KTbarsiEfh,1659,16460222,16460222,1674880085,1650979812,0,inbound,311307dd00a85d0c2d6173d4a0d4dba77a760bd708a7446fb4699883860156d2
101,bc1q22hp7n28whk5h94z93vm05hfx2zxs8ca9gglk7,9,4887081592075,4886907457229,1681093525,1680967354,174134846,outbound,c43f5817513f2acc547713ec34a97417a2eb2bfd34bc001d1847ac7789f99367
102,bc1q3xplqu2g5k2xy7m7926gvf27awlvn08urj6g6z,158,2705078,2498607,1673068479,1672900473,206471,inbound,c43f5817513f2acc547713ec34a97417a2eb2bfd34bc001d1847ac7789f99367
103,bc1qm6xzs0dklk6mdt0agja62z4t5ch2ur8z8jrfzk,230,10000,10000,1672770383,1672763949,0,inbound,c43f5817513f2acc547713ec34a97417a2eb2bfd34bc001d1847ac7789f99367
104,bc1q4sszy3e5f9dpeg66w27d83nqhsd8ejqsy559xv,253,1682194604,1682194604,1679909997,1653652838,0,inbound,c43f5817513f2acc547713ec34a97417a2eb2bfd34bc001d1847ac7789f99367
105,bc1qrxd8da5vs7952kkc3wcg0vnx5we2heyhfgymrh,279,64909,0,1672508827,1672508827,64909,inbound,c43f5817513f2acc547713ec34a97417a2eb2bfd34bc001d1847ac7789f99367
106,3BfhjWcNb4L6cEjXNbrQohtS5rQ6A8uB7D,313,1146430,1146430,1672511727,1672508827,0,inbound,c43f5817513f2acc547713ec34a97417a2eb2bfd34bc001d1847ac7789f99367
107,19FTaFHHz89S5SPwAfbyYZTgGsRfn4MQ9K,431,93747837,93747837,1677284185,1659358449,0,inbound,c43f5817513f2acc547713ec34a97417a2eb2bfd34bc001d1847ac7789f99367
108,19PeHo1nbZggqzcz5S7FNSPZU6eb8fdo2G,442,104928942,104928942,1679382375,1676242243,0,outbound,c43f5817513f2acc547713ec34a97417a2eb2bfd34bc001d1847ac7789f99367
109,33wQqXPWQUve63ZaWFzJEMuSTxN79okdBt,476,133253,133253,1672292796,1672264538,0,inbound,c43f5817513f2acc547713ec34a97417a2eb2bfd34bc001d1847ac7789f99367
110,3CrsRWu9vEQVaba42ddL8FLAcmsCiLZM9h,707,1190916,1190916,1677247851,1662697517,0,inbound,c43f5817513f2acc547713ec34a97417a2eb2bfd34bc001d1847ac7789f99367
111,bc1qwetzvcch5k608dzr73p7jpx5s56c50nghnk525s00dszhf2rlwxsne9hmx,871,344182087,344182087,1676283064,1673561569,0,outbound,c43f5817513f2acc547713ec34a97417a2eb2bfd34bc001d1847ac7789f99367
112,37w1jyoacpAEpqNHhVsPKmPSpNip2BvJ5d,1173,10324,0,1671752684,1671752684,10324,inbound,c43f5817513f2acc547713ec34a97417a2eb2bfd34bc001d1847ac7789f99367
113,bc1qy59slf4la4zxlmc77shxqglzv0eu9yxty3zqq3,1660,4171055305,4171055305,1673690235,1669965700,0,outbound,c43f5817513f2acc547713ec34a97417a2eb2bfd34bc001d1847ac7789f99367
114,bc1qtcu6tk7vpdh3v7dqptu36wregnj0hvcna56djj,10,10228144,10228144,1680466670,1669752164,0,inbound,9ee3976a19f8b94748ea998bafeee3dfc3260153bdbdc3dc1466f8894c3f2cf4
115,33phZ1GJ7arBCZydfN6BxoQfpvAYQQ2epG,159,271990,271990,1673071441,1673067394,0,inbound,9ee3976a19f8b94748ea998bafeee3dfc3260153bdbdc3dc1466f8894c3f2cf4
116,bc1qzqj7ugxcvd4kvuvphzy7r2zym9mjrpn4z50r3l,231,2866765,2866765,1673139830,1672763951,0,inbound,9ee3976a19f8b94748ea998bafeee3dfc3260153bdbdc3dc1466f8894c3f2cf4
117,35qAkwwpURWnwSdFpDfLEH84iC7uxBLVQS,254,96220513,96220513,1679478658,1642851199,0,inbound,9ee3976a19f8b94748ea998bafeee3dfc3260153bdbdc3dc1466f8894c3f2cf4
118,bc1q2hzk7zm2jcdgm2qe8k47w6qx4g8jh5wjqfgxnf,280,78437,78437,1672511972,1672508827,0,inbound,9ee3976a19f8b94748ea998bafeee3dfc3260153bdbdc3dc1466f8894c3f2cf4
119,bc1qmuql9fnv4j4nzrn4r9kcw07pkr6d0rh762y8aj,314,753561,753561,1672509423,1672508827,0,inbound,9ee3976a19f8b94748ea998bafeee3dfc3260153bdbdc3dc1466f8894c3f2cf4
120,bc1q2e6cxx6hfpw8nc9ecvz3e29ly3tc6n043kwftm,432,1713533443,1321134140,1679329246,1673625334,392399303,inbound,9ee3976a19f8b94748ea998bafeee3dfc3260153bdbdc3dc1466f8894c3f2cf4
121,bc1q272yhqhtynrlq6z0f4mxms2razgxpyghh4ndhz,443,227017753,227017753,1672278674,1672264538,0,inbound,9ee3976a19f8b94748ea998bafeee3dfc3260153bdbdc3dc1466f8894c3f2cf4
122,3FdQ7vP9gLwYYgWyCDNZMH5cqAmJfSQXwW,477,9071,9071,1672788274,1672264538,0,inbound,9ee3976a19f8b94748ea998bafeee3dfc3260153bdbdc3dc1466f8894c3f2cf4
123,377mUCtSU821b7Wyd7KJmUTyxwZUvE9eHE,708,140449068,140449068,1678622287,1662571647,0,inbound,9ee3976a19f8b94748ea998bafeee3dfc3260153bdbdc3dc1466f8894c3f2cf4
124,38uUR8kH7mo8YStxBho5v7ZqtAinBUmdfp,872,279563,279563,1671926581,1671903850,0,inbound,9ee3976a19f8b94748ea998bafeee3dfc3260153bdbdc3dc1466f8894c3f2cf4
125,37YPUQMpq7VP6HkwZQUhpxLBBfJ4eY1JsQ,1174,48743,48743,1671775429,1671752684,0,inbound,9ee3976a19f8b94748ea998bafeee3dfc3260153bdbdc3dc1466f8894c3f2cf4
126,bc1qp72dfn6cjdyrjw5e3zy4jj7lz0aeykr6kqkqyw,1661,15833925740,14792291590,1680613606,1674588410,1041634150,outbound,9ee3976a19f8b94748ea998bafeee3dfc3260153bdbdc3dc1466f8894c3f2cf4
127,bc1qdjahfcgv3nr5fffgr06030664z7p7gh4adej57,11,2758238,2758238,1680435737,1621692181,0,inbound,cdbb3dea8ac0192d4edbb5a8dfc5eca5b83c7256879f225915a5c0bf3bdd1384
128,3CWxP5isvbWT2aL4z7LhEphayJFFixquM3,12,1972447,0,1680801789,1677681970,1972447,inbound,cdbb3dea8ac0192d4edbb5a8dfc5eca5b83c7256879f225915a5c0bf3bdd1384
129,bc1qts8tpcf3z0rvww64egvv53cthgz8g0nn5at6lf93ygv94acj89cqr6xs0v,160,26742,0,1672930694,1672930694,26742,inbound,cdbb3dea8ac0192d4edbb5a8dfc5eca5b83c7256879f225915a5c0bf3bdd1384
130,bc1qhre8y6l7azk0x7lylt5q4t25qcuw69r8teauj2he78dhefcgnjvq9rqmvr,161,29076731,29076731,1672932308,1672930694,0,inbound,cdbb3dea8ac0192d4edbb5a8dfc5eca5b83c7256879f225915a5c0bf3bdd1384
131,1KwwskTBfGnjJyeNRjEzEg998fSBFV9YQZ,232,225412615,225412615,1681062612,1661523353,0,inbound,cdbb3dea8ac0192d4edbb5a8dfc5eca5b83c7256879f225915a5c0bf3bdd1384
132,bc1qdxjjxvxc5u43pfv8g7sknqmqcjj8q5yzlww05y,233,23798607,0,1677710470,1623298404,23798607,inbound,cdbb3dea8ac0192d4edbb5a8dfc5eca5b83c7256879f225915a5c0bf3bdd1384
133,3CUGZqR2mcK8zjrSnfVG12vwrhH12U7sYB,255,66386967,66138306,1680781886,1670709547,248661,inbound,cdbb3dea8ac0192d4edbb5a8dfc5eca5b83c7256879f225915a5c0bf3bdd1384
134,16qLHGQWGTecF1KQLG8R9yRAwb2U9JwKEx,256,1209572,0,1672765833,1672763826,1209572,inbound,cdbb3dea8ac0192d4edbb5a8dfc5eca5b83c7256879f225915a5c0bf3bdd1384
135,1CopnBn1eXCYMBqE8xbUQBYYawrjrNYnbZ,281,603456,603456,1672613355,1672508827,0,inbound,cdbb3dea8ac0192d4edbb5a8dfc5eca5b83c7256879f225915a5c0bf3bdd1384
136,39BFVfLjaGoRmj4JXWLEgcj4cd5937zYBP,282,64202,64202,1672531461,1672508827,0,inbound,cdbb3dea8ac0192d4edbb5a8dfc5eca5b83c7256879f225915a5c0bf3bdd1384
137,bc1qguerkhzhkvplx8f44n8l2pcmpnyjyegt58kg06,315,2096783,0,1672508827,1672508827,2096783,inbound,cdbb3dea8ac0192d4edbb5a8dfc5eca5b83c7256879f225915a5c0bf3bdd1384
138,397XMAKEGARMrRHbfXLDKzETTnWn2pDeVa,316,5915063,5915063,1673275294,1672508827,0,inbound,cdbb3dea8ac0192d4edbb5a8dfc5eca5b83c7256879f225915a5c0bf3bdd1384
139,35uoMs1gFENich65bSkF135B9RKVNLBP5o,433,87148,87148,1672290098,1672264538,0,inbound,cdbb3dea8ac0192d4edbb5a8dfc5eca5b83c7256879f225915a5c0bf3bdd1384
140,3H7BM4Ynq1XVkwDmsyJwWEzSH9QkT3nhDN,434,8248532145,8248532145,1681094404,1680726406,0,inbound,cdbb3dea8ac0192d4edbb5a8dfc5eca5b83c7256879f225915a5c0bf3bdd1384
141,38NFHiUG2zTLKb1gTihSE5nPBnyveLyVC9,444,104921,104921,1672421731,1672264538,0,inbound,cdbb3dea8ac0192d4edbb5a8dfc5eca5b83c7256879f225915a5c0bf3bdd1384
142,3N1KJffqq2hQBeM4ccMsowtyzLLd199u6y,445,469300688,469300688,1678891104,1674082427,0,outbound,cdbb3dea8ac0192d4edbb5a8dfc5eca5b83c7256879f225915a5c0bf3bdd1384
143,3Dg5L3vW85qSDDFdRWwe9EskFNYdb3BVF3,478,868602,868602,1672385565,1672264538,0,inbound,cdbb3dea8ac0192d4edbb5a8dfc5eca5b83c7256879f225915a5c0bf3bdd1384
144,37ciirB88BEYVDaDya748GGejCQaebj3iz,479,294379,294379,1672290097,1672264538,0,inbound,cdbb3dea8ac0192d4edbb5a8dfc5eca5b83c7256879f225915a5c0bf3bdd1384
145,3KnBbDyMDEFaUCxebAVkWCgDJJowKMPfrH,709,16914597,16914597,1680199852,1667766015,0,outbound,cdbb3dea8ac0192d4edbb5a8dfc5eca5b83c7256879f225915a5c0bf3bdd1384
146,15iUQkA75UMrXdMmwARegsCasBt5aTaZqH,710,1137077069,1137077069,1681070566,1674745138,0,outbound,cdbb3dea8ac0192d4edbb5a8dfc5eca5b83c7256879f225915a5c0bf3bdd1384
147,1FFtukAQmsGbizPybWm3kpYvYgkFWucqNY,873,135570,135570,1671906405,1671903850,0,inbound,cdbb3dea8ac0192d4edbb5a8dfc5eca5b83c7256879f225915a5c0bf3bdd1384
148,3Lh4LztZriTmiC63xrg1NdPn7tfk9sJVFV,874,71291,71291,1671906512,1671903850,0,inbound,cdbb3dea8ac0192d4edbb5a8dfc5eca5b83c7256879f225915a5c0bf3bdd1384
149,1PsLQWSTXaYVvCK5Qb6bZp3qDs7knZYFKc,1175,308417251,308417251,1681142605,1678358339,0,outbound,cdbb3dea8ac0192d4edbb5a8dfc5eca5b83c7256879f225915a5c0bf3bdd1384
150,3NLaPsfjDRCLXvJL9tTYo2GLE36f3WNaMp,1176,60053,60053,1672171381,1671752684,0,inbound,cdbb3dea8ac0192d4edbb5a8dfc5eca5b83c7256879f225915a5c0bf3bdd1384
151,3QWddDFHiSP968q3XxfutdhvL65tV1RhU7,1662,1354112000,1354112000,1679313897,1646629094,0,inbound,cdbb3dea8ac0192d4edbb5a8dfc5eca5b83c7256879f225915a5c0bf3bdd1384
152,1PPP7QjGqJYtScjVDjvthzxkTPKXMinfbT,1663,370710271,370710271,1674041067,1670489209,0,inbound,cdbb3dea8ac0192d4edbb5a8dfc5eca5b83c7256879f225915a5c0bf3bdd1384
153,bc1qz6lks9udfn78vx3cju9uyc6kqk6739hndak4ct,2004,11607291250,11604653370,1680700472,1670559791,2637880,inbound,3d2d12f2e71597036cc0a03a10df55c2f7fdd8d4708930658f73bc3560664c4e
154,1Eh7H7UZCdvgAsUeJbyJafxAHAaA7HBsHK,13,13558429,13558429,1680805165,1679404048,0,inbound,dce8271ff6ca6bacf4f9fd9ff463f587a0bb9d4c805af60777bec31dde32c916
155,bc1qplj45td70m6zpudstfcw6t5pz46n4yfxv2sfe3,14,29143,29143,1679607547,1679575088,0,inbound,dce8271ff6ca6bacf4f9fd9ff463f587a0bb9d4c805af60777bec31dde32c916
156,1MNcu7tpsZnasr9y1a6oAGQ1sKXuMP3rSk,15,10892797,10892797,1680624829,1675801990,0,inbound,dce8271ff6ca6bacf4f9fd9ff463f587a0bb9d4c805af60777bec31dde32c916
157,bc1qevwy762rum3z52w24pysefwqvnctjme87ycxrz,16,46703626,45336372,1680855468,1665262089,1367254,inbound,dce8271ff6ca6bacf4f9fd9ff463f587a0bb9d4c805af60777bec31dde32c916
158,1Q96DpAGrXHtCv5xvqYvvkGQhcjfKXd248,17,1405073,1405073,1679577917,1679575088,0,inbound,dce8271ff6ca6bacf4f9fd9ff463f587a0bb9d4c805af60777bec31dde32c916
159,38HSiYWvq6qzo9mD62sZ5gFScnvZvbx196,18,340828,340828,1679819112,1679575088,0,inbound,dce8271ff6ca6bacf4f9fd9ff463f587a0bb9d4c805af60777bec31dde32c916
160,bc1qkxurjz5gghuu859jpgngfxjd8whm4r9jjhva8t,19,19670766,0,1679575088,1679575088,19670766,inbound,dce8271ff6ca6bacf4f9fd9ff463f587a0bb9d4c805af60777bec31dde32c916
161,bc1q73swxqx6m5cjq96r0vqwjmmc0vfyeqlhe2at33,20,643421270,643421270,1679575688,1679575088,0,inbound,dce8271ff6ca6bacf4f9fd9ff463f587a0bb9d4c805af60777bec31dde32c916
162,bc1qwhnp87r48rn5l79afudm04njveag2gl8pvmz6t,21,3925994,3925994,1679575710,1679575087,0,inbound,dce8271ff6ca6bacf4f9fd9ff463f587a0bb9d4c805af60777bec31dde32c916
163,bc1q5syuu707g33j63ht8zr92cfuus07gx8ttr687f,22,1105789,1068378,1679575088,1665436458,37411,inbound,dce8271ff6ca6bacf4f9fd9ff463f587a0bb9d4c805af60777bec31dde32c916
164,bc1q0sx7x88a75k545zgrxh7vn2nt5nfhgaaand6xe,23,45211,45211,1679575141,1679575088,0,inbound,dce8271ff6ca6bacf4f9fd9ff463f587a0bb9d4c805af60777bec31dde32c916
165,12yg1YVH7gcoKtsfFHnRntW4cBjVjVXqoS,24,5343825,5082577,1680430598,1656886929,261248,inbound,dce8271ff6ca6bacf4f9fd9ff463f587a0bb9d4c805af60777bec31dde32c916
166,3PgpgqnndVLMB6vwS2ECcoutS4c2f9YXMe,25,46793,0,1679575088,1679575088,46793,inbound,dce8271ff6ca6bacf4f9fd9ff463f587a0bb9d4c805af60777bec31dde32c916
167,17Zuypg27F7ox8UAVen4cQrAJina3xkGkZ,26,397601,397601,1679607212,1679575088,0,inbound,dce8271ff6ca6bacf4f9fd9ff463f587a0bb9d4c805af60777bec31dde32c916
168,bc1q2afjfqffm9f2qzhwmalrseznt8kxd85yapcqm6,27,300000000,0,1679575087,1679575087,300000000,inbound,dce8271ff6ca6bacf4f9fd9ff463f587a0bb9d4c805af60777bec31dde32c916
169,19AsQtErnMhA2jYgNWBtqsBaRmEeq8C4Vh,28,43378,0,1679575087,1679575087,43378,inbound,dce8271ff6ca6bacf4f9fd9ff463f587a0bb9d4c805af60777bec31dde32c916
170,34Wwg22JTJg4wwha6SzUtsmq2h2PANvp7U,29,122896,122896,1680286972,1679575087,0,inbound,dce8271ff6ca6bacf4f9fd9ff463f587a0bb9d4c805af60777bec31dde32c916
171,bc1qkxuvpp9k9ytxjgy0rderd7tml26yrxhuhxxxf6,30,200930,200930,1679575464,1679353268,0,inbound,dce8271ff6ca6bacf4f9fd9ff463f587a0bb9d4c805af60777bec31dde32c916
172,35XPnKnicmB3ex439jeBPY1m8ddrK7x3cb,31,57013161,57000000,1679575088,1636115059,13161,inbound,dce8271ff6ca6bacf4f9fd9ff463f587a0bb9d4c805af60777bec31dde32c916
173,34PieX5mhUnjoFkb8gPXGkdVLtHiwwP8kc,32,290690791,274266622,1681048808,1679297352,16424169,outbound,dce8271ff6ca6bacf4f9fd9ff463f587a0bb9d4c805af60777bec31dde32c916
174,3JxATt8piXauosAnDU5fyJ6awRV9wKEybi,33,439600,439600,1679597549,1679575087,0,inbound,dce8271ff6ca6bacf4f9fd9ff463f587a0bb9d4c805af60777bec31dde32c916
175,3GJHxDBKmRaSNvMot9Cdh284A1Se9wc1ad,34,104842,104842,1680286969,1679575087,0,inbound,dce8271ff6ca6bacf4f9fd9ff463f587a0bb9d4c805af60777bec31dde32c916
176,3QT8gsqmVv9ry8kVboPHgaZpmKfhbKnVFG,35,684885,684885,1679577156,1679575088,0,inbound,dce8271ff6ca6bacf4f9fd9ff463f587a0bb9d4c805af60777bec31dde32c916
177,1D9kTdXQ94RgLvDkogZFZNJFwL69jv11es,36,95111,95111,1679577734,1679575087,0,inbound,dce8271ff6ca6bacf4f9fd9ff463f587a0bb9d4c805af60777bec31dde32c916
178,31xfdkf9mBSfy4vsvR5Yr7A3QQhgVFL2BY,37,461424132,461424132,1680909035,1668525131,0,inbound,dce8271ff6ca6bacf4f9fd9ff463f587a0bb9d4c805af60777bec31dde32c916
179,351cRdQKUTC2ahCy8NeqVP5kP4B9RPgzha,38,108211,108211,1679829907,1679575088,0,inbound,dce8271ff6ca6bacf4f9fd9ff463f587a0bb9d4c805af60777bec31dde32c916
180,bc1q6nv9jq3l4qtnte0xjw40lrhhdk7ynq70n3spks,39,2771690,2771690,1679666327,1679575087,0,inbound,dce8271ff6ca6bacf4f9fd9ff463f587a0bb9d4c805af60777bec31dde32c916
181,bc1qcg50l3w8trq8vmkzzv4xxvscryl32jak4lrexs,40,168603,168603,1680030806,1679575088,0,inbound,dce8271ff6ca6bacf4f9fd9ff463f587a0bb9d4c805af60777bec31dde32c916
182,bc1qmyn5qkjw5kcxjxe22sw48y7xuemd6cuuh5euex,41,238569,238569,1679913205,1679575088,0,inbound,dce8271ff6ca6bacf4f9fd9ff463f587a0bb9d4c805af60777bec31dde32c916
183,bc1qj862dh7pydqdas6r8tx94claep582v40dl53p5,42,310954,310954,1679583434,1679462769,0,inbound,dce8271ff6ca6bacf4f9fd9ff463f587a0bb9d4c805af60777bec31dde32c916
184,3JmUwZC74DNuE4RL9hkMVXn7FKQGJ4aADL,43,18079,18079,1679595070,1679575088,0,inbound,dce8271ff6ca6bacf4f9fd9ff463f587a0bb9d4c805af60777bec31dde32c916
185,3NXzj8p1bfJPES3sykCDAd8R33NVECMQdX,44,14541902,14541902,1679575349,1679575089,0,inbound,dce8271ff6ca6bacf4f9fd9ff463f587a0bb9d4c805af60777bec31dde32c916
186,3CQxkyzeaUzbhmCVzyTqtF2Ygjo1aiVHe8,45,3963041003,3963041003,1681094436,1680270664,0,inbound,dce8271ff6ca6bacf4f9fd9ff463f587a0bb9d4c805af60777bec31dde32c916
187,16RSwmSykB4mH7QjqAKiCMZuBUbReJNTWg,46,9409109,9409109,1675721054,1675176427,0,inbound,dce8271ff6ca6bacf4f9fd9ff463f587a0bb9d4c805af60777bec31dde32c916
188,3Lu5vr3gWpo3KpPaQVUnWsiRxakG7iiPEu,162,60000,60000,1673261780,1672916985,0,inbound,dce8271ff6ca6bacf4f9fd9ff463f587a0bb9d4c805af60777bec31dde32c916
189,17p4X24sBuHaxZziPrDKbD1CFwanqboLHs,163,574967,0,1673960266,1672916985,574967,inbound,dce8271ff6ca6bacf4f9fd9ff463f587a0bb9d4c805af60777bec31dde32c916
190,bc1q3h2rcllssvhuxply2ukr69ksn3x3zet40yusem,164,1071556731,1058228327,1680970557,1678735049,13328404,inbound,dce8271ff6ca6bacf4f9fd9ff463f587a0bb9d4c805af60777bec31dde32c916
191,3NQk9N8cbUMoJWTXnVXgvybuDEfUJ1oEYw,165,57501409,57501409,1678194019,1664676635,0,inbound,dce8271ff6ca6bacf4f9fd9ff463f587a0bb9d4c805af60777bec31dde32c916
192,bc1qwfgdjyy95aay2686fn74h6a4nu9eev6np7q4fn204dkj3274frlqrskvx0,166,189034965070135,188723522707085,1681097180,1681085590,311442363050,outbound,dce8271ff6ca6bacf4f9fd9ff463f587a0bb9d4c805af60777bec31dde32c916
193,bc1q4rq433zfmsk055jepmcjzqvmhl0ndhdt2vyhu8,167,496372,0,1672862594,1672862594,496372,inbound,dce8271ff6ca6bacf4f9fd9ff463f587a0bb9d4c805af60777bec31dde32c916
194,3LX5BJvNZaYWHyUxJvo22eBKNsTH1m84p4,168,179382,179382,1672894960,1672860877,0,inbound,dce8271ff6ca6bacf4f9fd9ff463f587a0bb9d4c805af60777bec31dde32c916
195,bc1qm34lsc65zpw79lxes69zkqmk6ee3ewf0j77s3h,169,3896342565336130,3891910056552976,1681097280,1681092215,4432508783154,inbound,dce8271ff6ca6bacf4f9fd9ff463f587a0bb9d4c805af60777bec31dde32c916
196,bc1qn55g7g440petfh9s64wks2x4gcg3vd8t64a9sd,170,5822322,5154760,1679491851,1671992851,667562,inbound,dce8271ff6ca6bacf4f9fd9ff463f587a0bb9d4c805af60777bec31dde32c916
197,3GNuztPFYKT4qsdTH9ncqD38LrWe6U5Gud,171,155817,0,1672860877,1672860877,155817,inbound,dce8271ff6ca6bacf4f9fd9ff463f587a0bb9d4c805af60777bec31dde32c916
198,bc1q9gzgu289v402r63kw3r7uuzgf7gmd9aw3fzhrg,172,24995468,24995468,1673893160,1670016318,0,inbound,dce8271ff6ca6bacf4f9fd9ff463f587a0bb9d4c805af60777bec31dde32c916
199,bc1q45f8kqedde2drlgu8zuuv03v2zdnhhq3av4m8u,173,600812,600812,1672915008,1672860877,0,inbound,dce8271ff6ca6bacf4f9fd9ff463f587a0bb9d4c805af60777bec31dde32c916
200,bc1qq2cwpthe038hweasvfp845sc0e57fnvmrcfm9z,174,247000,0,1672860877,1672860877,247000,inbound,dce8271ff6ca6bacf4f9fd9ff463f587a0bb9d4c805af60777bec31dde32c916
201,37YwZcp8ozbLbtBxAVHFKMt8n4j46fw6sW,175,404655,404655,1672963337,1672860877,0,inbound,dce8271ff6ca6bacf4f9fd9ff463f587a0bb9d4c805af60777bec31dde32c916
202,18qY8gzK6545vwSaqDrdrEoBVcvTdPDKYx,176,677222696,671794243,1679058425,1670687808,5428453,inbound,dce8271ff6ca6bacf4f9fd9ff463f587a0bb9d4c805af60777bec31dde32c916
203,bc1q6mght9jhjg33vxvysq4ssfxwsg9kqwmfltfxak,177,80000,80000,1672867646,1672860877,0,inbound,dce8271ff6ca6bacf4f9fd9ff463f587a0bb9d4c805af60777bec31dde32c916
204,bc1qavq6wz6mmj9tcg5v4wtgjgzgpp2n4rcvp0k2ec,178,5679000,0,1672860877,1672860877,5679000,inbound,dce8271ff6ca6bacf4f9fd9ff463f587a0bb9d4c805af60777bec31dde32c916
205,3J1qVMF4SnLrCEGW1MhNHJBTbotke9rA46,179,1902333,1694134,1679428830,1665388843,208199,inbound,dce8271ff6ca6bacf4f9fd9ff463f587a0bb9d4c805af60777bec31dde32c916
206,bc1qghlx2nme8qqs2rcqm6sp6hheu7mmnwtuy2ja46,180,1975261,1975261,1672945898,1672860877,0,inbound,dce8271ff6ca6bacf4f9fd9ff463f587a0bb9d4c805af60777bec31dde32c916
207,17seRszX6LnhgAR4LvJemvZJYcoNgEJYkt,181,490960,0,1672860877,1672860877,490960,inbound,dce8271ff6ca6bacf4f9fd9ff463f587a0bb9d4c805af60777bec31dde32c916
208,bc1qjwv6fufkyvhak4s3ykc8hmjmuss53250qfvj27,182,355470,355470,1672909702,1672860877,0,inbound,dce8271ff6ca6bacf4f9fd9ff463f587a0bb9d4c805af60777bec31dde32c916
209,3EMytApHEu3zDRRS3XjT2XMMBoZvZLNFyQ,183,131645220,121972863,1680181991,1680631051,9672357,inbound,dce8271ff6ca6bacf4f9fd9ff463f587a0bb9d4c805af60777bec31dde32c916
210,bc1q57se8fhuyjv0eghh9hl9wpaxqvvxt7lmx0pm9l,184,92385340,82282949,1680939719,1675015692,10102391,outbound,dce8271ff6ca6bacf4f9fd9ff463f587a0bb9d4c805af60777bec31dde32c916
211,bc1qpgmgx67qs7ls4hhzkt0w585p840nk7hma7ftku,185,170277453,169832307,1681076508,1678724053,445146,inbound,dce8271ff6ca6bacf4f9fd9ff463f587a0bb9d4c805af60777bec31dde32c916
212,bc1q8hzhrcq4assr8axjzkaw4g85dvjvaj577qpz2n,186,12980000,12980000,1672998109,1672860877,0,inbound,dce8271ff6ca6bacf4f9fd9ff463f587a0bb9d4c805af60777bec31dde32c916
213,bc1qentjlasldyc23kl79se7ey6zgtejeex839ce4x,187,34554259,34554259,1672862086,1672849356,0,inbound,dce8271ff6ca6bacf4f9fd9ff463f587a0bb9d4c805af60777bec31dde32c916
214,3FWq45kbRAmotDwBzW31V7WZDuLkTcfaew,188,24058000,24058000,1673223123,1672860877,0,inbound,dce8271ff6ca6bacf4f9fd9ff463f587a0bb9d4c805af60777bec31dde32c916
215,bc1qa3kjynhh6yfzllfg243962dj7sqz9dj64fqzpt,189,42628040,42628040,1679323151,1656386202,0,inbound,dce8271ff6ca6bacf4f9fd9ff463f587a0bb9d4c805af60777bec31dde32c916
216,1ELqWfzXnrxPLHSrgX2Z13nmK4Nq3NLn3W,190,78753054600,78753054600,1680707674,1677522085,0,inbound,dce8271ff6ca6bacf4f9fd9ff463f587a0bb9d4c805af60777bec31dde32c916
217,38UzKBnyZZUsKhL7eiTrkRoRDiymN1P7n8,191,2627887,2627887,1672863606,1672860877,0,inbound,dce8271ff6ca6bacf4f9fd9ff463f587a0bb9d4c805af60777bec31dde32c916
218,bc1quqkjapykd967hswxzuz9jkn5yyhsfshea3qp9v,192,80000,80000,1672965463,1672860877,0,inbound,dce8271ff6ca6bacf4f9fd9ff463f587a0bb9d4c805af60777bec31dde32c916
219,3KMxs5mZ6UDhfb3gzFni8Edyog5Qx8oeEZ,193,4383199,4383199,1676074435,1672860877,0,inbound,dce8271ff6ca6bacf4f9fd9ff463f587a0bb9d4c805af60777bec31dde32c916
220,33LAfmPCs6RpEWX2z3KttWmrNrfcFNem8v,194,242100,242100,1672865414,1672860877,0,inbound,dce8271ff6ca6bacf4f9fd9ff463f587a0bb9d4c805af60777bec31dde32c916
221,31yp2r8EsMArQp1RWgKAqMpu3gwhshWrvm,195,194000,194000,1672894960,1672860877,0,inbound,dce8271ff6ca6bacf4f9fd9ff463f587a0bb9d4c805af60777bec31dde32c916
222,3F4xkfbfvnGj2N8FRRzw5FGg1EvCkaVPD9,234,375995,375995,1672769029,1672763951,0,inbound,dce8271ff6ca6bacf4f9fd9ff463f587a0bb9d4c805af60777bec31dde32c916
223,bc1qfr8k4uywkvl2fa4f8nh9t5dxzs2amx4w2cpyhn,235,163045796,107342774,1677847828,1676975294,55703022,inbound,dce8271ff6ca6bacf4f9fd9ff463f587a0bb9d4c805af60777bec31dde32c916
224,bc1q79dr847gg470sgtczgscyks22zpeegdawuh27xscy656khenr5yq89h4d3,236,39906968,39906968,1674938898,1658082608,0,inbound,dce8271ff6ca6bacf4f9fd9ff463f587a0bb9d4c805af60777bec31dde32c916
225,348RQXPF6goJSdMgCSEXjzUn7m5vcVPqyT,237,10644294,8807052,1681049021,1677834549,1837242,inbound,dce8271ff6ca6bacf4f9fd9ff463f587a0bb9d4c805af60777bec31dde32c916
226,3QgwTCDcdy9D73RKSPU2c87FDgtJbpBpWB,238,3004555,3004555,1673343091,1672763951,0,inbound,dce8271ff6ca6bacf4f9fd9ff463f587a0bb9d4c805af60777bec31dde32c916
227,3PGR5qAx3p8mdoP1k4NHKhwCkZHuUPFrQU,239,36193118,32886800,1681049018,1680283029,3306318,inbound,dce8271ff6ca6bacf4f9fd9ff463f587a0bb9d4c805af60777bec31dde32c916
228,3AERN51EoXBcGKeLa92AnNqcYDNnPoMLYn,240,338477,338477,1672769029,1672763951,0,inbound,dce8271ff6ca6bacf4f9fd9ff463f587a0bb9d4c805af60777bec31dde32c916
229,bc1qmllgw3fhmmwq7fv44a5nkk8f0tpcp5ys3n2470,241,6720730593,6709759441,1681095000,1680913982,10971152,inbound,dce8271ff6ca6bacf4f9fd9ff463f587a0bb9d4c805af60777bec31dde32c916
230,bc1q5weyqd22v75mpwum8j5pzjd36r3qehkfuq7ep6,242,138662361,138662361,1674234958,1670833032,0,inbound,dce8271ff6ca6bacf4f9fd9ff463f587a0bb9d4c805af60777bec31dde32c916
231,bc1q66gwjgeexqwrr4x9wn9ytljnzy24n9nvw3lny9,243,91168,91168,1672797831,1672763951,0,inbound,dce8271ff6ca6bacf4f9fd9ff463f587a0bb9d4c805af60777bec31dde32c916
232,bc1qs3ca9g5cq7ek8w7d2tn505vpl8qghxce4pxqvz,244,79696,79696,1672869296,1672763950,0,inbound,dce8271ff6ca6bacf4f9fd9ff463f587a0bb9d4c805af60777bec31dde32c916
233,32coAMUNQrKSVcSe2HAY27zQLNNAXQ8RNd,245,74596389,74596389,1676030619,1673935329,0,outbound,dce8271ff6ca6bacf4f9fd9ff463f587a0bb9d4c805af60777bec31dde32c916
234,bc1qj893h6q940upqf9e2f5qv974x4xdwck3lkz30t,257,234744,234744,1672765334,1672763949,0,inbound,dce8271ff6ca6bacf4f9fd9ff463f587a0bb9d4c805af60777bec31dde32c916
235,3DsqxsqbdrmfJeRxBRuv4X9uMv5Wv8MLMQ,258,8599976,8599976,1672771549,1669059007,0,inbound,dce8271ff6ca6bacf4f9fd9ff463f587a0bb9d4c805af60777bec31dde32c916
236,39Eop5kjTtoxDbuknrghnXLie8zKPz3Rqg,259,317606,317606,1675393265,1672763949,0,inbound,dce8271ff6ca6bacf4f9fd9ff463f587a0bb9d4c805af60777bec31dde32c916
237,bc1q0kxm2dm7dyr3sleltcf0y5f8cpluf0lnmfugsm,260,320572662,320572662,1678266489,1669085911,0,inbound,dce8271ff6ca6bacf4f9fd9ff463f587a0bb9d4c805af60777bec31dde32c916
238,bc1q9s9nyp5xkdjjt4qvfvw6hp7aq4fwzawqt282m5,261,126585094,124751902,1680663501,1666819078,1833192,inbound,dce8271ff6ca6bacf4f9fd9ff463f587a0bb9d4c805af60777bec31dde32c916
239,3MQKLAedWmkUoVCtTJim8mF1NurcgP1BKM,262,72180,0,1672508827,1672508827,72180,inbound,dce8271ff6ca6bacf4f9fd9ff463f587a0bb9d4c805af60777bec31dde32c916
240,3LGa2e7RF5ETuW2S4f36T8i8JnaXrqHTC6,263,243502,243502,1672531468,1672508827,0,inbound,dce8271ff6ca6bacf4f9fd9ff463f587a0bb9d4c805af60777bec31dde32c916
241,bc1q4elnsxu99sm247gclm2m52z2096d8gv55t2mcz,264,724033,724033,1672511972,1672508827,0,inbound,dce8271ff6ca6bacf4f9fd9ff463f587a0bb9d4c805af60777bec31dde32c916
242,3BTNoKByQYZ9sVNajrGMniQ4kz5MoATC6a,265,1233439,1233439,1672728545,1672508827,0,inbound,dce8271ff6ca6bacf4f9fd9ff463f587a0bb9d4c805af60777bec31dde32c916
243,3EwsgEAWVwjJUfAcuy3nx3MdWs3XgUzfD5,266,37948956,37229139,1681088105,1662762127,719817,outbound,dce8271ff6ca6bacf4f9fd9ff463f587a0bb9d4c805af60777bec31dde32c916
244,bc1q9czqr2d26jznglfjkh4vpf9a5klpnc93zr6f8u,267,2941195,2941195,1672512874,1672508827,0,inbound,dce8271ff6ca6bacf4f9fd9ff463f587a0bb9d4c805af60777bec31dde32c916
245,3F9vEbJmJzavwfbPzUB1j5jK2ocGANJABD,268,319817,319817,1672735671,1672508827,0,inbound,dce8271ff6ca6bacf4f9fd9ff463f587a0bb9d4c805af60777bec31dde32c916
246,3LNUVp88HiXduZ1WnnN8J8eXAUUXM6A316,269,561480,561480,1672889794,1672508827,0,inbound,dce8271ff6ca6bacf4f9fd9ff463f587a0bb9d4c805af60777bec31dde32c916
247,1LMDMSyuTviy9YbymB4zEoXDCZUhyFrUmS,270,285302,285302,1672728495,1672508827,0,inbound,dce8271ff6ca6bacf4f9fd9ff463f587a0bb9d4c805af60777bec31dde32c916
248,353GGRjqYWB68iyvd4eqyaoYiF3XpMF9GJ,271,8627472,8627472,1675931888,1671299649,0,inbound,dce8271ff6ca6bacf4f9fd9ff463f587a0bb9d4c805af60777bec31dde32c916
249,3JagsnuJYcZZ4cZg1jW6iNYCy1vE8ReMBQ,283,572913,572913,1672531472,1672508827,0,inbound,dce8271ff6ca6bacf4f9fd9ff463f587a0bb9d4c805af60777bec31dde32c916
250,3Bmii1S2qRw7DqjYw8GYRR7zq5XAyRkV9H,284,1146573,1146573,1672512606,1672508827,0,inbound,dce8271ff6ca6bacf4f9fd9ff463f587a0bb9d4c805af60777bec31dde32c916
251,35BMdU2FuX2J5ykyf5eE6ExRmbscr9dcZW,285,285302,285302,1672531471,1672508827,0,inbound,dce8271ff6ca6bacf4f9fd9ff463f587a0bb9d4c805af60777bec31dde32c916
252,1NsX9gNor7zeApNEFpoLShwfzDwBxQUeVY,286,109102,109102,1674022579,1672508827,0,inbound,dce8271ff6ca6bacf4f9fd9ff463f587a0bb9d4c805af60777bec31dde32c916
253,18S4eEa1jquhUMouh54B8HmbwPPGjzpxyA,287,576696,0,1680228848,1662607911,576696,inbound,dce8271ff6ca6bacf4f9fd9ff463f587a0bb9d4c805af60777bec31dde32c916
254,bc1q4v0e3ar02w3cjh3scl38tztqkkhfv69hlqd0aa,288,9464013,9464013,1672518371,1672508827,0,inbound,dce8271ff6ca6bacf4f9fd9ff463f587a0bb9d4c805af60777bec31dde32c916
255,36EQbHsfkdwdqXrW3zEMXfjeaAECJz4BPR,289,1666331,1666331,1677331112,1672250648,0,inbound,dce8271ff6ca6bacf4f9fd9ff463f587a0bb9d4c805af60777bec31dde32c916
256,bc1qeze7k9qzn9gm07nky7zrd2y3u306a79szuzl8q,290,3203306,3115500,1680989713,1670648228,87806,inbound,dce8271ff6ca6bacf4f9fd9ff463f587a0bb9d4c805af60777bec31dde32c916
257,bc1qnd2hxcv8a6s3cqv3ajpydwcmrr9cl9wly48z95jeecgqxwha4mvs9k7g8t,291,291356943,291356943,1681052631,1666022448,0,inbound,dce8271ff6ca6bacf4f9fd9ff463f587a0bb9d4c805af60777bec31dde32c916
258,19WQon7E1pbaHxySacHd6CAXZMZvkYEaHB,292,772419,772419,1672513153,1672508827,0,inbound,dce8271ff6ca6bacf4f9fd9ff463f587a0bb9d4c805af60777bec31dde32c916
259,bc1qcfe6nwpdu48am0s4f3qcvekkfkmntd7ca3aex0,293,390252,280332,1672508827,1638309163,109920,inbound,dce8271ff6ca6bacf4f9fd9ff463f587a0bb9d4c805af60777bec31dde32c916
260,bc1ql054q7a6c9an4dljdt27ha75y676s9ygzhkmdltf0a4ankn4e6asquh3lm,294,126716,126716,1672699532,1672508827,0,inbound,dce8271ff6ca6bacf4f9fd9ff463f587a0bb9d4c805af60777bec31dde32c916
261,bc1qgftuamw6er4t3cj5uvhf0wdnq30yzyxqhk736u,295,131302,131302,1672511367,1672508827,0,inbound,dce8271ff6ca6bacf4f9fd9ff463f587a0bb9d4c805af60777bec31dde32c916
262,3HhBy4hVdWfkVrPs1BNCxFiNn7sdQJVPk9,296,343908,343908,1672531471,1672508827,0,inbound,dce8271ff6ca6bacf4f9fd9ff463f587a0bb9d4c805af60777bec31dde32c916
263,bc1qgl62ams0pws8h6sjugmjrxujzr5zcjp8392pca,297,167873,167873,1672721499,1672508827,0,inbound,dce8271ff6ca6bacf4f9fd9ff463f587a0bb9d4c805af60777bec31dde32c916
264,3LM2Tec9N4HiJ67vJGech1GY6e9Fw7J8Bw,298,156302,156302,1673023537,1672508827,0,inbound,dce8271ff6ca6bacf4f9fd9ff463f587a0bb9d4c805af60777bec31dde32c916
265,1AB63h6WezTCmva3tAWv2B6Z65xLuM3Ycm,299,1478428,1478428,1672635282,1672508827,0,inbound,dce8271ff6ca6bacf4f9fd9ff463f587a0bb9d4c805af60777bec31dde32c916
266,1CDy43SdQ4oRfxmWqNpoPxxgdJja2r9xEe,300,165892,165892,1672757056,1672508827,0,inbound,dce8271ff6ca6bacf4f9fd9ff463f587a0bb9d4c805af60777bec31dde32c916
267,3Bhdc2bxhrGa1dWEpWVyPrze5Jo2Lyc8d6,301,1943117,1943117,1672512613,1672508827,0,inbound,dce8271ff6ca6bacf4f9fd9ff463f587a0bb9d4c805af60777bec31dde32c916
268,1GTgzBnbB9UEKpEALeX8QvZ6NTG62Prukh,302,1147468,1147468,1672636763,1672508827,0,inbound,dce8271ff6ca6bacf4f9fd9ff463f587a0bb9d4c805af60777bec31dde32c916
269,bc1qcwne33gq4lhqdg067up26g6qtnul9xqwdmjmvx,303,2179507,2179507,1675977334,1672508827,0,inbound,dce8271ff6ca6bacf4f9fd9ff463f587a0bb9d4c805af60777bec31dde32c916
270,1M8Lya58WqPzr3rWkkm8XDXiGQDf5fPt6d,304,285280,285280,1672728504,1672508827,0,inbound,dce8271ff6ca6bacf4f9fd9ff463f587a0bb9d4c805af60777bec31dde32c916
271,18FmGnPqwW5apUERovmjK7goGzBjdEB3JV,305,313787,313787,1672835771,1672508827,0,inbound,dce8271ff6ca6bacf4f9fd9ff463f587a0bb9d4c805af60777bec31dde32c916
272,35bPgVkCu9R7oos3gX7G1cginuVc6oAGZw,317,3187002,3187002,1672626191,1672508827,0,inbound,dce8271ff6ca6bacf4f9fd9ff463f587a0bb9d4c805af60777bec31dde32c916
273,3L7q89wg4jPHvZubHhQHkgTykn5hpXHQZb,318,196113,196113,1672531468,1672508827,0,inbound,dce8271ff6ca6bacf4f9fd9ff463f587a0bb9d4c805af60777bec31dde32c916
274,14kWNXQQ7Kuhp3zfXbG5u2hiXctKwjrmvM,319,8716520,8716520,1672741681,1644512667,0,inbound,dce8271ff6ca6bacf4f9fd9ff463f587a0bb9d4c805af60777bec31dde32c916
275,bc1qdtn4htm0jv7872ar8xe4grq6uyqyk928cy83f5,320,28747847,28747847,1678923686,1676071136,0,outbound,dce8271ff6ca6bacf4f9fd9ff463f587a0bb9d4c805af60777bec31dde32c916
276,bc1qvagw544h3a7agk5h8lnw4hqs7xak4p67qxjs9n,321,195702,195702,1672515168,1672508827,0,inbound,dce8271ff6ca6bacf4f9fd9ff463f587a0bb9d4c805af60777bec31dde32c916
277,3KLKd5eJHGstd5eaj3pxu2w3E48u17yyum,322,241374,241374,1672797560,1672508827,0,inbound,dce8271ff6ca6bacf4f9fd9ff463f587a0bb9d4c805af60777bec31dde32c916
278,358d1KWZbDdWbGmzHpRC9PF3kcFEquu5ST,323,27029683,27029683,1680355430,1671149091,0,inbound,dce8271ff6ca6bacf4f9fd9ff463f587a0bb9d4c805af60777bec31dde32c916
279,bc1qcnt5pntshcq6g4fzf58kxqn0afyhjj5k40xs6e,324,22340731,22340731,1672418532,1670953970,0,inbound,dce8271ff6ca6bacf4f9fd9ff463f587a0bb9d4c805af60777bec31dde32c916
280,35sGRbGUfgD6yZZLYZEv1S8fEBewAcJWFQ,325,899196402,893769272,1680584392,1671832648,5427130,outbound,dce8271ff6ca6bacf4f9fd9ff463f587a0bb9d4c805af60777bec31dde32c916
281,38MfJkxPkpwsZxkyfESwjdaKBdXrV8DpWr,326,33561276309130,33561266328601,1681089611,1680280936,9980529,outbound,dce8271ff6ca6bacf4f9fd9ff463f587a0bb9d4c805af60777bec31dde32c916
282,bc1qmvdleqw49vluretgj9takz8nlqugp40j2wp2q3,327,6598123,6598123,1679327815,1672414729,0,inbound,dce8271ff6ca6bacf4f9fd9ff463f587a0bb9d4c805af60777bec31dde32c916
283,bc1qrlu8pq5pjj3270g2u2r63ztutlz374twa0qyxn,328,421231,421231,1672415221,1672414729,0,inbound,dce8271ff6ca6bacf4f9fd9ff463f587a0bb9d4c805af60777bec31dde32c916
284,353eRXkk1CfTtCgWu3uiFKXm3vdev9Z5ua,329,5611815,5611815,1673320695,1672253689,0,inbound,dce8271ff6ca6bacf4f9fd9ff463f587a0bb9d4c805af60777bec31dde32c916
285,bc1qmdpee5t284py6rhddn94jujf9vtlqmw9u2evyn,330,213571204,213571204,1678962172,1653074648,0,inbound,dce8271ff6ca6bacf4f9fd9ff463f587a0bb9d4c805af60777bec31dde32c916
286,3BAtmcXRfBZh2bTukqkEygcDHzLtPRnPjv,331,80000,80000,1672419400,1672414729,0,inbound,dce8271ff6ca6bacf4f9fd9ff463f587a0bb9d4c805af60777bec31dde32c916
287,bc1qn29saytgwxc5gdqfagma7h0zkqeq8xtfqdwla8,332,89074473,0,1672414729,1672414729,89074473,inbound,dce8271ff6ca6bacf4f9fd9ff463f587a0bb9d4c805af60777bec31dde32c916
288,bc1qqrzammq5eak24ewnpvlmkd7g046zwzpqqh6ztm,333,114032615,0,1679219198,1671710330,114032615,inbound,dce8271ff6ca6bacf4f9fd9ff463f587a0bb9d4c805af60777bec31dde32c916
289,3GoPkmXP2kY4g9JTC4U4vvH6o15DM89DvX,334,1999908,1999908,1672679771,1672414729,0,inbound,dce8271ff6ca6bacf4f9fd9ff463f587a0bb9d4c805af60777bec31dde32c916
290,3QqYWNpqpY97iKZ459fCqSRbUiRXZxctTT,335,7894503,7894503,1673371872,1672414729,0,inbound,dce8271ff6ca6bacf4f9fd9ff463f587a0bb9d4c805af60777bec31dde32c916
291,bc1qguddpecnlk5q9hvx6dvg75g0cnzn4w0e95wtyd,336,27752100,0,1672414729,1672414729,27752100,inbound,dce8271ff6ca6bacf4f9fd9ff463f587a0bb9d4c805af60777bec31dde32c916
292,3LCjHUPZFPd4vddM3j5rH28TcUVmL32b8Q,337,24127905,24127905,1678795547,1658565878,0,inbound,dce8271ff6ca6bacf4f9fd9ff463f587a0bb9d4c805af60777bec31dde32c916
293,bc1qhxu4usd9hrmxlryw3ansqn4vup5mnhxay495sf,338,3963049,0,1672414729,1672414729,3963049,inbound,dce8271ff6ca6bacf4f9fd9ff463f587a0bb9d4c805af60777bec31dde32c916
294,bc1qek8ajeygzlq3le2q4hv8vfvjcadgs8s9nj4puz,339,912883000,912883000,1672420423,1653923799,0,inbound,dce8271ff6ca6bacf4f9fd9ff463f587a0bb9d4c805af60777bec31dde32c916
295,35yQp7ZNBFHEEpE7kjXm6gzj3KBwBibwTA,340,3449906,3449906,1672661531,1672414729,0,inbound,dce8271ff6ca6bacf4f9fd9ff463f587a0bb9d4c805af60777bec31dde32c916
296,bc1qmz863ezrm4v5dnapjslqegdj93pmythp34dykwr0xn65jtk7yd6sh4k44p,341,70906331,70906331,1680307340,1677687646,0,inbound,dce8271ff6ca6bacf4f9fd9ff463f587a0bb9d4c805af60777bec31dde32c916
297,bc1qke25q075cajprle9ul7dxjw0rs4j5xx47e2sue,342,18875041,18875041,1680380805,1643707939,0,inbound,dce8271ff6ca6bacf4f9fd9ff463f587a0bb9d4c805af60777bec31dde32c916
298,32D3YNhS4CN6HaadeLSVmv63sU7JibQWAn,343,588460,588460,1672456249,1672414729,0,inbound,dce8271ff6ca6bacf4f9fd9ff463f587a0bb9d4c805af60777bec31dde32c916
299,3ANTBStp1wEpvNV1c7HJE8Zb9roy81ysoW,344,1310000,1310000,1672518127,1672414729,0,inbound,dce8271ff6ca6bacf4f9fd9ff463f587a0bb9d4c805af60777bec31dde32c916
300,39MiRSiTVh6bgL4JgiepYk8MCPyiXea9W3,345,100000,100000,1673335046,1672414729,0,inbound,dce8271ff6ca6bacf4f9fd9ff463f587a0bb9d4c805af60777bec31dde32c916
301,bc1q0mn8hmuanv3vn0xmfl3j26g0npw2pdghg2g3kv,346,658011,657137,1672422377,1664723118,874,inbound,dce8271ff6ca6bacf4f9fd9ff463f587a0bb9d4c805af60777bec31dde32c916
302,3HVpXq6ZRJKMrvauwBkV1DMNcdJQaqjcng,347,333843652,328938630,1680323875,1672202653,4905022,outbound,dce8271ff6ca6bacf4f9fd9ff463f587a0bb9d4c805af60777bec31dde32c916
303,1HbiimTwbbFKnT4nBc2BRDn8d5uof4sQnZ,348,12192925,12192925,1672416135,1672414729,0,inbound,dce8271ff6ca6bacf4f9fd9ff463f587a0bb9d4c805af60777bec31dde32c916
304,bc1qdqryjtc3879pqyfxtwhpd0ye76egp9z7ag3slm,349,5813000,0,1672414729,1672414729,5813000,inbound,dce8271ff6ca6bacf4f9fd9ff463f587a0bb9d4c805af60777bec31dde32c916
305,bc1qfvrfmqvw06k4xxqkcgaura7flwk96alnqjtefd,350,4567377801,4539124882,1681070528,1679394856,28252919,outbound,dce8271ff6ca6bacf4f9fd9ff463f587a0bb9d4c805af60777bec31dde32c916
306,3BJ7M7DP7y7xDJ6iirao5ynSj2WNUEZVKX,446,888002784,887385784,1675653337,1668561863,617000,inbound,dce8271ff6ca6bacf4f9fd9ff463f587a0bb9d4c805af60777bec31dde32c916
307,382mFYsJcZgDpjQ9UbzshpJPRLbvgFR9Mk,447,605954,605954,1672295909,1672264538,0,inbound,dce8271ff6ca6bacf4f9fd9ff463f587a0bb9d4c805af60777bec31dde32c916
308,3AbGuidkEVv4uSn9ttbudJJgmHfE65mEHH,448,7377314,7377314,1674347419,1657832276,0,inbound,dce8271ff6ca6bacf4f9fd9ff463f587a0bb9d4c805af60777bec31dde32c916
309,1PoKSHekhhmvbyWiDqFwCHLYpP2SzeXFH2,449,54723544,54723544,1680544965,1666381850,0,inbound,dce8271ff6ca6bacf4f9fd9ff463f587a0bb9d4c805af60777bec31dde32c916
310,36VwSTJ5VyuKocbyMMWZ8fJGTYHURGqydR,450,41472021,39982789,1681046679,1672515807,1489232,inbound,dce8271ff6ca6bacf4f9fd9ff463f587a0bb9d4c805af60777bec31dde32c916
311,16LRg8ekBC4zx36sNDWtaJKhPU2LoAE3cQ,451,326048206,326048206,1679724201,1675920223,0,inbound,dce8271ff6ca6bacf4f9fd9ff463f587a0bb9d4c805af60777bec31dde32c916
312,39n6Sq8gy6NhveuhiNoyYNDGHnTYjMjTCe,452,195437095,194049955,1680359318,1677700479,1387140,inbound,dce8271ff6ca6bacf4f9fd9ff463f587a0bb9d4c805af60777bec31dde32c916
313,bc1qvkrx5kctmmvnpcfl270m4q036xgdrsur723une,453,20463841,20463841,1680699815,1661013328,0,inbound,dce8271ff6ca6bacf4f9fd9ff463f587a0bb9d4c805af60777bec31dde32c916
314,bc1q6gu59xl8nkguxx460my0450ldmey857lruhuy4,454,8001024,8001024,1674209464,1671662694,0,inbound,dce8271ff6ca6bacf4f9fd9ff463f587a0bb9d4c805af60777bec31dde32c916
315,3FrBhotQcBaEeiGowTpoqdtD2KY6zWcAUX,455,282514,282514,1672272143,1672264538,0,inbound,dce8271ff6ca6bacf4f9fd9ff463f587a0bb9d4c805af60777bec31dde32c916
316,bc1qazgal5p6x2aw0x2wy2mgrgl9vu73u9vk4pzvuc,456,1418637,1418637,1672300616,1672250691,0,inbound,dce8271ff6ca6bacf4f9fd9ff463f587a0bb9d4c805af60777bec31dde32c916
317,1A6wn9rWghNQYQmGGppmqHWb3CvxJnqziR,457,272618,272618,1672289717,1672264538,0,inbound,dce8271ff6ca6bacf4f9fd9ff463f587a0bb9d4c805af60777bec31dde32c916
318,1Nzn8Vp6M3YGW6hmjj7Y6LMR9j8dMp54uF,458,2961522,2961522,1672269313,1672264538,0,inbound,dce8271ff6ca6bacf4f9fd9ff463f587a0bb9d4c805af60777bec31dde32c916
319,bc1q4vhac7tpujlzak565wz7h32hz4yvspqzgchvwx,459,31841387,31834145,1674709635,1667518620,7242,inbound,dce8271ff6ca6bacf4f9fd9ff463f587a0bb9d4c805af60777bec31dde32c916
320,15eMF7VsHDv7mHWEWRDivu8RkRjYSqGGuk,460,316385956,309845491,1678617256,1677049027,6540465,inbound,dce8271ff6ca6bacf4f9fd9ff463f587a0bb9d4c805af60777bec31dde32c916
321,3Q2ciuvaNZERZZtkrPEcvBVdjBJRgCFhPh,461,193833,193833,1672272136,1672264538,0,inbound,dce8271ff6ca6bacf4f9fd9ff463f587a0bb9d4c805af60777bec31dde32c916
322,39aSJ2sGky2NTazN5etssaei14DwgVwi3U,462,214737921,212387886,1680768064,1675620051,2350035,inbound,dce8271ff6ca6bacf4f9fd9ff463f587a0bb9d4c805af60777bec31dde32c916
323,19MgmCGrCbjLHR7Gp31DkgnnFgCKo7FaUv,463,5095753892,5095753892,1680854537,1675843526,0,inbound,dce8271ff6ca6bacf4f9fd9ff463f587a0bb9d4c805af60777bec31dde32c916
324,39cLwgd9DyXBPayEFoheoy1kh8RDym6UtS,480,1717262555,1714582307,1681045916,1678312165,2680248,outbound,dce8271ff6ca6bacf4f9fd9ff463f587a0bb9d4c805af60777bec31dde32c916
325,3Gz6CWBpGuKXFfjJtafAzjYqEh2bWShBxv,481,121164,121164,1672788274,1672264538,0,inbound,dce8271ff6ca6bacf4f9fd9ff463f587a0bb9d4c805af60777bec31dde32c916
326,3JG3dMRPwsARyT92x4KJQAEfQ8wHWvHGbB,482,532890,532890,1674771433,1672264538,0,inbound,dce8271ff6ca6bacf4f9fd9ff463f587a0bb9d4c805af60777bec31dde32c916
327,1KGHNC3AY1TDUzjmzbGWqQk1ojBFPhX7eF,483,5938463,5938463,1672267391,1672264538,0,inbound,dce8271ff6ca6bacf4f9fd9ff463f587a0bb9d4c805af60777bec31dde32c916
328,13iXLu3hw667afVXu1ukCEXECw4v2igVjE,484,359521,359521,1672267932,1672264538,0,inbound,dce8271ff6ca6bacf4f9fd9ff463f587a0bb9d4c805af60777bec31dde32c916
329,bc1qvsa0zjclyyjvt4vgmhr3suu7xf2zg8r9tfq60e,485,181870,181870,1672265541,1672264538,0,inbound,dce8271ff6ca6bacf4f9fd9ff463f587a0bb9d4c805af60777bec31dde32c916
330,37LYkmc8hgEusozJzr9KmbqqFimrFNMjH8,486,19543145,17478086,1681069865,1668608988,2065059,inbound,dce8271ff6ca6bacf4f9fd9ff463f587a0bb9d4c805af60777bec31dde32c916
331,194Ew7cqVekxKuGBC4a8FsJFDXqDQATxtz,487,5682892,5682892,1672315337,1672264538,0,inbound,dce8271ff6ca6bacf4f9fd9ff463f587a0bb9d4c805af60777bec31dde32c916
332,3PPRDQ6Ez8f7HWxpvRVdsfpA9Za8T8h8AN,488,252060,252060,1672738057,1672264538,0,inbound,dce8271ff6ca6bacf4f9fd9ff463f587a0bb9d4c805af60777bec31dde32c916
333,bc1qa9vqhwm0276vfxgan63kxv5tra4cjhx96lljzg,489,227017757,227017757,1672278794,1672264538,0,inbound,dce8271ff6ca6bacf4f9fd9ff463f587a0bb9d4c805af60777bec31dde32c916
334,bc1q8d9ykyvgj8t6r3fykjut3s2aj3gaxgkam2w8p3,490,57858667,45619417,1680874207,1667713886,12239250,inbound,dce8271ff6ca6bacf4f9fd9ff463f587a0bb9d4c805af60777bec31dde32c916
335,1GvJb3MmLD7YS4wMs2nEqZd6A5UsCbAUgi,491,108827,108827,1672264945,1672264538,0,inbound,dce8271ff6ca6bacf4f9fd9ff463f587a0bb9d4c805af60777bec31dde32c916
336,3Bwt2gCmDiinakMP9wPpd9sXak1cyN4Jid,492,163543,163543,1672272135,1672264538,0,inbound,dce8271ff6ca6bacf4f9fd9ff463f587a0bb9d4c805af60777bec31dde32c916
337,3H5wqs6cQ5pd4U2TjjyJfu1M4YjN6zc2c2,493,6045524,6045524,1676899739,1672258507,0,inbound,dce8271ff6ca6bacf4f9fd9ff463f587a0bb9d4c805af60777bec31dde32c916
338,36Ppd6DU4kVBSUsHQ6couCqek84ZXSsxDt,494,23470664618,23468373559,1681065324,1679654076,2291059,inbound,dce8271ff6ca6bacf4f9fd9ff463f587a0bb9d4c805af60777bec31dde32c916
339,16o472jFGKe7CbZ1pJJ5vZveoDVsSJEmEp,495,282523,282523,1672264908,1672264538,0,inbound,dce8271ff6ca6bacf4f9fd9ff463f587a0bb9d4c805af60777bec31dde32c916
340,3DoQJXYKG8RuDFsZmyi9t6KjydLcXH6Dma,496,5174588,5174588,1680486882,1658937145,0,inbound,dce8271ff6ca6bacf4f9fd9ff463f587a0bb9d4c805af60777bec31dde32c916
341,16e6RXScQdD9bup2kVwKtjNWcTMM7uXBq3,497,121168,121168,1672381093,1672264538,0,inbound,dce8271ff6ca6bacf4f9fd9ff463f587a0bb9d4c805af60777bec31dde32c916
342,3NsbYZFfuikVuyjbk7kmcPey9FAJewAsSX,498,99486512,99229834,1680239496,1675749821,256678,outbound,dce8271ff6ca6bacf4f9fd9ff463f587a0bb9d4c805af60777bec31dde32c916
343,bc1ql4c7kjeymc6dcyy788w95zxuxm7ldeku44lhmz,499,12154461,11949753,1679820497,1669591624,204708,inbound,dce8271ff6ca6bacf4f9fd9ff463f587a0bb9d4c805af60777bec31dde32c916
344,bc1q0yxw5lyvgsyz2etrepm53ayzkgq07w6dyv2mfl,500,1474069,1474069,1672441390,1672264538,0,inbound,dce8271ff6ca6bacf4f9fd9ff463f587a0bb9d4c805af60777bec31dde32c916
345,3BwvKi6kngbiSjjoF7ZMRMhj9oj3eGJbUM,501,363444,363444,1672326378,1672264538,0,inbound,dce8271ff6ca6bacf4f9fd9ff463f587a0bb9d4c805af60777bec31dde32c916
346,bc1qtahqlenxpsjedqypmw4dk7h46z89d44h9ly3nq,502,252916,252916,1672301907,1672264538,0,inbound,dce8271ff6ca6bacf4f9fd9ff463f587a0bb9d4c805af60777bec31dde32c916
347,1KMzzTLQhqsKfd8zPf9tMTLGWQUCv1w8Cy,503,64163284,64163284,1681062610,1674871304,0,outbound,dce8271ff6ca6bacf4f9fd9ff463f587a0bb9d4c805af60777bec31dde32c916
348,3GJqbezD45YffDUi8sFwmaJyqmstbw2jnN,504,10949238,10949238,1672266517,1672050268,0,inbound,dce8271ff6ca6bacf4f9fd9ff463f587a0bb9d4c805af60777bec31dde32c916
349,bc1q0jc2kqk7p0q9tukcx0xjcdzrrj5qxuqmuj0nua,505,45763,45763,1672796470,1672264538,0,inbound,dce8271ff6ca6bacf4f9fd9ff463f587a0bb9d4c805af60777bec31dde32c916
350,bc1q8lrlufml06xe9jhu38zpef4us5mf7yq59368ah,506,227017753,227017753,1672278794,1672264538,0,inbound,dce8271ff6ca6bacf4f9fd9ff463f587a0bb9d4c805af60777bec31dde32c916
351,bc1qvmpe07m9cu9rrrg4lhlhgh0sfk5jn25x6wmkcz,507,227017753,227017753,1672278883,1672264538,0,inbound,dce8271ff6ca6bacf4f9fd9ff463f587a0bb9d4c805af60777bec31dde32c916
352,33wd5aXRaGWjgvJLUZmNthcTTemoCLBw8P,508,8079148,7847614,1680427185,1671590874,231534,inbound,dce8271ff6ca6bacf4f9fd9ff463f587a0bb9d4c805af60777bec31dde32c916
353,3QkRqUgdymrq2ckQ4x8jmn6XNb2TcBPC94,509,61342867,60998365,1680869525,1670196184,344502,outbound,dce8271ff6ca6bacf4f9fd9ff463f587a0bb9d4c805af60777bec31dde32c916
354,3GYWSk1cMTJXFhQnv6HERuD375vDmaJq6q,510,244734616,244734616,1680752441,1606244959,0,inbound,dce8271ff6ca6bacf4f9fd9ff463f587a0bb9d4c805af60777bec31dde32c916
355,bc1qgy63rv7kzwzya5d80nfj3av4zqlwc0kzwdzwgl,511,124436251,124245815,1681027575,1673010090,190436,outbound,dce8271ff6ca6bacf4f9fd9ff463f587a0bb9d4c805af60777bec31dde32c916
356,bc1qzaw8vwzr6m5yh8glyvm060z2lz6gj2gzltp3yl,512,208507,208507,1672264989,1672264538,0,inbound,dce8271ff6ca6bacf4f9fd9ff463f587a0bb9d4c805af60777bec31dde32c916
357,33ZJTv15QB5MHSHnJzggJYYU1evm1zEdD3,513,341733,341733,1672272140,1672264538,0,inbound,dce8271ff6ca6bacf4f9fd9ff463f587a0bb9d4c805af60777bec31dde32c916
358,bc1qjvu6kq3yyf4q5hjdhnzl9nvm4fcwax0dpd7gtak4k5ecw47qlasslrf4kl,711,130617,130617,1672737564,1672082849,0,inbound,dce8271ff6ca6bacf4f9fd9ff463f587a0bb9d4c805af60777bec31dde32c916
359,1GEjF3r6StzrzXmyYs7i216yMrTjj3hsLG,712,20930082,20930082,1672269368,1664636455,0,outbound,dce8271ff6ca6bacf4f9fd9ff463f587a0bb9d4c805af60777bec31dde32c916
360,1JobweY3MMLa4ra8t2pgfd3oYQ8Vyh3PdK,713,5937051,5937051,1672187620,1672082849,0,inbound,dce8271ff6ca6bacf4f9fd9ff463f587a0bb9d4c805af60777bec31dde32c916
361,1FgNmbdgtcQgiYC3VNyDc77xpgLE3h7x7w,714,41596,41596,1673547852,1672082849,0,inbound,dce8271ff6ca6bacf4f9fd9ff463f587a0bb9d4c805af60777bec31dde32c916
362,3MqUZywMEw8rhnkNCB5YtRS8VtDjqNxWPR,715,2535122776,2535122776,1681132671,1680809460,0,inbound,dce8271ff6ca6bacf4f9fd9ff463f587a0bb9d4c805af60777bec31dde32c916
363,3DBq3K7SXnYLSN7bm5KrWrE3oDLgiop1dF,716,335054,335054,1673706848,1672082849,0,inbound,dce8271ff6ca6bacf4f9fd9ff463f587a0bb9d4c805af60777bec31dde32c916
364,3J3L79P3LVSEwpMPk4z7XWtvyv7DKUtLdW,717,566989,566989,1672765270,1672082849,0,inbound,dce8271ff6ca6bacf4f9fd9ff463f587a0bb9d4c805af60777bec31dde32c916
365,322TjYZSFCRshFcfsuy66VqdEUFRYup9wq,718,205947,205947,1672099662,1672082849,0,inbound,dce8271ff6ca6bacf4f9fd9ff463f587a0bb9d4c805af60777bec31dde32c916
366,bc1qx3qk529kx693ne7mzgmt0revpye5e4nknvyh96,719,9016693,8479121,1681082997,1667609146,537572,inbound,dce8271ff6ca6bacf4f9fd9ff463f587a0bb9d4c805af60777bec31dde32c916
367,36ALoSouVNtMTybERXrBLr387C9M8hn5bR,720,108056,108056,1672117297,1672082849,0,inbound,dce8271ff6ca6bacf4f9fd9ff463f587a0bb9d4c805af60777bec31dde32c916
368,3Fv7Uu2Zb5GyXxthqhkWDE4iS3aK5N7inf,721,593706,593706,1672103368,1672082849,0,inbound,dce8271ff6ca6bacf4f9fd9ff463f587a0bb9d4c805af60777bec31dde32c916
369,359MBtPjFG2X9cG6UsYr8PcDbYHvGgPa9W,722,1139924,1139924,1672127082,1672082849,0,inbound,dce8271ff6ca6bacf4f9fd9ff463f587a0bb9d4c805af60777bec31dde32c916
370,bc1qnffwnl0fx9as293d202nsp4lepeg637jw36wh2,723,201863,201863,1672120833,1672082849,0,inbound,dce8271ff6ca6bacf4f9fd9ff463f587a0bb9d4c805af60777bec31dde32c916
371,32r5CZmCJpesZNa7Yh5Ck9cXrRZ9ZCwMaA,724,335074,335074,1672163667,1672082849,0,inbound,dce8271ff6ca6bacf4f9fd9ff463f587a0bb9d4c805af60777bec31dde32c916
372,32QU7ab2kBGPdLyGd879uJcsoZGDYeFM68,725,150251979,150251979,1677877032,1652637779,0,inbound,dce8271ff6ca6bacf4f9fd9ff463f587a0bb9d4c805af60777bec31dde32c916
373,3AofqpmfgofdeQzWVLMGeJgToDGJCUUAA4,726,1092305,1092305,1672413099,1672082849,0,inbound,dce8271ff6ca6bacf4f9fd9ff463f587a0bb9d4c805af60777bec31dde32c916
374,1C9xV7HUQda8rSTeuBRiSzg1JzGvWwVRFv,727,160301,160301,1672086692,1672082849,0,inbound,dce8271ff6ca6bacf4f9fd9ff463f587a0bb9d4c805af60777bec31dde32c916
375,1GuaMnG4fmk4ymEny6c52b15PA1kBo2v4x,728,162432459,162354820,1681121878,1676677737,77639,inbound,dce8271ff6ca6bacf4f9fd9ff463f587a0bb9d4c805af60777bec31dde32c916
376,bc1qklfnt8zu0xu2a5sl2y407cmr8gnwf55kwc60j4,729,144110138,144110138,1680647381,1672419731,0,inbound,dce8271ff6ca6bacf4f9fd9ff463f587a0bb9d4c805af60777bec31dde32c916
377,3Fseu8yvow5o1Cx72XcpmyiEwLQoWcATdn,730,76503478,75814978,1680182017,1678006469,688500,outbound,dce8271ff6ca6bacf4f9fd9ff463f587a0bb9d4c805af60777bec31dde32c916
378,3B2mU8sYcYaQsAz98Xh7o2NXM1XvxsMJAv,731,102895,0,1672082849,1672082849,102895,inbound,dce8271ff6ca6bacf4f9fd9ff463f587a0bb9d4c805af60777bec31dde32c916
379,3378N25bTbT5aR2QQeQKroJJHjzcANzARg,732,641193,641193,1672099668,1672082849,0,inbound,dce8271ff6ca6bacf4f9fd9ff463f587a0bb9d4c805af60777bec31dde32c916
380,3MNQTTkN64nRPUxfdohXmsa2MJpwTBaShr,733,13633653302,13616065164,1681140271,1680864057,17588138,inbound,dce8271ff6ca6bacf4f9fd9ff463f587a0bb9d4c805af60777bec31dde32c916
381,3FPSjffkTUGVT2oZWgToaCasnqYjT3VuUm,734,184048,184048,1672155959,1672082849,0,inbound,dce8271ff6ca6bacf4f9fd9ff463f587a0bb9d4c805af60777bec31dde32c916
382,3DNpE7srna2UjhMPLdxtQCjBpvU64EWMBa,735,917803,917803,1672099675,1672082849,0,inbound,dce8271ff6ca6bacf4f9fd9ff463f587a0bb9d4c805af60777bec31dde32c916
383,35oWBbxAL14eE6fsdToLJVSQcZvPznXCCQ,736,456592698,456452848,1681072345,1665503247,139850,outbound,dce8271ff6ca6bacf4f9fd9ff463f587a0bb9d4c805af60777bec31dde32c916
384,1MwQMoRzvbZ4oY3YcssrZSGP4fh8RV1eDy,737,2292067936,2292067936,1681135622,1680682384,0,outbound,dce8271ff6ca6bacf4f9fd9ff463f587a0bb9d4c805af60777bec31dde32c916
385,16Fr8ZKqqF4v1V9AG3JjA936QqxLcNqgZi,738,68877491,68877491,1681064363,1676850912,0,inbound,dce8271ff6ca6bacf4f9fd9ff463f587a0bb9d4c805af60777bec31dde32c916
386,31hdFYJNPQsvZMH3UzjizXFSeSXuHj4aLc,739,132133,132133,1672090310,1672082849,0,inbound,dce8271ff6ca6bacf4f9fd9ff463f587a0bb9d4c805af60777bec31dde32c916
387,1FsGjUJdZF9tvz1xpptXVaXCB6ASh18jU4,740,123712,123712,1672086692,1672082849,0,inbound,dce8271ff6ca6bacf4f9fd9ff463f587a0bb9d4c805af60777bec31dde32c916
388,3H74VT858rk4nPj7AQCWWYReV8XsmAmHo5,741,75486596,73983533,1681115153,1679456882,1503063,inbound,dce8271ff6ca6bacf4f9fd9ff463f587a0bb9d4c805af60777bec31dde32c916
389,bc1qwudugkfhnhunvkwe07luk6hxr8a2zaszlh6t9u,742,80044108,80025951,1678314161,1672172092,18157,outbound,dce8271ff6ca6bacf4f9fd9ff463f587a0bb9d4c805af60777bec31dde32c916
390,36tXfryk6BrJGYjC8DnCtFLwnNpVPkrZQv,743,142303,142303,1672099663,1672082849,0,inbound,dce8271ff6ca6bacf4f9fd9ff463f587a0bb9d4c805af60777bec31dde32c916
391,1GobhtoE1voVAWtTgT2cCRF43Xv2QuPTyw,744,419880,0,1672082849,1672082849,419880,inbound,dce8271ff6ca6bacf4f9fd9ff463f587a0bb9d4c805af60777bec31dde32c916
392,3GY2z541ikBxm6kW3iCeyEr8KBZsTn8AWC,875,10942406590,10931815791,1681132671,1680540524,10590799,outbound,dce8271ff6ca6bacf4f9fd9ff463f587a0bb9d4c805af60777bec31dde32c916
393,3Cj6WFjbAkuRS3gWDYJPy4GkVDjeoP5Vd6,876,161934,161934,1671926576,1671903850,0,inbound,dce8271ff6ca6bacf4f9fd9ff463f587a0bb9d4c805af60777bec31dde32c916
394,39pAmKqDnB2DWcY794tTBmaqCq5ZscMBRT,877,118820,118820,1672702105,1671903850,0,inbound,dce8271ff6ca6bacf4f9fd9ff463f587a0bb9d4c805af60777bec31dde32c916
395,13cpb9AvqRTTfpGWkgkwbbrQVv5X1cowtW,878,320846,320846,1672096812,1671903850,0,inbound,dce8271ff6ca6bacf4f9fd9ff463f587a0bb9d4c805af60777bec31dde32c916
396,bc1qwr6r7yjdtyk3u9dl70yw469mhmh09ntrl0kj6m,879,136161,136161,1671999544,1671903850,0,inbound,dce8271ff6ca6bacf4f9fd9ff463f587a0bb9d4c805af60777bec31dde32c916
397,bc1qgt7cwe7z224u669vlnu3lm84kf4zs9mzs7rqxyceugec56rv00fszr62kp,880,31628069,31628069,1681078484,1673122887,0,outbound,dce8271ff6ca6bacf4f9fd9ff463f587a0bb9d4c805af60777bec31dde32c916
398,bc1qphjqh763kqxlrf6zm254tn30rgvaj9mnqecr8wyac39pkny7uquqchj5d3,881,76926173,76237585,1681139588,1678537387,688588,inbound,dce8271ff6ca6bacf4f9fd9ff463f587a0bb9d4c805af60777bec31dde32c916
399,1APQzSwqGcYXyeEhVXoVLyr3qAWeMTPXms,882,600140,0,1671903850,1671903850,600140,inbound,dce8271ff6ca6bacf4f9fd9ff463f587a0bb9d4c805af60777bec31dde32c916
400,3Py4S2vbxHq3vE7wG5i3iB8k9G6mMcVLAV,883,117823,117823,1671926573,1671903850,0,inbound,dce8271ff6ca6bacf4f9fd9ff463f587a0bb9d4c805af60777bec31dde32c916
401,1ACoot2pRiiteabPUuzwz3svy8qAyTEaQG,884,210006,210006,1672005555,1671903850,0,inbound,dce8271ff6ca6bacf4f9fd9ff463f587a0bb9d4c805af60777bec31dde32c916
402,3MuBW4Yb1KKqbEcsSfLYfXi1xXXGpx66Ek,885,72967910,72967910,1680657917,1652397551,0,inbound,dce8271ff6ca6bacf4f9fd9ff463f587a0bb9d4c805af60777bec31dde32c916
403,3HYfssXwUCzpAF28yA3uawbGubziG3H75u,886,175432271,175432271,1672467081,1672190709,0,inbound,dce8271ff6ca6bacf4f9fd9ff463f587a0bb9d4c805af60777bec31dde32c916
404,3JvJGGZMfoXDFS2fA79jv518E97kxPTaxV,887,261421785,261361067,1681047390,1679511726,60718,inbound,dce8271ff6ca6bacf4f9fd9ff463f587a0bb9d4c805af60777bec31dde32c916
405,3Pj3h1XiBmYbGqCeAz1g3rUm6m6ptwWEcq,888,46221423,46079998,1680259515,1650524110,141425,inbound,dce8271ff6ca6bacf4f9fd9ff463f587a0bb9d4c805af60777bec31dde32c916
406,3KkMRKRbcJAWvsMstqfscwPNWHY6DuRGyw,889,279334973,271284768,1681136407,1677103145,8050205,outbound,dce8271ff6ca6bacf4f9fd9ff463f587a0bb9d4c805af60777bec31dde32c916
407,1BFyLEF1G1QA3DVCNvuP3MKPSrx9Bggjcs,890,280991,280991,1672234332,1671903850,0,inbound,dce8271ff6ca6bacf4f9fd9ff463f587a0bb9d4c805af60777bec31dde32c916
408,3728etgZTfNABDW6cHsHuN9tYRtEW3Nfxe,891,1066195,1066195,1672071625,1671903850,0,inbound,dce8271ff6ca6bacf4f9fd9ff463f587a0bb9d4c805af60777bec31dde32c916
409,3LNvfgizGXQE7NB9Ze6YgyBuF48P8rxaFE,892,7443484,7443484,1672490447,1655351466,0,inbound,dce8271ff6ca6bacf4f9fd9ff463f587a0bb9d4c805af60777bec31dde32c916
410,3QtEoTZU7NZpQNRPXj8YHF4xrWfxXFZNRa,893,897054,897054,1672127082,1671903850,0,inbound,dce8271ff6ca6bacf4f9fd9ff463f587a0bb9d4c805af60777bec31dde32c916
411,39Cb9cNzV3Htm9ULbLDR4bz4gecHxk1nqD,894,564384,564384,1671926581,1671903850,0,inbound,dce8271ff6ca6bacf4f9fd9ff463f587a0bb9d4c805af60777bec31dde32c916
412,bc1q467hv2hxjjwj0g6w9y54rgg7ye7c8x3aeccc22,895,297042,297042,1671906551,1671903850,0,inbound,dce8271ff6ca6bacf4f9fd9ff463f587a0bb9d4c805af60777bec31dde32c916
413,3APhv5A4iByeDufT36GdpgeFb3C7RVn65c,896,1075200,1075200,1672087613,1671903850,0,inbound,dce8271ff6ca6bacf4f9fd9ff463f587a0bb9d4c805af60777bec31dde32c916
414,1AQ8kCNN7XHuGbh37VodFZtj7ubvqMJv2P,897,594088,594088,1671948141,1671903850,0,inbound,dce8271ff6ca6bacf4f9fd9ff463f587a0bb9d4c805af60777bec31dde32c916
415,bc1qhxvja0axpyvuavfpvd02ptahckyjwle4h5gthe,898,5157178,5157178,1681051167,1669408148,0,inbound,dce8271ff6ca6bacf4f9fd9ff463f587a0bb9d4c805af60777bec31dde32c916
416,1FdQwyfaGvoVuWpYBn54ULv8b4C2du1DPv,899,438359,438359,1671930314,1671903850,0,inbound,dce8271ff6ca6bacf4f9fd9ff463f587a0bb9d4c805af60777bec31dde32c916
417,bc1qjk04jhutcq4m79tnf8qdhuf7m7ggep7tp5xsvx,900,3449395,3449395,1671909598,1671903850,0,inbound,dce8271ff6ca6bacf4f9fd9ff463f587a0bb9d4c805af60777bec31dde32c916
418,36X8TbA4QrgUeSaF9HLJr5Au93gEffyZhJ,901,5410000,5410000,1671962326,1671903850,0,inbound,dce8271ff6ca6bacf4f9fd9ff463f587a0bb9d4c805af60777bec31dde32c916
419,3GWy4uSHf549xXXXc7Wv6RzD3ozq9t5aDV,902,588148,588148,1672762344,1671903850,0,inbound,dce8271ff6ca6bacf4f9fd9ff463f587a0bb9d4c805af60777bec31dde32c916
420,3CcApgLoCskgqvH2o9onZ2hHtBJmrFU18a,903,990488,990488,1672762344,1671903850,0,inbound,dce8271ff6ca6bacf4f9fd9ff463f587a0bb9d4c805af60777bec31dde32c916
421,bc1q0td9s30kywqx7dfpmfz7gkal8zmfa3lfku5g7d,904,558308396,558308396,1677351493,1654209538,0,inbound,dce8271ff6ca6bacf4f9fd9ff463f587a0bb9d4c805af60777bec31dde32c916
422,1EThAVv2nT87wfkkF4JmxsHa5sfWDtkfyb,905,845560,845560,1671936439,1671903850,0,inbound,dce8271ff6ca6bacf4f9fd9ff463f587a0bb9d4c805af60777bec31dde32c916
423,3AqmCg7PG1dpgbNuw8MF3qXFUUPLXSzW7g,906,279562,279562,1671926579,1671903850,0,inbound,dce8271ff6ca6bacf4f9fd9ff463f587a0bb9d4c805af60777bec31dde32c916
424,bc1qkpz5w7349pzldzehzlk5v9z37egzsa6p9h04s0,907,1178832,1178832,1671909288,1671903850,0,inbound,dce8271ff6ca6bacf4f9fd9ff463f587a0bb9d4c805af60777bec31dde32c916
425,3Q6fEGZLotXcUZaS349KikKJ9N4sUd3AoX,908,106608,106608,1671926573,1671903850,0,inbound,dce8271ff6ca6bacf4f9fd9ff463f587a0bb9d4c805af60777bec31dde32c916
426,bc1qnz9np8vdpgzqgr08dl5tujtzu9qtqe75aq77ky,1177,58401339,58401339,1672528598,1668704656,0,inbound,dce8271ff6ca6bacf4f9fd9ff463f587a0bb9d4c805af60777bec31dde32c916
427,3HfPWZBLtJ4wUMkE6RU3Rwzqnd6pGKA8xE,1178,11402645,11402645,1674074300,1671407745,0,inbound,dce8271ff6ca6bacf4f9fd9ff463f587a0bb9d4c805af60777bec31dde32c916
428,3GujiGx66k56PWT9AS5S4MGF32Hjp3KQ7W,1179,42141539,41761173,1680184278,1673330579,380366,outbound,dce8271ff6ca6bacf4f9fd9ff463f587a0bb9d4c805af60777bec31dde32c916
429,3C3ZkpCMrtR9vwBtsh75Ppd6tsbUZkAAYR,1180,190647,190647,1671771704,1671752684,0,inbound,dce8271ff6ca6bacf4f9fd9ff463f587a0bb9d4c805af60777bec31dde32c916
430,bc1qwst5wuc4crf5gm8z50402a287guhp62uymyvw0,1181,148959,148959,1671763882,1671752684,0,inbound,dce8271ff6ca6bacf4f9fd9ff463f587a0bb9d4c805af60777bec31dde32c916
431,3Lsa34gt3MXdTpMvZMupEdcL245g4A2kH4,1182,10181905,9337823,1681115137,1677061435,844082,inbound,dce8271ff6ca6bacf4f9fd9ff463f587a0bb9d4c805af60777bec31dde32c916
432,1ErhSzg1ncmUJmvveLDgKqz7eCpDtDN3xZ,1183,74401,74401,1675370831,1671752684,0,inbound,dce8271ff6ca6bacf4f9fd9ff463f587a0bb9d4c805af60777bec31dde32c916
433,bc1q4llcjqg7l568d4hnf2njr8ulmmq2nv8mc92zge,1184,3370279,3370279,1672358981,1671267571,0,inbound,dce8271ff6ca6bacf4f9fd9ff463f587a0bb9d4c805af60777bec31dde32c916
434,3FXMRML8QkeMyJWePaQpMApVEUtFQVHWch,1185,33401,33401,1671775429,1671752684,0,inbound,dce8271ff6ca6bacf4f9fd9ff463f587a0bb9d4c805af60777bec31dde32c916
435,bc1q5ptn6dz9sjfkcs54xq5krp53nqaqyn9ju6vc2r,1186,686520,686520,1671754242,1671752684,0,inbound,dce8271ff6ca6bacf4f9fd9ff463f587a0bb9d4c805af60777bec31dde32c916
436,bc1qu3j2l94tyzccafeptwfznrhc0lpj05pydca6gd,1187,2152532,2152532,1673298942,1668443948,0,inbound,dce8271ff6ca6bacf4f9fd9ff463f587a0bb9d4c805af60777bec31dde32c916
437,3AwigfVxfoZThcbcWyBcjXr9cy6gpA5EVi,1188,306937,306937,1672133412,1671752684,0,inbound,dce8271ff6ca6bacf4f9fd9ff463f587a0bb9d4c805af60777bec31dde32c916
438,1nrjqCfhGtXAE5zqr9QWyKc56FbyxLxhK,1189,1756601392,1755656909,1681125652,1674090123,944483,inbound,dce8271ff6ca6bacf4f9fd9ff463f587a0bb9d4c805af60777bec31dde32c916
439,36o5fsxSLsz2XTK3HqmqkXbiprVENirLNQ,1190,47177097,45007642,1681115158,1678652192,2169455,outbound,dce8271ff6ca6bacf4f9fd9ff463f587a0bb9d4c805af60777bec31dde32c916
440,bc1qm8ug5l22phd2ez3j38h64n533de6n6dt6s9l4z24kvz29zx6crts0gzwjr,1191,64084859,64084859,1680564657,1672950918,0,outbound,dce8271ff6ca6bacf4f9fd9ff463f587a0bb9d4c805af60777bec31dde32c916
441,3Jbnpb8BSe72BWiXHoBYQCCL6qiY4oj9VW,1192,7456014,7028880,1681091851,1654181268,427134,inbound,dce8271ff6ca6bacf4f9fd9ff463f587a0bb9d4c805af60777bec31dde32c916
442,1PyRJZYzedqEVUhnHgVFWyf55o3N4noqH3,1193,2701968988,2692158058,1681082881,1678723318,9810930,outbound,dce8271ff6ca6bacf4f9fd9ff463f587a0bb9d4c805af60777bec31dde32c916
443,bc1qac02x6qz8zhcazuezqcn77hjprxauk8xdzfljn,1194,318764,318764,1671800302,1671752684,0,inbound,dce8271ff6ca6bacf4f9fd9ff463f587a0bb9d4c805af60777bec31dde32c916
444,1GtYdaYUWBg87RCBoSMXPsSdmNrYnECE7x,1195,5827525,5827525,1671754197,1671752684,0,inbound,dce8271ff6ca6bacf4f9fd9ff463f587a0bb9d4c805af60777bec31dde32c916
445,3ATbSXvBZudgGfZenNm4YDN9qxXyBZBCBh,1196,5945000,5945000,1671755454,1671752684,0,inbound,dce8271ff6ca6bacf4f9fd9ff463f587a0bb9d4c805af60777bec31dde32c916
446,3Cg29L8o6xsfYsCbHe4wY8yeCc73pLPYva,1197,588562,588562,1671764380,1671752684,0,inbound,dce8271ff6ca6bacf4f9fd9ff463f587a0bb9d4c805af60777bec31dde32c916
447,bc1q8ux5klujkgytrjeq92uasxz2latf8jsw9qfc9x,1198,1648329959,1648329959,1678980970,1677537051,0,inbound,dce8271ff6ca6bacf4f9fd9ff463f587a0bb9d4c805af60777bec31dde32c916
448,bc1qm6p3r0w5r3z3nuagu7c8tnhkfty4l4ejcz8g4w,1199,6950587,6950587,1680142536,1664470460,0,inbound,dce8271ff6ca6bacf4f9fd9ff463f587a0bb9d4c805af60777bec31dde32c916
449,bc1qmsyh42nwpuyv6rdesk08kxd8uea3gfyy2yeval,1200,689827327,689827327,1681105050,1672778593,0,outbound,dce8271ff6ca6bacf4f9fd9ff463f587a0bb9d4c805af60777bec31dde32c916
450,bc1q3sskfakyqlhamcdllu7dcx8fmw3rnrhr0rew64,1201,142873,142873,1671718103,1671716527,0,inbound,dce8271ff6ca6bacf4f9fd9ff463f587a0bb9d4c805af60777bec31dde32c916
451,1KY5NQnWxQug8VG25dokvN65hUtEc2SoDz,1202,85019920,85019920,1671746529,1653580954,0,outbound,dce8271ff6ca6bacf4f9fd9ff463f587a0bb9d4c805af60777bec31dde32c916
452,3J5TLgM7VakMcS23VA8cCJCVX2LbvBirrQ,1203,6037636,6027444,1677215448,1660209005,10192,inbound,dce8271ff6ca6bacf4f9fd9ff463f587a0bb9d4c805af60777bec31dde32c916
453,3KGmzcogPqdXWkHkpJFqYU8yepkQHp8oev,1204,4753277,4753277,1672305998,1671716527,0,inbound,dce8271ff6ca6bacf4f9fd9ff463f587a0bb9d4c805af60777bec31dde32c916
454,1NJrsnPrGU2mvT7mMukPUspC8CbW42W2ni,1205,740369,740369,1674068874,1671716527,0,inbound,dce8271ff6ca6bacf4f9fd9ff463f587a0bb9d4c805af60777bec31dde32c916
455,381JhcUGyweLJ6p8PMEyL2x9VFa696d8CY,1206,47663284,46389424,1680993480,1595574525,1273860,inbound,dce8271ff6ca6bacf4f9fd9ff463f587a0bb9d4c805af60777bec31dde32c916
456,bc1qcq2lzsmznh6hjqk8fegvvmnzefygfrtfms4shw,1207,243068098,243068098,1671803960,1667032269,0,outbound,dce8271ff6ca6bacf4f9fd9ff463f587a0bb9d4c805af60777bec31dde32c916
457,bc1qn8rv33csr4ftrtxnc6z3l5r5t2a74mjygnp578,1208,4877707,0,1671716527,1671715326,4877707,inbound,dce8271ff6ca6bacf4f9fd9ff463f587a0bb9d4c805af60777bec31dde32c916
458,35R4aTpP9KM8aYsPEMKPqVWKDUGWJv6VUA,1209,892497,892497,1672368027,1671716527,0,inbound,dce8271ff6ca6bacf4f9fd9ff463f587a0bb9d4c805af60777bec31dde32c916
459,3HSN6hdpU5NfbZRmRzc4cjALMsPsVZV1TT,1210,565265,565265,1672673690,1671716527,0,inbound,dce8271ff6ca6bacf4f9fd9ff463f587a0bb9d4c805af60777bec31dde32c916
460,37HP12EpNqs6BNr6HATpX3aEbvQRPXGqnM,1664,531000,531000,1670856922,1670831806,0,inbound,dce8271ff6ca6bacf4f9fd9ff463f587a0bb9d4c805af60777bec31dde32c916
461,3LBsdG9dd1hXL9f2SV4W7HaFs3FGE3MLyR,1665,1070190,1070190,1672181102,1670831806,0,inbound,dce8271ff6ca6bacf4f9fd9ff463f587a0bb9d4c805af60777bec31dde32c916
462,3AM9bSLqH8iX2uun7ugonJF7NSnvAzmdrb,1666,17541180103,15951341724,1680613700,1674649500,1589838379,inbound,dce8271ff6ca6bacf4f9fd9ff463f587a0bb9d4c805af60777bec31dde32c916
463,bc1qcpd2suezau99lndzhw5zrtm79swcz7a4sv8nhu,1667,3304154,0,1670831806,1642153883,3304154,inbound,dce8271ff6ca6bacf4f9fd9ff463f587a0bb9d4c805af60777bec31dde32c916
464,bc1qzxmckkatyacqmdz2q8x2yqknet3gcn725hnzlt,1668,2892840,2892840,1670835374,1670831806,0,inbound,dce8271ff6ca6bacf4f9fd9ff463f587a0bb9d4c805af60777bec31dde32c916
465,bc1q0tk6sd5gnyzmjzfqdhh40m4yvjzt4upkyzaacl,1669,56974000,56974000,1673790902,1670831806,0,inbound,dce8271ff6ca6bacf4f9fd9ff463f587a0bb9d4c805af60777bec31dde32c916
466,bc1qhrsejxv6qgk90qfyrg4m5wm2sqmdxjmv45g6s4,1670,1770700,1770700,1670839439,1670831806,0,inbound,dce8271ff6ca6bacf4f9fd9ff463f587a0bb9d4c805af60777bec31dde32c916
467,bc1q8h5w9qqgq9p0qcx9sl0eqmrf9yjskxmfxynf3v,1671,80046815272,80046815272,1675281081,1673600558,0,inbound,dce8271ff6ca6bacf4f9fd9ff463f587a0bb9d4c805af60777bec31dde32c916
468,3FuQiYWUBL1zcJQZMs6d1DutPW6rcoDS9A,1672,528039,528039,1670839242,1670831806,0,inbound,dce8271ff6ca6bacf4f9fd9ff463f587a0bb9d4c805af60777bec31dde32c916
469,bc1q4ehg2egdqs5xydxwzfky2ks0pk2xawsj72q7wg,1673,58229013,58229013,1679146794,1652965831,0,inbound,dce8271ff6ca6bacf4f9fd9ff463f587a0bb9d4c805af60777bec31dde32c916
470,3J5tFSkyRdweq7u6oUnfYnphk732DHaBo5,1674,160000,160000,1670864252,1670831806,0,inbound,dce8271ff6ca6bacf4f9fd9ff463f587a0bb9d4c805af60777bec31dde32c916
471,bc1qd5envt5uesmpeggeffg4rz84vqn6vg3zx3l9e5,1675,1542320,1542320,1671001923,1669398793,0,inbound,dce8271ff6ca6bacf4f9fd9ff463f587a0bb9d4c805af60777bec31dde32c916
472,bc1qpvst4zh3j6wsqls7pu5r0fp358pcgyjumnefkj,1676,1211139676,1211139676,1680253662,1647865665,0,outbound,dce8271ff6ca6bacf4f9fd9ff463f587a0bb9d4c805af60777bec31dde32c916
473,bc1qgte9u96fxfxn0m3nv4wv23ndqtymhnja2tsnsu,1677,53000000,0,1671393890,1669289848,53000000,inbound,dce8271ff6ca6bacf4f9fd9ff463f587a0bb9d4c805af60777bec31dde32c916
474,bc1qwtynlgvgar7fq3caraskrmtz063ek8h6dv4qq2,1678,12964900,0,1670917132,1670831806,12964900,inbound,dce8271ff6ca6bacf4f9fd9ff463f587a0bb9d4c805af60777bec31dde32c916
475,bc1qrf6st29e7ykrfqhm52wkr23ufuzxyqlt2g2e5c,1679,89253,89253,1671007364,1670831806,0,inbound,dce8271ff6ca6bacf4f9fd9ff463f587a0bb9d4c805af60777bec31dde32c916
476,bc1qktzv8z229jtl84j65trk0th4pyquaguuepuw94,1680,168785817,168785817,1674561164,1669879965,0,inbound,dce8271ff6ca6bacf4f9fd9ff463f587a0bb9d4c805af60777bec31dde32c916
477,3HCdHKBffY9xtbYdhjNkKcvAbzUhvrcWoJ,1681,29230806,29230806,1670859489,1661751041,0,inbound,dce8271ff6ca6bacf4f9fd9ff463f587a0bb9d4c805af60777bec31dde32c916
478,3Ftpg1TtYBjHqWd8YyLJ7At3UyWtDUghb4,1682,14773000,14773000,1670932070,1670831806,0,inbound,dce8271ff6ca6bacf4f9fd9ff463f587a0bb9d4c805af60777bec31dde32c916
479,bc1qfwa9p02g037vsyx340ycv2puwlrzfwzfawpvvn,1683,9286928,9286928,1673625947,1670781998,0,inbound,dce8271ff6ca6bacf4f9fd9ff463f587a0bb9d4c805af60777bec31dde32c916
480,1AKvWmu9dZDgUw4rbuRgjor3SWfSWuxbyJ,1684,2720685844,2720685844,1670768652,1499428599,0,inbound,dce8271ff6ca6bacf4f9fd9ff463f587a0bb9d4c805af60777bec31dde32c916
481,bc1q7kezx9euxgs5qre7uruakr88suul7hlmsjttac,1685,15005704,12507864,1680769268,1614910150,2497840,inbound,dce8271ff6ca6bacf4f9fd9ff463f587a0bb9d4c805af60777bec31dde32c916
482,39AyPYWFPVW8rFmrKRCvc9ip5gZfPBBLvU,1686,500000,500000,1670785382,1670762209,0,inbound,dce8271ff6ca6bacf4f9fd9ff463f587a0bb9d4c805af60777bec31dde32c916
483,bc1qnfw3wt848tenf3eagz9lspj5c4e5vp3gtn3yxa,1687,3775329,3775329,1670768067,1670762209,0,inbound,dce8271ff6ca6bacf4f9fd9ff463f587a0bb9d4c805af60777bec31dde32c916
484,bc1q6tv7kkhs5dv655grhm7u29pnnw6ssar3fn22wq,1688,2059000,0,1670762209,1670762209,2059000,inbound,dce8271ff6ca6bacf4f9fd9ff463f587a0bb9d4c805af60777bec31dde32c916
485,1KH4HT1H2r67jXEnMeL2dmZqBWY6GtXPtR,1689,24123000,24123000,1673518757,1670762209,0,inbound,dce8271ff6ca6bacf4f9fd9ff463f587a0bb9d4c805af60777bec31dde32c916
486,38BQTNLSD3dBAnHsMUycH2nKqXeZjxepbZ,1690,12000000,12000000,1670764216,1670762209,0,inbound,dce8271ff6ca6bacf4f9fd9ff463f587a0bb9d4c805af60777bec31dde32c916
487,3Ey7kXr2hnMqMxY1VVvvS9bK4SccUY95Fw,1691,5463131,5463131,1676475737,1658665315,0,inbound,dce8271ff6ca6bacf4f9fd9ff463f587a0bb9d4c805af60777bec31dde32c916
488,12EccDyV2613966gjhjDhBj9S7fa8vxGwA,1692,17074283,17074283,1671010077,1670762209,0,inbound,dce8271ff6ca6bacf4f9fd9ff463f587a0bb9d4c805af60777bec31dde32c916
489,12mL3txpFGWC9GCfi6Eti7h1igdSWNoAr7,1693,12322350780,12322350780,1679985112,1622093710,0,inbound,dce8271ff6ca6bacf4f9fd9ff463f587a0bb9d4c805af60777bec31dde32c916
490,bc1quuadr9s7jw82fexup2t7q035eyts45cj0c96x0,1694,2805258,2805258,1672246360,1670762209,0,inbound,dce8271ff6ca6bacf4f9fd9ff463f587a0bb9d4c805af60777bec31dde32c916
491,bc1qsj6cg45chn03hp4a8qakz9p0n35wzpslg706xc,1695,130056902,130056902,1681120591,1673202647,0,outbound,dce8271ff6ca6bacf4f9fd9ff463f587a0bb9d4c805af60777bec31dde32c916
492,bc1q5vzxj23mff8w6ls2ne2xt2ngu3pq298tgcajqd,1696,113322,113322,1670765376,1670762209,0,inbound,dce8271ff6ca6bacf4f9fd9ff463f587a0bb9d4c805af60777bec31dde32c916
493,3Avcmqt7z4KiYwrbc42W8NuBtFUVC7dBmt,1697,130321670,123347273,1681131038,1673012077,6974397,inbound,dce8271ff6ca6bacf4f9fd9ff463f587a0bb9d4c805af60777bec31dde32c916
494,bc1qtxuw64c2un3vede7h8m6ml2z7a34uzdg2zws5d,47,26465841,26465841,1680220854,1676138459,0,outbound,4382bb696d0c4d5b2cc151661aec535ee417ca0db7a817683fff8539b29fc457
495,bc1qpml20mpcdjz6n5ewgdgl5fv3m8jjnatcd8tp3g,48,4108528,0,1675180570,1675180570,4108528,inbound,4382bb696d0c4d5b2cc151661aec535ee417ca0db7a817683fff8539b29fc457
496,1NP5gYk3f69yzj4YZY58TTkpjFaGvFWUZm,49,134072,134072,1675186215,1675180570,0,inbound,4382bb696d0c4d5b2cc151661aec535ee417ca0db7a817683fff8539b29fc457
497,332oNcNS6iAvPQ2FDFgsQdVUpM8RSKCK4m,50,498898,498898,1675203455,1675180570,0,inbound,4382bb696d0c4d5b2cc151661aec535ee417ca0db7a817683fff8539b29fc457
498,bc1qug7v5v0rt8hr6gs7pu39ems64q3wgqcsk77u3f,51,16433,16433,1675521114,1675180570,0,inbound,4382bb696d0c4d5b2cc151661aec535ee417ca0db7a817683fff8539b29fc457
499,3L1fJcyxSoHpR8Ae8LC65vhqTw8XnyTLXa,52,212545192,212545192,1680980595,1672022234,0,outbound,4382bb696d0c4d5b2cc151661aec535ee417ca0db7a817683fff8539b29fc457
500,bc1qygs8jva8n0vuzpqnvwjxmylv97xn5xyqpjkag4,53,2714925139,2702736961,1681025874,1678780017,12188178,inbound,4382bb696d0c4d5b2cc151661aec535ee417ca0db7a817683fff8539b29fc457
501,3DLqtjtAxjNeENp6fTRQ4MbkdcDpT4sayC,54,86487,0,1675180570,1675180570,86487,inbound,4382bb696d0c4d5b2cc151661aec535ee417ca0db7a817683fff8539b29fc457
502,bc1qjvmq60d78tjxvprezyzf4mkv8xg7jdu795xwjl,55,1297302,0,1675180570,1675180570,1297302,inbound,4382bb696d0c4d5b2cc151661aec535ee417ca0db7a817683fff8539b29fc457
503,bc1q2lh2ufhfm2sg5ej5mn6faaj2cajlhglts29wt2,56,605487,605487,1675697438,1675180570,0,inbound,4382bb696d0c4d5b2cc151661aec535ee417ca0db7a817683fff8539b29fc457
504,3K3zKBMSWD2CnTW1FdzQN98PrKmuRPEMEm,57,2873751,2873751,1675181718,1675180570,0,inbound,4382bb696d0c4d5b2cc151661aec535ee417ca0db7a817683fff8539b29fc457
505,bc1qapm6f5v0zxhn6aewqq8jyvhyd8cp67r4nlfm08,58,10766,10766,1675183104,1675180570,0,inbound,4382bb696d0c4d5b2cc151661aec535ee417ca0db7a817683fff8539b29fc457
506,345tFXxMrPE6fPBGzaDtVcymDv8wM9pTtz,59,159602124,157732070,1681048779,1680206296,1870054,inbound,4382bb696d0c4d5b2cc151661aec535ee417ca0db7a817683fff8539b29fc457
507,3Muxe3LktuotCx4zd2X4sea1QmXb2JLL3k,60,128909,128909,1675188150,1675180570,0,inbound,4382bb696d0c4d5b2cc151661aec535ee417ca0db7a817683fff8539b29fc457
508,3Ny74UX4Pp77GMp4X2HC7gbYa2Kakcr2Zj,61,8390994,8390994,1677542839,1672786746,0,inbound,4382bb696d0c4d5b2cc151661aec535ee417ca0db7a817683fff8539b29fc457
509,bc1qqw8t96lq7uyqtqrd9wj56k3zhyf5apt5v0c5kw,62,203444,0,1675180570,1675180570,203444,inbound,4382bb696d0c4d5b2cc151661aec535ee417ca0db7a817683fff8539b29fc457
510,bc1q8auuz2e0h8z0dc0yvh8scummrt34pspmqn3s0e,63,127228,127228,1675183104,1675180570,0,inbound,4382bb696d0c4d5b2cc151661aec535ee417ca0db7a817683fff8539b29fc457
511,3Nv3VpD5FaTLm3P96eMGoGAu3MVzbbcPkz,64,532498,532498,1675188144,1675180570,0,inbound,4382bb696d0c4d5b2cc151661aec535ee417ca0db7a817683fff8539b29fc457
512,bc1q4al9zcsxs63c94su62rggpyg4ylnn6ssv0ktqv,65,2472122,2472122,1675443440,1675180570,0,inbound,4382bb696d0c4d5b2cc151661aec535ee417ca0db7a817683fff8539b29fc457
513,bc1q9fzf5kpweap8wsga6vhy2778pdalcg08p4ttz5,66,22322105,22311619,1679415157,1669564567,10486,inbound,4382bb696d0c4d5b2cc151661aec535ee417ca0db7a817683fff8539b29fc457
514,16kQzsA4LA1HMZYj5qaTg7ktJFxSfv2gCP,67,726059,726059,1675238475,1675180570,0,inbound,4382bb696d0c4d5b2cc151661aec535ee417ca0db7a817683fff8539b29fc457
515,bc1qv3neyh0q8flyay05wvt3m580m0lveqg4yp2lag,68,1041033,1041033,1675736676,1675180570,0,inbound,4382bb696d0c4d5b2cc151661aec535ee417ca0db7a817683fff8539b29fc457
516,3JAJRf94bmDUabcWCCDvyiTMTRRGrgxRTL,69,1288800,1253614,1677115860,1675180569,35186,inbound,4382bb696d0c4d5b2cc151661aec535ee417ca0db7a817683fff8539b29fc457
517,bc1q42ykgd47avgmp6eczs4ug0qxurln94y7933qdl,70,30581803,30581803,1678736404,1620514027,0,inbound,4382bb696d0c4d5b2cc151661aec535ee417ca0db7a817683fff8539b29fc457
518,3Cyx4DGBKZysAvn2rbdvV3URxS9P1ZcgZh,71,478701086,478701086,1680823403,1674390158,0,inbound,4382bb696d0c4d5b2cc151661aec535ee417ca0db7a817683fff8539b29fc457
519,bc1qz70ftx7vfjsj58029dqwqgs7ez62d35ln6r7vc,72,406394,406394,1675681786,1675180570,0,inbound,4382bb696d0c4d5b2cc151661aec535ee417ca0db7a817683fff8539b29fc457
520,bc1qrhlzuvdg6e9ru3wua07sxh9pegnecjh3rvvrq5,73,4384186,4384186,1675821602,1675180570,0,inbound,4382bb696d0c4d5b2cc151661aec535ee417ca0db7a817683fff8539b29fc457
521,bc1qxesg5u5mqlknhn2r5rl2l9ajfsxqcre3c89fnc,74,8756806,8756806,1675181672,1675180569,0,inbound,4382bb696d0c4d5b2cc151661aec535ee417ca0db7a817683fff8539b29fc457
522,3K4Cy12tPKu4gbRHgMsdHBv8HSDMuATpFz,75,577073,577073,1675293866,1675180570,0,inbound,4382bb696d0c4d5b2cc151661aec535ee417ca0db7a817683fff8539b29fc457
523,3JEeur8txUkKZEiZnC5RrEXozeXinnXmoR,76,70993606,70993606,1680847741,1671769147,0,inbound,4382bb696d0c4d5b2cc151661aec535ee417ca0db7a817683fff8539b29fc457
524,bc1qmes5q05hna5wya8d2yvt6f2dvqlljgd2en545wlckgtc4wsjvykqlugjsk,77,259461,259461,1675360840,1675180569,0,inbound,4382bb696d0c4d5b2cc151661aec535ee417ca0db7a817683fff8539b29fc457
525,3HuGeyk1wi2yRGTwgNNDP37BvZ8CsWJScv,78,108109,108109,1675380625,1675180570,0,inbound,4382bb696d0c4d5b2cc151661aec535ee417ca0db7a817683fff8539b29fc457
526,1CnwV9Lggs9RfjDbasQX86yzzVENnj7gAv,79,43225,43225,1675991115,1675180570,0,inbound,4382bb696d0c4d5b2cc151661aec535ee417ca0db7a817683fff8539b29fc457
527,39HEYbTjXnRVmVAatX7qX28T6yB1GZAQQG,80,440785,440785,1675857741,1675180570,0,inbound,4382bb696d0c4d5b2cc151661aec535ee417ca0db7a817683fff8539b29fc457
528,12iMDCaP4gmAsvtTtV22Q99P11D9yKCMi5,81,349400,349400,1675339326,1675180570,0,inbound,4382bb696d0c4d5b2cc151661aec535ee417ca0db7a817683fff8539b29fc457
529,1DrMupA9bZ5rdcGwqd2JtbwExqZGuxqHoe,82,33138086,33121221,1680083411,1671041471,16865,inbound,4382bb696d0c4d5b2cc151661aec535ee417ca0db7a817683fff8539b29fc457
530,bc1qaw2q6pnxrpyk8lhjj83gedua554y5rzuwecr34,83,1542200,1542200,1675180895,1658968738,0,inbound,4382bb696d0c4d5b2cc151661aec535ee417ca0db7a817683fff8539b29fc457
531,1Aku6TqkKo2t4PDyB82Ns7tw7mvGZc8wG,84,16165584,16146268,1680657944,1675437609,19316,inbound,4382bb696d0c4d5b2cc151661aec535ee417ca0db7a817683fff8539b29fc457
532,bc1qh8y0m4spx3hdns47rwp0hgc8j05h2dt2fg6d7q,85,44298844,44298844,1674940598,1674938973,0,inbound,4382bb696d0c4d5b2cc151661aec535ee417ca0db7a817683fff8539b29fc457
533,1677RB9wD9BTNttXF2uLucd13EVQGZCydN,196,143636,143636,1672878313,1672860877,0,inbound,4382bb696d0c4d5b2cc151661aec535ee417ca0db7a817683fff8539b29fc457
534,37zto23feNRTAQaHaHs2eoFuJNXGDdvHFK,197,8204018,8024497,1679355911,1662406244,179521,outbound,4382bb696d0c4d5b2cc151661aec535ee417ca0db7a817683fff8539b29fc457
535,bc1q5xk4g82fhltmju7yyht3pvwdwj50em9mnegvzt,198,147852914,147852914,1675848220,1672860877,0,inbound,4382bb696d0c4d5b2cc151661aec535ee417ca0db7a817683fff8539b29fc457
536,bc1qt2a57jskrfufmvpa7q8zq8gc6eksmakyhwr5g8,199,104174492,104174492,1674348744,1672498458,0,inbound,4382bb696d0c4d5b2cc151661aec535ee417ca0db7a817683fff8539b29fc457
537,3CYev9ry1RvYP2ZnFbCPseaY8dhWA4ivbJ,200,15032,15032,1672850877,1672777743,0,inbound,4382bb696d0c4d5b2cc151661aec535ee417ca0db7a817683fff8539b29fc457
538,3HuSXjCL7bNyY2dAQmexdyUf68B3ppE6dN,201,105001,105001,1673010054,1672777743,0,inbound,4382bb696d0c4d5b2cc151661aec535ee417ca0db7a817683fff8539b29fc457
539,1MtEFovN6D6ZEXGfgMN7JdQzQV6NMeHAU3,202,506545,356372,1672777743,1671209940,150173,inbound,4382bb696d0c4d5b2cc151661aec535ee417ca0db7a817683fff8539b29fc457
540,1NmQfBcLnWrve7A2eQf214ToydjxZ3GBWM,203,6658471,6658471,1677623083,1666728094,0,inbound,4382bb696d0c4d5b2cc151661aec535ee417ca0db7a817683fff8539b29fc457
541,34nwR6ERVXPJh6e3RtcxMXWeZhDo9JUfhn,204,1465105,1465105,1672845130,1672777743,0,inbound,4382bb696d0c4d5b2cc151661aec535ee417ca0db7a817683fff8539b29fc457
542,bc1q63jqw5z7ekgdvksw2f3fpfjlly5d5j3vhuyq6c,205,281351772,281351772,1676180353,1674795631,0,outbound,4382bb696d0c4d5b2cc151661aec535ee417ca0db7a817683fff8539b29fc457
543,32CtQ3Ym9ArsAgJ1dBDkTkgBo9tXa3g7UM,206,3871802,3871802,1674403043,1672777743,0,inbound,4382bb696d0c4d5b2cc151661aec535ee417ca0db7a817683fff8539b29fc457
544,bc1q726l7gm3dvhye767gxwhyr3mc34q9vqexpkqd2,207,88279184,88279184,1674851831,1668446431,0,inbound,4382bb696d0c4d5b2cc151661aec535ee417ca0db7a817683fff8539b29fc457
545,bc1qvud29czn9zalr5wc9qkwt8zwfy3c2zv4pc0y6ctc7kn5wr7seevqkwsc9q,208,13152942,13152942,1672790233,1672777743,0,inbound,4382bb696d0c4d5b2cc151661aec535ee417ca0db7a817683fff8539b29fc457
546,3PAhwcbdkecirh7RCDCS8DxMy4XSieCfEv,209,14572745,14572745,1672798162,1672777743,0,inbound,4382bb696d0c4d5b2cc151661aec535ee417ca0db7a817683fff8539b29fc457
547,bc1qslp2q98lnjy58275xfrqhlmsglyz4t4vjfaw9l,210,142033564,142033564,1679502816,1668427646,0,inbound,4382bb696d0c4d5b2cc151661aec535ee417ca0db7a817683fff8539b29fc457
548,3BNzxuKCcx6HU7VJKEi3CQh9jzxgnfTc9U,211,666596,666596,1673352792,1672758368,0,inbound,4382bb696d0c4d5b2cc151661aec535ee417ca0db7a817683fff8539b29fc457
549,3JZxT9syHDJEpXoZwnUyTQCASo7H9cNzpR,212,143862,143862,1672765364,1672763951,0,inbound,4382bb696d0c4d5b2cc151661aec535ee417ca0db7a817683fff8539b29fc457
550,bc1qd8dwzy3zg0fgf5eh7fmyvnpxpzxjmazc2y52z0,213,36065,36065,1672793789,1672763951,0,inbound,4382bb696d0c4d5b2cc151661aec535ee417ca0db7a817683fff8539b29fc457
551,33QS8u9Y7xAmzf6Ke4cdDsPJypzHHqL8FR,214,14873473,14873473,1677524430,1635010448,0,inbound,4382bb696d0c4d5b2cc151661aec535ee417ca0db7a817683fff8539b29fc457
552,3HkFe5Ad9oQzjdF6h3EqRbwjz3q4egcF3G,215,35753022,35753022,1680525367,1672319791,0,inbound,4382bb696d0c4d5b2cc151661aec535ee417ca0db7a817683fff8539b29fc457
553,3QKft4sMae86svSreyzSmwvXYUXcwwmLQt,216,195692,195692,1672769029,1672763951,0,inbound,4382bb696d0c4d5b2cc151661aec535ee417ca0db7a817683fff8539b29fc457
554,12mdh9Fr2XtdeHuVcPmrNyq5ZcTGWyunPe,217,73743,73743,1673241137,1672763949,0,inbound,4382bb696d0c4d5b2cc151661aec535ee417ca0db7a817683fff8539b29fc457
555,bc1q57caklcalylmrlpd9xxnj9glfkgk2jj2kwh689,218,29089,29089,1672778646,1672763949,0,inbound,4382bb696d0c4d5b2cc151661aec535ee417ca0db7a817683fff8539b29fc457
556,bc1qyt4ztg3smpfw9jq98knyzqz4dcmrffnv45ev78,219,8121529,3143623,1679773688,1668690730,4977906,inbound,4382bb696d0c4d5b2cc151661aec535ee417ca0db7a817683fff8539b29fc457
557,3MetsAdfwkKc8Crm9Urp675BiFTnSoh4pY,220,61379934,61310868,1681051699,1675104535,69066,outbound,4382bb696d0c4d5b2cc151661aec535ee417ca0db7a817683fff8539b29fc457
558,1QJ6nBwgJRAKT2txy1ufe67EaW9MYK2Lsx,221,857468,857468,1672766234,1672763949,0,inbound,4382bb696d0c4d5b2cc151661aec535ee417ca0db7a817683fff8539b29fc457
559,bc1qcf32n3p30mmwlg4ztyp4gjm39slrgjtcm42hrn,222,54063,54063,1673006695,1672763949,0,inbound,4382bb696d0c4d5b2cc151661aec535ee417ca0db7a817683fff8539b29fc457
560,38ZGowSgBvfcGCimp9LofBJvRLp6F9oMkj,351,8329000,8329000,1672417557,1672414729,0,inbound,4382bb696d0c4d5b2cc151661aec535ee417ca0db7a817683fff8539b29fc457
561,3K5CgxgDSTx2z7c4DsZxpFoDNULhEoBEzN,352,36479800,36479800,1679899024,1577380953,0,outbound,4382bb696d0c4d5b2cc151661aec535ee417ca0db7a817683fff8539b29fc457
562,3BipLjRHCB29KhxMDpCx2ZqXgAG2vijAC3,353,1847838,1847838,1672511276,1672147009,0,inbound,4382bb696d0c4d5b2cc151661aec535ee417ca0db7a817683fff8539b29fc457
563,bc1qr3gld8sv2zaxn5yxpd3danndjj4r0d5mrfn20p,354,90063743,90063743,1672827983,1672414729,0,inbound,4382bb696d0c4d5b2cc151661aec535ee417ca0db7a817683fff8539b29fc457
564,bc1q3jj6vydet76nf0t4sx0k068rl4p57zcg4lxhce,355,3458774,3458774,1672420816,1672414729,0,inbound,4382bb696d0c4d5b2cc151661aec535ee417ca0db7a817683fff8539b29fc457
565,3NDQwo4x4o61Kdvmzu42mtPgGSwdjir7jt,356,11389465,11389465,1672423016,1618467331,0,inbound,4382bb696d0c4d5b2cc151661aec535ee417ca0db7a817683fff8539b29fc457
566,39cA9kVouBKHU97B1GEPhheZoZkqBSVwSA,357,14941000,14941000,1672416267,1672414729,0,inbound,4382bb696d0c4d5b2cc151661aec535ee417ca0db7a817683fff8539b29fc457
567,3AYvnGndy4JQ6qZgEjhsHTe2qSgSUCVjEu,358,893280,893280,1673804313,1648894088,0,inbound,4382bb696d0c4d5b2cc151661aec535ee417ca0db7a817683fff8539b29fc457
568,38m9dfL26Tx1nkxswH1yTCtvPPHBxAPqu9,359,232045,232045,1672555507,1672414729,0,inbound,4382bb696d0c4d5b2cc151661aec535ee417ca0db7a817683fff8539b29fc457
569,bc1qfzltmvecf5rlv3wpg0kyqyvwzzvgtymxzqwpfk,360,1000000,0,1672414729,1672414729,1000000,inbound,4382bb696d0c4d5b2cc151661aec535ee417ca0db7a817683fff8539b29fc457
570,39u6QmrxdoNVsJS9KUgdFx7pKpk5cMmidu,361,1432991,1432991,1673584390,1672360965,0,inbound,4382bb696d0c4d5b2cc151661aec535ee417ca0db7a817683fff8539b29fc457
571,bc1qssxk6x42prqv7jk50ehytnfpzln25rgm6krfh9,362,66598600,66598600,1672569377,1672414729,0,inbound,4382bb696d0c4d5b2cc151661aec535ee417ca0db7a817683fff8539b29fc457
572,bc1q6sr56036vcakylkxkqty7pl0gkyzl3c08jp4gg,363,49122478,49122478,1680486717,1668578691,0,inbound,4382bb696d0c4d5b2cc151661aec535ee417ca0db7a817683fff8539b29fc457
573,bc1qmvzqzc0x5cd77n6ev3l42sk2g59a6rwpvjyku9,364,873337,0,1672414729,1672414729,873337,inbound,4382bb696d0c4d5b2cc151661aec535ee417ca0db7a817683fff8539b29fc457
574,345gdVwEQA5CDAgEPBo1uuHRhwCSvtRiFk,365,174835,174835,1672435867,1672414729,0,inbound,4382bb696d0c4d5b2cc151661aec535ee417ca0db7a817683fff8539b29fc457
575,3KaTjdfyezBSjgkowxoDpnEoKyCgA4bxrc,366,21612721,0,1672414729,1611644983,21612721,inbound,4382bb696d0c4d5b2cc151661aec535ee417ca0db7a817683fff8539b29fc457
576,bc1qmxpfwuvkl85mhx5pe9n7mk9c79f8g52wvhjh6p,367,747998,0,1672414729,1672414729,747998,inbound,4382bb696d0c4d5b2cc151661aec535ee417ca0db7a817683fff8539b29fc457
577,bc1qcr2233yw3v3ughptk87vj5nlaq8jl275c7l9n2,368,625405,0,1672414729,1672414729,625405,inbound,4382bb696d0c4d5b2cc151661aec535ee417ca0db7a817683fff8539b29fc457
578,bc1qw944wxklw82antz84gvwt432qar0mf896fmu02,369,226136096,226136096,1677936747,1642627151,0,inbound,4382bb696d0c4d5b2cc151661aec535ee417ca0db7a817683fff8539b29fc457
579,37uyDCPhRqZ9NzT43xcowvtKz2CQrU1bEt,370,22709394,22709394,1672465383,1672414729,0,inbound,4382bb696d0c4d5b2cc151661aec535ee417ca0db7a817683fff8539b29fc457
580,bc1q39fkl8qcwstv0z25sp4urmzk62zuat9z92dr76,371,23459993,23459993,1678995326,1663257883,0,inbound,4382bb696d0c4d5b2cc151661aec535ee417ca0db7a817683fff8539b29fc457
581,3KhkLtREwGGYikVMNWNV8YATPkobJ8eFeK,372,119491819,117720309,1680607958,1617340674,1771510,inbound,4382bb696d0c4d5b2cc151661aec535ee417ca0db7a817683fff8539b29fc457
582,bc1qvgmlrrnfustqgjayjlhu2ulcq8yj07n7qffrlv,373,1997832,1997832,1672862594,1672385353,0,inbound,4382bb696d0c4d5b2cc151661aec535ee417ca0db7a817683fff8539b29fc457
583,bc1qhtu93e46z0ln6zdsg39v207t2x46tvfhdyrr4y,374,2375776115,2375776115,1677308494,1669104993,0,inbound,4382bb696d0c4d5b2cc151661aec535ee417ca0db7a817683fff8539b29fc457
584,bc1q6u3md5t52c5h8cmjm3a22qw7qm3ryxq8wlf0qg6hhzmcx3q64qws3ls2xn,375,1967332585,1967332585,1672556880,1602697248,0,inbound,4382bb696d0c4d5b2cc151661aec535ee417ca0db7a817683fff8539b29fc457
585,1Kr6QSydW9bFQG1mXiPNNu6WpJGmUa9i1g,376,13190123051007377,13189896362625015,1681097177,1680998090,226688382362,outbound,4382bb696d0c4d5b2cc151661aec535ee417ca0db7a817683fff8539b29fc457
586,bc1qpy73q9uf0zwyunzn4x6euj9lqmem8cexjm3zqz,377,1453058,1453058,1675887363,1672364206,0,inbound,4382bb696d0c4d5b2cc151661aec535ee417ca0db7a817683fff8539b29fc457
587,bc1qxnjqv5apw0mdv5yf85tr77rh0pc60tghq0yhzpzegd8u2y2cypdsw85yf8,378,3641815711,3641815711,1676042498,1674610229,0,outbound,4382bb696d0c4d5b2cc151661aec535ee417ca0db7a817683fff8539b29fc457
588,1FuX2ZP7vF8BBmjCYuJ8fMQERvDebMVEPD,379,80000,80000,1672471213,1672364206,0,inbound,4382bb696d0c4d5b2cc151661aec535ee417ca0db7a817683fff8539b29fc457
589,3Qr2VVeTT47fDvqC5uLfwW6PZURA6gk9Co,380,88957946,88957946,1677654770,1672036974,0,inbound,4382bb696d0c4d5b2cc151661aec535ee417ca0db7a817683fff8539b29fc457
590,bc1qh6e05ayzmjvgj07x74r2687ylkqyk5j9kwc2ph,381,130205869,130205869,1678492850,1673455157,0,outbound,4382bb696d0c4d5b2cc151661aec535ee417ca0db7a817683fff8539b29fc457
591,bc1qz2u65krzgdf0rtd3a3t3u2ufyywfra4ds832hu,382,80000,0,1672364206,1672364206,80000,inbound,4382bb696d0c4d5b2cc151661aec535ee417ca0db7a817683fff8539b29fc457
592,bc1qpam0uaa4q073ddtrcfdfn74djx9lnr5vpzx56l,383,2387000,0,1672364206,1672364206,2387000,inbound,4382bb696d0c4d5b2cc151661aec535ee417ca0db7a817683fff8539b29fc457
593,14B69Axemy3aeYeDyqL2FiPjcPpcWdH2Ky,384,1192681,1192681,1673061754,1672034805,0,inbound,4382bb696d0c4d5b2cc151661aec535ee417ca0db7a817683fff8539b29fc457
594,3QhaVjTdxD3hi45sEkTp7jaVXPajsL5YYJ,385,10873473459,10873473459,1678584665,1672476131,0,inbound,4382bb696d0c4d5b2cc151661aec535ee417ca0db7a817683fff8539b29fc457
595,bc1q9ghw5zt5ssv2y4ac72slt872xray88n0djxx2p,386,255915000,0,1672364206,1672189365,255915000,inbound,4382bb696d0c4d5b2cc151661aec535ee417ca0db7a817683fff8539b29fc457
596,1H47mXojXJkU9ASHLhBXh29PQxmEd6AnSP,387,809313000,809313000,1677685194,1671340966,0,inbound,4382bb696d0c4d5b2cc151661aec535ee417ca0db7a817683fff8539b29fc457
597,bc1q3xe8llefhta04ceasfjgvg0umcc98q4k65vmuv,388,5856148,5856148,1672364673,1672364206,0,inbound,4382bb696d0c4d5b2cc151661aec535ee417ca0db7a817683fff8539b29fc457
598,1GuccfqQh5pTbUa8xNqHGsnFN1SdU2rmgr,389,5616679,5616679,1676544656,1668425090,0,inbound,4382bb696d0c4d5b2cc151661aec535ee417ca0db7a817683fff8539b29fc457
599,3MtKqgGCFTkfYy5daWjoTEMn4eycJnJj5f,514,275441132,274996888,1681044569,1673152945,444244,outbound,4382bb696d0c4d5b2cc151661aec535ee417ca0db7a817683fff8539b29fc457
600,3En9nZejRykM6NboiD2Dq3X6aQ1hwzcqZj,515,45721,45721,1672272133,1672264538,0,inbound,4382bb696d0c4d5b2cc151661aec535ee417ca0db7a817683fff8539b29fc457
601,16KFJyWk1FBNq7RhgTMYTfUSb5Bm3VU6Mj,516,302910,302910,1672272223,1672264538,0,inbound,4382bb696d0c4d5b2cc151661aec535ee417ca0db7a817683fff8539b29fc457
602,bc1q2967w8aevnkjyalcu2hf252aljuk64ysas7les,517,33476795982,33473968237,1681132422,1680952773,2827745,inbound,4382bb696d0c4d5b2cc151661aec535ee417ca0db7a817683fff8539b29fc457
603,16pxFHkcQQWHJFDMAktxYRCsN9kSBeMcZc,518,187544767,187537661,1681062597,1678298518,7106,outbound,4382bb696d0c4d5b2cc151661aec535ee417ca0db7a817683fff8539b29fc457
604,3EGS9qoVEHNTRJhYnwqejyTnr7YeTEUbfq,519,34537988,29718570,1681121440,1668160840,4819418,outbound,4382bb696d0c4d5b2cc151661aec535ee417ca0db7a817683fff8539b29fc457
605,3C5QA3qZHn9hSJLd4uqujeGS6Z1A5hZETq,520,183571060,183571060,1680030128,1672157489,0,inbound,4382bb696d0c4d5b2cc151661aec535ee417ca0db7a817683fff8539b29fc457
606,1Cdb3epDdmqnxNLRLgvPREbYMhoEGP3cFZ,521,140480,140480,1673461586,1672264538,0,inbound,4382bb696d0c4d5b2cc151661aec535ee417ca0db7a817683fff8539b29fc457
607,3EGLLJUR8LYdLJMsGesdr3eJp5fnUBS9YW,522,203940663,203662272,1676097645,1671303350,278391,inbound,4382bb696d0c4d5b2cc151661aec535ee417ca0db7a817683fff8539b29fc457
608,bc1qxcs5r3yhvcqa4qu2gy6ku27wvjx6tf8rrtvvk3,523,104916,104916,1672796470,1672264538,0,inbound,4382bb696d0c4d5b2cc151661aec535ee417ca0db7a817683fff8539b29fc457
609,1FCAsiseTniCYQMbRwK5brA5iZRKSXQNhb,524,61690609,61690609,1672443016,1670773561,0,inbound,4382bb696d0c4d5b2cc151661aec535ee417ca0db7a817683fff8539b29fc457
610,bc1qlkn0p8qyq79kxkwmg3kyaupan8nvhvll5fzu3e,525,12978238,12978238,1678412064,1620530083,0,inbound,4382bb696d0c4d5b2cc151661aec535ee417ca0db7a817683fff8539b29fc457
611,34hExWLX1RE47vn8SdJFAQmLCAFVRshTQA,526,64329181,64329181,1677782290,1671804707,0,inbound,4382bb696d0c4d5b2cc151661aec535ee417ca0db7a817683fff8539b29fc457
612,3EzE9A7xWWiuF4uN5CaZFN9WwZ8feJA1uT,527,79793667,78602375,1680716783,1677756310,1191292,inbound,4382bb696d0c4d5b2cc151661aec535ee417ca0db7a817683fff8539b29fc457
613,bc1q5n6zhwjarj4h5ad6upn96k9v56pqs9q3qlawdj,528,427104,427104,1673135340,1672264538,0,inbound,4382bb696d0c4d5b2cc151661aec535ee417ca0db7a817683fff8539b29fc457
614,1CYwhdJM7UXcDkTemDsRn9QsfgjLhFxUPy,529,1309327924,1309327924,1681078075,1680128296,0,outbound,4382bb696d0c4d5b2cc151661aec535ee417ca0db7a817683fff8539b29fc457
615,3PPyBovoWWfmXgUiuBuiHXYi2APLo1EaH5,530,92950867,90134193,1680478401,1645053638,2816674,outbound,4382bb696d0c4d5b2cc151661aec535ee417ca0db7a817683fff8539b29fc457
616,bc1qkh5k3z73lcupwn8gcqaraljg9lk46fjv2gqde7,531,113021615,113021615,1677230484,1671589107,0,outbound,4382bb696d0c4d5b2cc151661aec535ee417ca0db7a817683fff8539b29fc457
617,bc1q2gy040gg4esezj8cgnt5an4sd2gprmvd6v2q5n,532,936093,936093,1672264934,1672264538,0,inbound,4382bb696d0c4d5b2cc151661aec535ee417ca0db7a817683fff8539b29fc457
618,3JzfzsdaHFPuGKVfTbWeFSGFYAcCXoETFK,533,187740108,185364054,1681115186,1680403989,2376054,inbound,4382bb696d0c4d5b2cc151661aec535ee417ca0db7a817683fff8539b29fc457
619,bc1qpyp2mvh9t0hqdkl74spzzek8ew64tvscefd5j9,534,227017753,227017753,1672278883,1672264538,0,inbound,4382bb696d0c4d5b2cc151661aec535ee417ca0db7a817683fff8539b29fc457
620,3FeFs9oNg3qT3ZGWKnCRHwcnH1edES9Cd1,535,231576018,230323053,1681115166,1680297414,1252965,outbound,4382bb696d0c4d5b2cc151661aec535ee417ca0db7a817683fff8539b29fc457
621,3GGrkWbRHRVJ5qWiaY1fw47GKtpRYPoJ1X,536,505760,505760,1672310623,1672264538,0,inbound,4382bb696d0c4d5b2cc151661aec535ee417ca0db7a817683fff8539b29fc457
622,35XM1Sz4uJ6TUBMYecfyia1quUULT4njM1,537,1222576107,1221823419,1681115158,1679628987,752688,outbound,4382bb696d0c4d5b2cc151661aec535ee417ca0db7a817683fff8539b29fc457
623,bc1qkvcpmmve5y9re7andnwwe05jnvwg3jgxjn7xnj,538,578690,578690,1672430480,1672264538,0,inbound,4382bb696d0c4d5b2cc151661aec535ee417ca0db7a817683fff8539b29fc457
624,3Gcr2UxcFGnv3XoArzBdwuMm4xcckkkX2a,539,193777,193777,1672290095,1672264538,0,inbound,4382bb696d0c4d5b2cc151661aec535ee417ca0db7a817683fff8539b29fc457
625,3Jkwq5BPszRjgi1iZ5JBYQKv2UYLru1zKu,540,460123,460123,1672310623,1672264538,0,inbound,4382bb696d0c4d5b2cc151661aec535ee417ca0db7a817683fff8539b29fc457
626,bc1qr6yz5faemrehtpmg4qy0jf00nkwnqsvzj6z7u9,541,54831609,25924736,1681006064,1671492088,28906873,inbound,4382bb696d0c4d5b2cc151661aec535ee417ca0db7a817683fff8539b29fc457
627,bc1qhncptp9yjlqk8n8nr8fpgkqd88l90y4d57ss26,542,107583182,106496635,1681124538,1679633623,1086547,inbound,4382bb696d0c4d5b2cc151661aec535ee417ca0db7a817683fff8539b29fc457
628,bc1qqw36rg4des94qly9rh5t630khegxslujzkyrnt,543,282559,282559,1672287208,1672264538,0,inbound,4382bb696d0c4d5b2cc151661aec535ee417ca0db7a817683fff8539b29fc457
629,bc1qft7za3n7fk2shq2lwm98l76j3hysxzqhak0jfs,544,104785584,104422851,1681058500,1673020121,362733,outbound,4382bb696d0c4d5b2cc151661aec535ee417ca0db7a817683fff8539b29fc457
630,37bbyc6dggBvDraC3PcNWYZNAmXtebPy5C,545,1789236,1789236,1674086529,1671889604,0,inbound,4382bb696d0c4d5b2cc151661aec535ee417ca0db7a817683fff8539b29fc457
631,3NB3dHHBdf4tsrA22R6m54NDxy5kjRFCLc,546,133216,133216,1672272130,1672264538,0,inbound,4382bb696d0c4d5b2cc151661aec535ee417ca0db7a817683fff8539b29fc457
632,33yLz4crvui6xJDjxPgu8H5cX7WR2d17xd,547,290229104,279825415,1681125696,1678659151,10403689,outbound,4382bb696d0c4d5b2cc151661aec535ee417ca0db7a817683fff8539b29fc457
633,bc1qdlxgja88y6qe8437xtxkttxh34w3y4h7tyjs6p,548,617967,617967,1672275824,1672264538,0,inbound,4382bb696d0c4d5b2cc151661aec535ee417ca0db7a817683fff8539b29fc457
634,bc1qvqgtvmle26xf69qreaj6tyf55eqkttp802l63a,549,119957032,119957032,1681026006,1674665572,0,outbound,4382bb696d0c4d5b2cc151661aec535ee417ca0db7a817683fff8539b29fc457
635,34f7JQWmzDWDGWMXz3kzJ7UZdVQ8Sni7Bj,550,37000,37000,1672320058,1672264538,0,inbound,4382bb696d0c4d5b2cc151661aec535ee417ca0db7a817683fff8539b29fc457
636,3PsH8coN64x9HthQSL6Sr97gmRVsLFYH47,551,75272,75272,1672297134,1672264538,0,inbound,4382bb696d0c4d5b2cc151661aec535ee417ca0db7a817683fff8539b29fc457
637,3EgnMmoxZ9tbW82UDVcv2e61Le3HqRThju,552,164060,164060,1672272178,1672264538,0,inbound,4382bb696d0c4d5b2cc151661aec535ee417ca0db7a817683fff8539b29fc457
638,1L6i9yeNDK6HwnhqL6ft7tMoYSuMD8woh,745,202457,202457,1672087572,1672082849,0,inbound,4382bb696d0c4d5b2cc151661aec535ee417ca0db7a817683fff8539b29fc457
639,3QzBtqrziiweXF9HW2bhUUo4RgRVVQPnAU,746,243422,0,1672082849,1672082849,243422,inbound,4382bb696d0c4d5b2cc151661aec535ee417ca0db7a817683fff8539b29fc457
640,1NCnatKybvsNurF8W2meeBH9oFUy9uDxAC,747,174062,174062,1672294877,1672082849,0,inbound,4382bb696d0c4d5b2cc151661aec535ee417ca0db7a817683fff8539b29fc457
641,3Bs9yMFyn1bqREwjHsVqh9c8JsbKWjCKcc,748,25103941,24906658,1677160660,1672256741,197283,outbound,4382bb696d0c4d5b2cc151661aec535ee417ca0db7a817683fff8539b29fc457
642,3DJreh92bm4vLEvxtLnSXSyzuxDMpsnwdZ,749,61740022,61726066,1680691051,1656463851,13956,inbound,4382bb696d0c4d5b2cc151661aec535ee417ca0db7a817683fff8539b29fc457
643,bc1qrnge53529hyn5kc6kyde200y4falqsdkk6zhxd,750,859598,859598,1672430259,1672082849,0,inbound,4382bb696d0c4d5b2cc151661aec535ee417ca0db7a817683fff8539b29fc457
644,3LVQ6DdvMP7qGva4jzaodhh87B4QW1WtUG,751,59970,59970,1672158532,1672082849,0,inbound,4382bb696d0c4d5b2cc151661aec535ee417ca0db7a817683fff8539b29fc457
645,bc1qhvyqp228qfcldtccgqqqx7ht39c6lq2prwcf70,752,2903385,2903385,1672084565,1672082849,0,inbound,4382bb696d0c4d5b2cc151661aec535ee417ca0db7a817683fff8539b29fc457
646,3QQyj2YiJrctze9HKAqMqAo8PEa9AhS4KM,753,1165696075,1165695185,1675235182,1670806170,890,inbound,4382bb696d0c4d5b2cc151661aec535ee417ca0db7a817683fff8539b29fc457
647,32hTbbscXXRZzfXBpga8omrPJAPZncWizC,754,653076,653076,1672111149,1672082849,0,inbound,4382bb696d0c4d5b2cc151661aec535ee417ca0db7a817683fff8539b29fc457
648,bc1q82ekpe56yg6xc040l38e288p3pst9dzde0m8ra,755,61295985,61295985,1681091421,1676044861,0,inbound,4382bb696d0c4d5b2cc151661aec535ee417ca0db7a817683fff8539b29fc457
649,3ESk9UiR5jBSKacPCQcKSSfYJL59VVjgWE,756,567175,567175,1672132070,1672082849,0,inbound,4382bb696d0c4d5b2cc151661aec535ee417ca0db7a817683fff8539b29fc457
650,3GyY4ur5YzYGRw5Jqm68yHHcPP2MrXW1rg,757,277065,277065,1672117294,1672082849,0,inbound,4382bb696d0c4d5b2cc151661aec535ee417ca0db7a817683fff8539b29fc457
651,3AHA9XrMjF8rncyeRczGw47xaQL2kJUvzc,758,160941,160941,1672099663,1672082849,0,inbound,4382bb696d0c4d5b2cc151661aec535ee417ca0db7a817683fff8539b29fc457
652,3KjZNsKmsTa1w5sawipKq5zzTZU7vhYbvz,759,236404,236404,1672476696,1672082849,0,inbound,4382bb696d0c4d5b2cc151661aec535ee417ca0db7a817683fff8539b29fc457
653,1Cj5rPRtLVNajqgdTMVJoyW96hZrUeNcPB,760,584666,584666,1672084751,1672082849,0,inbound,4382bb696d0c4d5b2cc151661aec535ee417ca0db7a817683fff8539b29fc457
654,1B4kyr8cn3UCJEGWAEgWkjLbgvZPZSKgJ1,761,621539,621539,1672115636,1672082849,0,inbound,4382bb696d0c4d5b2cc151661aec535ee417ca0db7a817683fff8539b29fc457
655,1BjJZjiwvd3GT84dsaYGbgUHbXSG6CGcao,762,890571,890571,1672085351,1672082849,0,inbound,4382bb696d0c4d5b2cc151661aec535ee417ca0db7a817683fff8539b29fc457
656,3LKoDo7rxaAtpKz7NkE7ES25ZAmsHRbtDS,763,84293,84293,1672099662,1672082849,0,inbound,4382bb696d0c4d5b2cc151661aec535ee417ca0db7a817683fff8539b29fc457
657,bc1qwgdygzlhkpqau8yj3hm8jy8csfl34fpc0wtr4r,764,991022,991022,1672087205,1672082849,0,inbound,4382bb696d0c4d5b2cc151661aec535ee417ca0db7a817683fff8539b29fc457
658,36kocZCZpgjkCgupsgC3XwcMTBtNrhBTTq,765,553227,553227,1672099665,1672082849,0,inbound,4382bb696d0c4d5b2cc151661aec535ee417ca0db7a817683fff8539b29fc457
659,39kDk1BQThAB928kCio7X3425GQFuc2ax3,766,118742,118742,1672786483,1672082849,0,inbound,4382bb696d0c4d5b2cc151661aec535ee417ca0db7a817683fff8539b29fc457
660,1GBAsds52JPfoVKW3QK2kVJ5e8joy1AZvp,767,211404831,211404831,1680984357,1671473559,0,outbound,4382bb696d0c4d5b2cc151661aec535ee417ca0db7a817683fff8539b29fc457
661,bc1q6w4kkk74cvzxd2ln84gzjd2q8jxg5s5xyqhyt4,768,45415461,45199701,1680558783,1664602601,215760,inbound,4382bb696d0c4d5b2cc151661aec535ee417ca0db7a817683fff8539b29fc457
662,1Di1jnrdaJGkRW9V9gj9SopQLfdpwbbAn,769,1281953908,1281953908,1681020528,1679053287,0,inbound,4382bb696d0c4d5b2cc151661aec535ee417ca0db7a817683fff8539b29fc457
663,3EQjZQwwUKBP1RKg21TpoHYzeHT7w5NLUt,770,297378,297378,1672099665,1672082849,0,inbound,4382bb696d0c4d5b2cc151661aec535ee417ca0db7a817683fff8539b29fc457
664,32SAvsEgjxnfYer4h7tV5tgEUuMiAM91Kd,771,419524,419524,1672163668,1672082849,0,inbound,4382bb696d0c4d5b2cc151661aec535ee417ca0db7a817683fff8539b29fc457
665,1HsM9gApD9Ppy8GsmpRoM5YqSE8UGsd7Uv,772,1136425,1136425,1672089011,1672082849,0,inbound,4382bb696d0c4d5b2cc151661aec535ee417ca0db7a817683fff8539b29fc457
666,bc1q79scwccp9v2lpwnhg8qwltdzjtl6t93c79u2k4,773,75381420,75381420,1678235250,1671862239,0,outbound,4382bb696d0c4d5b2cc151661aec535ee417ca0db7a817683fff8539b29fc457
667,1EKi2YpRYDTo6bhgjgK4kokXoo7ksLJGhF,774,130612,130612,1672086755,1672082849,0,inbound,4382bb696d0c4d5b2cc151661aec535ee417ca0db7a817683fff8539b29fc457
668,1NgT9Dkg3jkbziWhND86fJdnBV7rGqTxm5,775,593705,593705,1672086973,1672082849,0,inbound,4382bb696d0c4d5b2cc151661aec535ee417ca0db7a817683fff8539b29fc457
669,3BvzsuZuve2RxokD4ZhT7az7nvU5Vj2x8k,776,335237,335237,1672117294,1672082849,0,inbound,4382bb696d0c4d5b2cc151661aec535ee417ca0db7a817683fff8539b29fc457
670,bc1qgz8dw2qnhtklegc75wydvnqgg42jqk0x8es6w0,777,307526568,307526568,1681044215,1676197147,0,inbound,4382bb696d0c4d5b2cc151661aec535ee417ca0db7a817683fff8539b29fc457
671,3BSZQgMUSrs8KoKHSisVsHSP3R3s1qVzHD,778,123192,123192,1672099320,1672082849,0,inbound,4382bb696d0c4d5b2cc151661aec535ee417ca0db7a817683fff8539b29fc457
672,3BsYxJpweq3L4Rj6AhN4wKFL2XwhQXR1yj,779,178130,178130,1672229074,1672082849,0,inbound,4382bb696d0c4d5b2cc151661aec535ee417ca0db7a817683fff8539b29fc457
673,1GqWuhvbvL5822Z3mdNRTzms72YLQkvvHo,780,336850,336850,1672085480,1672082849,0,inbound,4382bb696d0c4d5b2cc151661aec535ee417ca0db7a817683fff8539b29fc457
674,13ZB4gxcasTVJCzp8Q19P7tWYDanfWgHGN,781,231307152,231307152,1679422633,1673664692,0,inbound,4382bb696d0c4d5b2cc151661aec535ee417ca0db7a817683fff8539b29fc457
675,3M9159HFK7r2Cu2aXyfxhXaM5rcFFN3arp,782,685048,685048,1672099668,1672082849,0,inbound,4382bb696d0c4d5b2cc151661aec535ee417ca0db7a817683fff8539b29fc457
676,bc1qlgns2728400am37m82r8muafauh5mjlptfpq62,783,219009,219009,1672174366,1672082849,0,inbound,4382bb696d0c4d5b2cc151661aec535ee417ca0db7a817683fff8539b29fc457
677,1FeYZLfdvUiHXNZqcgSdipaZogQqew7PKg,909,297202,297202,1672152079,1671903850,0,inbound,4382bb696d0c4d5b2cc151661aec535ee417ca0db7a817683fff8539b29fc457
678,bc1q5neg6uk2nnzz74yfryyrx6gs76n3p8sj2l4ngv,910,42969587,42969587,1672103258,1665706509,0,inbound,4382bb696d0c4d5b2cc151661aec535ee417ca0db7a817683fff8539b29fc457
679,3K6GEevUgY2AfE8VbhnN86AtPxGdjccqxo,911,135395,135395,1671926576,1671903850,0,inbound,4382bb696d0c4d5b2cc151661aec535ee417ca0db7a817683fff8539b29fc457
680,bc1qgcuxuh2wt5q5d8s29vd75lt6c7l6llcx0nzvcg,912,173362917,173362917,1680107615,1669622589,0,inbound,4382bb696d0c4d5b2cc151661aec535ee417ca0db7a817683fff8539b29fc457
681,35MQhx5FWEwSvggwS8V4zqHzneGxnix1Rp,913,126578,126578,1672383625,1671903850,0,inbound,4382bb696d0c4d5b2cc151661aec535ee417ca0db7a817683fff8539b29fc457
682,3MXucJrR7VLjrXURCMUM6ciGuzYhtBCszA,914,597173,597173,1672071745,1671903850,0,inbound,4382bb696d0c4d5b2cc151661aec535ee417ca0db7a817683fff8539b29fc457
683,17ujRrPAmegUQGkxGj3oD7Zi9xbSVUEY9N,915,60816667,60816667,1680629100,1530654780,0,inbound,4382bb696d0c4d5b2cc151661aec535ee417ca0db7a817683fff8539b29fc457
684,3AL9SkPAXS846LHYVrmWz6N9KHQYxyEoAZ,916,5000000,5000000,1672305998,1671903850,0,inbound,4382bb696d0c4d5b2cc151661aec535ee417ca0db7a817683fff8539b29fc457
685,36NAjiLQFcJAHFoLyUGdK3GNbGeUznfVYR,917,239652139,236397578,1673560969,1666695432,3254561,inbound,4382bb696d0c4d5b2cc151661aec535ee417ca0db7a817683fff8539b29fc457
686,3J2nAHZckiPJi9DJAqhcyLpRXmrzrNWngA,918,371837,371837,1672074624,1671903850,0,inbound,4382bb696d0c4d5b2cc151661aec535ee417ca0db7a817683fff8539b29fc457
687,1J6E7GgekoUtUjvXwuUvYhEkYeWSwSjrdF,919,59411,0,1671903850,1671903850,59411,inbound,4382bb696d0c4d5b2cc151661aec535ee417ca0db7a817683fff8539b29fc457
688,bc1qpxp9lpcuh83p0acyj03mp82nsdmsnjjr8h0ecjretcsvsh2xa0xs79zgyy,920,30604305,30604305,1679855679,1666627001,0,outbound,4382bb696d0c4d5b2cc151661aec535ee417ca0db7a817683fff8539b29fc457
689,374o2tVBVVBjRM3u1zyVGywATTH8thBxTK,921,631197,631197,1672664248,1671903850,0,inbound,4382bb696d0c4d5b2cc151661aec535ee417ca0db7a817683fff8539b29fc457
690,39PHPZtgRBWfQAvuRdnokQwZwqS5MsP7XE,922,136166,136166,1672702105,1671903850,0,inbound,4382bb696d0c4d5b2cc151661aec535ee417ca0db7a817683fff8539b29fc457
691,12JXZ1ENN6zSsRwAXdG4LNS8YcAp9WQR3z,923,106095,106095,1674489626,1671903850,0,inbound,4382bb696d0c4d5b2cc151661aec535ee417ca0db7a817683fff8539b29fc457
692,1G6mHaJM3pF3dWEaXTjLFeNhJJoGnmuTv,924,303076,303076,1672151595,1671903850,0,inbound,4382bb696d0c4d5b2cc151661aec535ee417ca0db7a817683fff8539b29fc457
693,3MbweD4zyFi6Vv1HpuaP5hCxzEADe4VUkb,925,1264775,1264775,1672013199,1671903850,0,inbound,4382bb696d0c4d5b2cc151661aec535ee417ca0db7a817683fff8539b29fc457
694,1N7VwGCupScSWfBRsT2MfeFm7FaEBXiugz,926,279214,279214,1672246785,1671903850,0,inbound,4382bb696d0c4d5b2cc151661aec535ee417ca0db7a817683fff8539b29fc457
695,3B9Pg4dvNS9thy2oQz2dfNb5wDuwSSNXWS,927,768492376,738566345,1680831417,1597505219,29926031,inbound,4382bb696d0c4d5b2cc151661aec535ee417ca0db7a817683fff8539b29fc457
696,32GU4BDyT4MJeCJL57paL2gPudFdPmbsVE,928,292795,292795,1672076545,1671903850,0,inbound,4382bb696d0c4d5b2cc151661aec535ee417ca0db7a817683fff8539b29fc457
697,1H49oCZVTyYJoWR4nY4qEjyzKU9xPwqL1u,929,891125,891125,1671912056,1671903850,0,inbound,4382bb696d0c4d5b2cc151661aec535ee417ca0db7a817683fff8539b29fc457
698,33DJEwnPtG8MWffzL8LDRJWZKbnGFjJxYk,930,128445,128445,1671944490,1671903850,0,inbound,4382bb696d0c4d5b2cc151661aec535ee417ca0db7a817683fff8539b29fc457
699,35WNtwEBQYx1yZLnq89BXKuDbwmZDfBvRp,931,30225044,17938990,1681092139,1633132365,12286054,inbound,4382bb696d0c4d5b2cc151661aec535ee417ca0db7a817683fff8539b29fc457
700,3J2gUD8DMg48GbNgwcHdhGGohmvWRSiRVb,932,578345,578345,1671926582,1671903850,0,inbound,4382bb696d0c4d5b2cc151661aec535ee417ca0db7a817683fff8539b29fc457
701,bc1qwyfmfqhkwdkfz8wtzxp0w0kpekadc0ygyhtrw2pd6sgh8sl243zsm87ljf,933,570637,570637,1672071980,1671903850,0,inbound,4382bb696d0c4d5b2cc151661aec535ee417ca0db7a817683fff8539b29fc457
702,1K74dYUuBpg482wUXJCrpa6xe5LRG38m7d,934,11881,0,1671903850,1671903850,11881,inbound,4382bb696d0c4d5b2cc151661aec535ee417ca0db7a817683fff8539b29fc457
703,1C7SZwdiZNAvPGwHENiUY5vGJ49PsYtBRF,935,574095,574095,1672054458,1671903850,0,inbound,4382bb696d0c4d5b2cc151661aec535ee417ca0db7a817683fff8539b29fc457
704,3GMgXDz8KJY2NPXScRjM5WQFs9BD3GPPZm,936,65390953,65073254,1681140104,1677181292,317699,outbound,4382bb696d0c4d5b2cc151661aec535ee417ca0db7a817683fff8539b29fc457
705,36YLxYqLmqRSx9hKSasZwNt77TPU6bCekh,937,565598,565598,1672434704,1671903850,0,inbound,4382bb696d0c4d5b2cc151661aec535ee417ca0db7a817683fff8539b29fc457
706,bc1q64zghhx9qjcrc8lk2r9zfzs0qzl2u2m2jjpmaj,938,189329640,189329640,1671906309,1671903850,0,inbound,4382bb696d0c4d5b2cc151661aec535ee417ca0db7a817683fff8539b29fc457
707,1Q2utPXp9jWz1RLMh7rZoeQhQuYGvJyZq2,939,70295185,70295185,1681012253,1666223444,0,inbound,4382bb696d0c4d5b2cc151661aec535ee417ca0db7a817683fff8539b29fc457
708,37GLDXXXA6nD9xELn4wrx9fyopzLVKHT15,940,3730949,3705377,1679298165,1619573859,25572,inbound,4382bb696d0c4d5b2cc151661aec535ee417ca0db7a817683fff8539b29fc457
709,bc1qw29qr8gtfvrkv0jdmk3p6z6725fewu35g59yg6,941,5657413,5657413,1671800963,1671799967,0,inbound,4382bb696d0c4d5b2cc151661aec535ee417ca0db7a817683fff8539b29fc457
710,33xGKHVmssYLEmzNx6g1A9Kmn1xTGC8zsM,942,5176657,0,1678019219,1656752081,5176657,inbound,4382bb696d0c4d5b2cc151661aec535ee417ca0db7a817683fff8539b29fc457
711,34GQ6rbubMctrMAE1KH3e1frYwVJbo2KNj,943,391000,391000,1671932048,1671799967,0,inbound,4382bb696d0c4d5b2cc151661aec535ee417ca0db7a817683fff8539b29fc457
712,33XknTE7PAoAY8zZjsphfvy6VgGPeXdc1V,944,214000,214000,1672447634,1671799967,0,inbound,4382bb696d0c4d5b2cc151661aec535ee417ca0db7a817683fff8539b29fc457
713,1BkASuHxgvwMBzPFZ22ihgMvEUVNTDTRkr,945,3760336,3760336,1672036746,1671799967,0,inbound,4382bb696d0c4d5b2cc151661aec535ee417ca0db7a817683fff8539b29fc457
714,bc1q50f34txs4mvztcvzdxaz86erskhlcefmt7h2hk,946,57195898,57195898,1681119772,1656920969,0,outbound,4382bb696d0c4d5b2cc151661aec535ee417ca0db7a817683fff8539b29fc457
715,bc1qq7zncqsvvnlrf3yujndk6lvqa5lfj8f0eeeccx,947,1653218,0,1671799967,1671799967,1653218,inbound,4382bb696d0c4d5b2cc151661aec535ee417ca0db7a817683fff8539b29fc457
716,bc1q8dqcaa8umk8spytzjcwtkr7n8re07wk85g84cz,1211,14313113,14313113,1677941260,1669885575,0,inbound,4382bb696d0c4d5b2cc151661aec535ee417ca0db7a817683fff8539b29fc457
717,3J1ZyhNMPHiZCEypYe4hKXt96nP7b5ZmUL,1212,151739300,147088181,1680994851,1675354160,4651119,inbound,4382bb696d0c4d5b2cc151661aec535ee417ca0db7a817683fff8539b29fc457
718,32qiWozcV8FXXmo2JvATt9dnQW6TZZU65B,1213,169861,169861,1671732183,1671716527,0,inbound,4382bb696d0c4d5b2cc151661aec535ee417ca0db7a817683fff8539b29fc457
719,3DUiUocKAnuDqqCak99w9aET9qfXFqXRMV,1214,232006,232006,1672136910,1671716527,0,inbound,4382bb696d0c4d5b2cc151661aec535ee417ca0db7a817683fff8539b29fc457
720,bc1qth7jpqg5xn6hecxcn79sf5zqnyn32c45982ky6,1215,5273700,5273700,1676494651,1671715613,0,inbound,4382bb696d0c4d5b2cc151661aec535ee417ca0db7a817683fff8539b29fc457
721,bc1q04jkp6j8ucjyep2yjrz7arcs94nl09u5zxugzagknf67nf8tuwcsdpeekk,1216,272024,0,1671716527,1671716527,272024,inbound,4382bb696d0c4d5b2cc151661aec535ee417ca0db7a817683fff8539b29fc457
722,bc1q7m5g0mk3u8g6q6y6nyzwrp0ugyxn0crs7j25pv,1217,43320232,43320232,1673952521,1668375449,0,inbound,4382bb696d0c4d5b2cc151661aec535ee417ca0db7a817683fff8539b29fc457
723,3N7p4W4JC9yWH3wsstSKPkgsPNrnDGjZ3s,1218,2678837,2678837,1671725160,1671716527,0,inbound,4382bb696d0c4d5b2cc151661aec535ee417ca0db7a817683fff8539b29fc457
724,bc1qprdf80adfz7aekh5nejjfrp3jksc8r929svpxk,1219,384790259865257,384760430394978,1681144404,1681064692,29829470279,outbound,4382bb696d0c4d5b2cc151661aec535ee417ca0db7a817683fff8539b29fc457
725,1GQdrgqAbkeEPUef1UpiTc4X1mUHMcyuGW,1220,713941598850259,713919115880084,1681144527,1681132931,22482970175,outbound,4382bb696d0c4d5b2cc151661aec535ee417ca0db7a817683fff8539b29fc457
726,bc1qxed7zg8cad4sj0q3yjmcq9ygyz0mgvj49cqrru,1221,25962179,25962179,1673046747,1671623674,0,inbound,4382bb696d0c4d5b2cc151661aec535ee417ca0db7a817683fff8539b29fc457
727,bc1qu8dctq65r68xsqvyxutjahepaj62svr9q2vtgu,1222,3667113,3667113,1676774985,1671557719,0,inbound,4382bb696d0c4d5b2cc151661aec535ee417ca0db7a817683fff8539b29fc457
728,bc1q800zhz0m9372hzwq3q88fc3d26dfa77te509ys,1223,36062,0,1671498819,1671498819,36062,inbound,4382bb696d0c4d5b2cc151661aec535ee417ca0db7a817683fff8539b29fc457
729,3GG4D98ZBhzBBiNjGWzAk971bsaVun3Zds,1224,410000,410000,1671426094,1671389808,0,inbound,4382bb696d0c4d5b2cc151661aec535ee417ca0db7a817683fff8539b29fc457
730,13K4NH5urzgTxgQmhfRKY7e8cyDxF46Ubw,1225,10099444,10099444,1672974366,1647834237,0,inbound,4382bb696d0c4d5b2cc151661aec535ee417ca0db7a817683fff8539b29fc457
731,38hSNCaqmAqGcuiV2SFmpLt5fBYJFBEYc4,1226,8519604,8519604,1673033166,1658120560,0,inbound,4382bb696d0c4d5b2cc151661aec535ee417ca0db7a817683fff8539b29fc457
732,bc1qgvpysc7m8vrrz3spqedkjkht55ylt9hjv7vpqt,1227,21398000,0,1678174760,1665211844,21398000,inbound,4382bb696d0c4d5b2cc151661aec535ee417ca0db7a817683fff8539b29fc457
733,1GnviWmYjS23AQxjrNAGPhR6z9WiUWXT4j,1228,217205,217205,1672328164,1671389808,0,inbound,4382bb696d0c4d5b2cc151661aec535ee417ca0db7a817683fff8539b29fc457
734,bc1qwv75tgmvd8zr2y3eclm5pkc4napxmn0eycets4,1229,2580425,0,1671389808,1671389808,2580425,inbound,4382bb696d0c4d5b2cc151661aec535ee417ca0db7a817683fff8539b29fc457
735,1D34r6tAgWFk4QFMdDDFipWRXuWMaKmpSu,1230,6766900,1354000,1671389808,1671126170,5412900,inbound,4382bb696d0c4d5b2cc151661aec535ee417ca0db7a817683fff8539b29fc457
736,bc1qgyyqe26gg5uu3dw7s9xw4mwwajdrrnfqs5jplc,1231,1347430157,1344523981,1680581994,1672897431,2906176,outbound,4382bb696d0c4d5b2cc151661aec535ee417ca0db7a817683fff8539b29fc457
737,bc1qmfmvzg42vpg4k7dpjq6pdd8nfj4drken2nuxs8,1232,330439,0,1671389808,1671389808,330439,inbound,4382bb696d0c4d5b2cc151661aec535ee417ca0db7a817683fff8539b29fc457
738,3DJstriiapX45492P6u13AiJTcgF6JfCyg,1233,6738060,6738060,1677432652,1671384166,0,inbound,4382bb696d0c4d5b2cc151661aec535ee417ca0db7a817683fff8539b29fc457
739,bc1qc0p06ty60aw5rljj0sfz9uuhwshw8wsp0ra293,1234,80501118,80501118,1671542423,1652262279,0,inbound,4382bb696d0c4d5b2cc151661aec535ee417ca0db7a817683fff8539b29fc457
740,35B1PCjCRGuF7cntDdojn7BuHjkEAKQFUY,1235,1657310,1657310,1671401108,1671389808,0,inbound,4382bb696d0c4d5b2cc151661aec535ee417ca0db7a817683fff8539b29fc457
741,34sKJ2yKoGMdYiYFiqtqqToJEVJZwcvvkK,1236,80000,0,1671389808,1671389808,80000,inbound,4382bb696d0c4d5b2cc151661aec535ee417ca0db7a817683fff8539b29fc457
742,bc1qljx55d44gvaxxuttrrkkrse8fxkrd2f7tsa4yj,1237,116927369,116909668,1680075639,1664760043,17701,inbound,4382bb696d0c4d5b2cc151661aec535ee417ca0db7a817683fff8539b29fc457
743,3HKf3tXDH6yF9gB34hnPutxRfUL85mucGd,1238,25227732878,25127752878,1681107229,1641457819,99980000,outbound,4382bb696d0c4d5b2cc151661aec535ee417ca0db7a817683fff8539b29fc457
744,bc1q3yvlk96muvjyt3mp487dg2ljnmdu8hqynn5mww,1239,332530,332530,1671398017,1671389808,0,inbound,4382bb696d0c4d5b2cc151661aec535ee417ca0db7a817683fff8539b29fc457
745,bc1q967smj8rrnveytqfusgwl38hjd4q62emsup8mj,1240,30358494,0,1671389808,1671391128,30358494,inbound,4382bb696d0c4d5b2cc151661aec535ee417ca0db7a817683fff8539b29fc457
746,bc1q32l078mys7j2cm7etmqzjt69vp646chxt2nvrs,1241,487004,0,1671389808,1671389808,487004,inbound,4382bb696d0c4d5b2cc151661aec535ee417ca0db7a817683fff8539b29fc457
747,19GPudzF38pMxs6cPgeusrTKjNW8Ju7urW,1242,608694,608694,1671390666,1671389808,0,inbound,4382bb696d0c4d5b2cc151661aec535ee417ca0db7a817683fff8539b29fc457
748,19t1o23V6XmYB3meXz5hf5Pqo4AqrGq1Uv,1243,17872000,17872000,1671394832,1671389808,0,inbound,4382bb696d0c4d5b2cc151661aec535ee417ca0db7a817683fff8539b29fc457
749,bc1qcwg0970mszcr99vg4w0w8eyt4amawc4g8um2j7,1244,696267,696267,1671416559,1652297692,0,inbound,4382bb696d0c4d5b2cc151661aec535ee417ca0db7a817683fff8539b29fc457
750,328Eyf4wicuUghsxHnVCTkJgoxaoMpkfnk,1245,239131,0,1671389808,1664011003,239131,inbound,4382bb696d0c4d5b2cc151661aec535ee417ca0db7a817683fff8539b29fc457
751,bc1qwupqp90x4pan4sxu5skcyv9qlnpulgyqxce8pr,1246,1567437,0,1671389808,1671389808,1567437,inbound,4382bb696d0c4d5b2cc151661aec535ee417ca0db7a817683fff8539b29fc457
752,bc1qdpzfs8c8xhhmd9tswc4s2fky2yw6ys74yyyr5p,1247,16520759,16520759,1671392945,1671389808,0,inbound,4382bb696d0c4d5b2cc151661aec535ee417ca0db7a817683fff8539b29fc457
753,bc1qgcukx9kpwce8kuxqaqph0e9k84z62k2fatjtna,1248,5433830,0,1671651077,1671389808,5433830,inbound,4382bb696d0c4d5b2cc151661aec535ee417ca0db7a817683fff8539b29fc457
754,bc1qp3u3hhexj6k560ms4eaaqt0ququxry7ym33eas,1249,4950947,4950947,1675565430,1671252766,0,inbound,4382bb696d0c4d5b2cc151661aec535ee417ca0db7a817683fff8539b29fc457
755,3HdKNYrcRZMDzkWZJKjYbk5XW7fJxLoxzy,1698,2019205,2019205,1670839559,1670762209,0,inbound,4382bb696d0c4d5b2cc151661aec535ee417ca0db7a817683fff8539b29fc457
756,bc1qfzzr8d00824y625dw7kudg7uln9wx4p3fwpj7q,1699,253199994,252173371,1681035851,1676098635,1026623,outbound,4382bb696d0c4d5b2cc151661aec535ee417ca0db7a817683fff8539b29fc457
757,3FG9dBNRs6ccbbb674kKbt1APoVn1Lt7Ev,1700,1649875220,1649875220,1679705922,1670072686,0,inbound,4382bb696d0c4d5b2cc151661aec535ee417ca0db7a817683fff8539b29fc457
758,bc1qq4ycyhrqw5wee4f24tsvrde3hh90gwkkxhnr94,1701,5296666,0,1670762209,1670762209,5296666,inbound,4382bb696d0c4d5b2cc151661aec535ee417ca0db7a817683fff8539b29fc457
759,3QptzrDhZVkGK8VaVQHv6NxNbVGpjTwobb,1702,172000,172000,1673712850,1670762209,0,inbound,4382bb696d0c4d5b2cc151661aec535ee417ca0db7a817683fff8539b29fc457
760,bc1q57p4r6y9v9y83s7yux0zka58mv2xnk4smf6jsq,1703,1087576,1087576,1671177609,1670762209,0,inbound,4382bb696d0c4d5b2cc151661aec535ee417ca0db7a817683fff8539b29fc457
761,bc1qcsmn0n59m5ws4knc4n76zj79dm20pupgjmxajr,1704,3492440,3492440,1677089914,1670575488,0,inbound,4382bb696d0c4d5b2cc151661aec535ee417ca0db7a817683fff8539b29fc457
762,bc1qc90j0wl8l5dv94hdhjcx6ty65lnjevhety25qx,1705,2690063,0,1670762209,1670762209,2690063,inbound,4382bb696d0c4d5b2cc151661aec535ee417ca0db7a817683fff8539b29fc457
763,1FTknQBAyQUzskRfg47ffLJdZH2U4S6CkF,1706,2353000,2353000,1678972697,1663765155,0,inbound,4382bb696d0c4d5b2cc151661aec535ee417ca0db7a817683fff8539b29fc457
764,3EaVed2dMQ3QVMaghraUhEmQa6Kv1jcpP9,1707,16590147,16590147,1671593681,1652564774,0,outbound,4382bb696d0c4d5b2cc151661aec535ee417ca0db7a817683fff8539b29fc457
765,3Eq381WU63rMRb9tfqVBACypqGjynCB91F,1708,4507439,4507439,1671326031,1627453281,0,inbound,4382bb696d0c4d5b2cc151661aec535ee417ca0db7a817683fff8539b29fc457
766,37s3TVLWq8Qh3bdpBGerTZMaWh5fjXPHSA,1709,22956000,22956000,1676919813,1671044115,0,inbound,4382bb696d0c4d5b2cc151661aec535ee417ca0db7a817683fff8539b29fc457
767,3514NSrCCUQJY1hT58p5m3LWAqo6t5usfK,1710,6253419,6253419,1671446718,1638481414,0,inbound,4382bb696d0c4d5b2cc151661aec535ee417ca0db7a817683fff8539b29fc457
768,1QFyeumXc3ibtSHMNYh2gsHYGpH98VUiZS,1711,9468935,9468935,1680866333,1665812384,0,inbound,4382bb696d0c4d5b2cc151661aec535ee417ca0db7a817683fff8539b29fc457
769,3Dwehtb3W3DjvcNLmP8uou1HkGYkvssXdq,1712,4208841,4208841,1678828548,1666219394,0,inbound,4382bb696d0c4d5b2cc151661aec535ee417ca0db7a817683fff8539b29fc457
770,bc1q5zald3zst3xr0cchua58mvsepz392rarx0ly9z,1713,248209838,248209838,1677859689,1673527582,0,inbound,4382bb696d0c4d5b2cc151661aec535ee417ca0db7a817683fff8539b29fc457
771,bc1qjs66kzuc2exa78h397gxa720galzjnwend763u,1714,559000,559000,1670766015,1670761449,0,inbound,4382bb696d0c4d5b2cc151661aec535ee417ca0db7a817683fff8539b29fc457
772,bc1qazqn558gt5f037z6zltykuxyvh986u8n5kr3j0,1715,28799964,28787804,1678786388,1667472524,12160,outbound,4382bb696d0c4d5b2cc151661aec535ee417ca0db7a817683fff8539b29fc457
773,bc1qlzl2lywy5eghgnkpvtwc62ss5wk2mww04j9w9r,1716,328650,328650,1671556985,1670761449,0,inbound,4382bb696d0c4d5b2cc151661aec535ee417ca0db7a817683fff8539b29fc457
774,bc1q9egacdyj9xcpzftjgkl5px4gtywwfw3cptcm3r,1717,357000,357000,1670782545,1670761449,0,inbound,4382bb696d0c4d5b2cc151661aec535ee417ca0db7a817683fff8539b29fc457
775,1LvZta8o4B4j51RJEU7kgZ1wSPfsdDFW5S,1718,363000,363000,1670761842,1670761449,0,inbound,4382bb696d0c4d5b2cc151661aec535ee417ca0db7a817683fff8539b29fc457
776,bc1qa84vedu7wmms83r68q6p4r7hj3zgte3ncwst9z,1719,771129,770122,1672055962,1670761449,1007,inbound,4382bb696d0c4d5b2cc151661aec535ee417ca0db7a817683fff8539b29fc457
777,bc1qrgvq8w9yrlh6ya3jysejh75nj4vua9utwpx7rf,1720,400000,0,1670761449,1670761449,400000,inbound,4382bb696d0c4d5b2cc151661aec535ee417ca0db7a817683fff8539b29fc457
778,bc1quehwkm0lz68le873907ules7khy68n4hxq84ct,1721,41872076,41869884,1673566059,1662732638,2192,inbound,4382bb696d0c4d5b2cc151661aec535ee417ca0db7a817683fff8539b29fc457
779,3QeMes5aTgtwuG4MzFaQxKTtwB8M2SzgrJ,1722,26899831,26624831,1681107136,1673206639,275000,outbound,4382bb696d0c4d5b2cc151661aec535ee417ca0db7a817683fff8539b29fc457
780,bc1ql3dp5zxzt4nde6vp8lj3c5et8d84rzsjasa0wp,1723,522044001,522044001,1681076214,1675271650,0,outbound,4382bb696d0c4d5b2cc151661aec535ee417ca0db7a817683fff8539b29fc457
781,1Nt9yRYdgzVh2fBWcbpCsYsRmx6LgQtYY6,1724,6227000,6227000,1670771209,1670760048,0,inbound,4382bb696d0c4d5b2cc151661aec535ee417ca0db7a817683fff8539b29fc457
782,3ACFhLzuoiadsD7Faba4SbGNRd4QJT89Qc,1725,25194000,25194000,1672360895,1665253140,0,inbound,4382bb696d0c4d5b2cc151661aec535ee417ca0db7a817683fff8539b29fc457
783,bc1qjauauk5d03rj8ynm5acjq874seen2ae423nxyy,1726,560300,560300,1670762271,1670761449,0,inbound,4382bb696d0c4d5b2cc151661aec535ee417ca0db7a817683fff8539b29fc457
784,bc1q8yakhanmflzyf0qcqzluagmtw5mkp40dn35872,1727,773154,562000,1670772194,1670761449,211154,inbound,4382bb696d0c4d5b2cc151661aec535ee417ca0db7a817683fff8539b29fc457
785,122M5Y38NymAxyAZSoXKFG14obqSHXnGz5,1728,588000,588000,1670761621,1670761449,0,inbound,4382bb696d0c4d5b2cc151661aec535ee417ca0db7a817683fff8539b29fc457
786,bc1qypdcq4lepr7gh3dqkp2yv9sj9s0rta7q8rlaxe,1729,79282805,79282805,1670762291,1663113727,0,inbound,4382bb696d0c4d5b2cc151661aec535ee417ca0db7a817683fff8539b29fc457
787,bc1q7sleyggegfss2wrvlcwdks50m9cqdj5j5c96dr,1730,2796830,2796830,1675014734,1664345559,0,inbound,4382bb696d0c4d5b2cc151661aec535ee417ca0db7a817683fff8539b29fc457
788,bc1q7rsh25kxwuv3wtmdsa3vtz4ztptgwvqgzms4yv,1731,4093363,4093363,1670972980,1670525017,0,inbound,4382bb696d0c4d5b2cc151661aec535ee417ca0db7a817683fff8539b29fc457
789,1LxUzEEnQQe9whq5Jszs3iChu4xYykGrjg,1732,619000,619000,1670930789,1670761449,0,inbound,4382bb696d0c4d5b2cc151661aec535ee417ca0db7a817683fff8539b29fc457
790,bc1q960j7l2qy6yzknwpufl5mg9axyhw0zmyec4qyv,1733,681000,0,1670761449,1670761449,681000,inbound,4382bb696d0c4d5b2cc151661aec535ee417ca0db7a817683fff8539b29fc457
791,3Gyke6u6AZ4dWd1LF2uccpJEniuz2DeHWE,1734,738000,0,1670761449,1670761449,738000,inbound,4382bb696d0c4d5b2cc151661aec535ee417ca0db7a817683fff8539b29fc457
792,bc1qmsglu7ew7unua8cy7ekkxvfzcv9nzczlgttylf,1735,2713366,2545741,1671801328,1648417007,167625,inbound,4382bb696d0c4d5b2cc151661aec535ee417ca0db7a817683fff8539b29fc457
793,18EicenjZ6y8gdwuZ6fYwQz1B69Rronajv,1736,1071000,1071000,1670763669,1670761449,0,inbound,4382bb696d0c4d5b2cc151661aec535ee417ca0db7a817683fff8539b29fc457
794,398skynBFukTyBNCCmcCGjdNN8g6odGVF7,86,38854,38854,1677951036,1674696303,0,inbound,dce574f2f8283a45c76d37773fe49bf2c04320cf91af3d9917bfd47926340c4f
795,345QvTKjrXZvDAMQaQQz9YzRtahoP3CxLS,390,400800,400800,1672375676,1672364206,0,inbound,dce574f2f8283a45c76d37773fe49bf2c04320cf91af3d9917bfd47926340c4f
796,bc1qk9xmsju2lldu3s5y4f2e65c9q0v2d777a8ppk2,553,24908902,24908902,1679613739,1645004929,0,inbound,dce574f2f8283a45c76d37773fe49bf2c04320cf91af3d9917bfd47926340c4f
797,bc1qsaq9q9n4m3f0kzsemv49gy9zuptau9mpv2c6t64hnk9qn0rfx4nqkxsf3j,784,783749,783749,1672088108,1672082849,0,inbound,dce574f2f8283a45c76d37773fe49bf2c04320cf91af3d9917bfd47926340c4f
798,bc1qhuckmly8vr2uymc0skep4np4cyp3kf9n7dgn0f,948,402777,0,1671799967,1671799967,402777,inbound,dce574f2f8283a45c76d37773fe49bf2c04320cf91af3d9917bfd47926340c4f
799,3DiXJYr4K6r7MNMDB2fwKnkPDzqqj67zgY,1250,3118000,3118000,1671411281,1671389808,0,inbound,dce574f2f8283a45c76d37773fe49bf2c04320cf91af3d9917bfd47926340c4f
800,bc1ql7ac056tkev3ctzlhjqt06a7tq5xpegdt0gzk3,1737,16174000,16174000,1671740575,1669246506,0,inbound,dce574f2f8283a45c76d37773fe49bf2c04320cf91af3d9917bfd47926340c4f
801,bc1qjuyaneay66w5pnhxky3xw2tn4fj7jf5j5n7jfn,87,119439,119439,1674704270,1674696302,0,inbound,95818e024a3165fc2b8ddaed0e2a269bd3bbb192aba98b38d823f75c484feff6
802,3Np4QC4Mykt77w24Kn8PRnQZCgtZZpU9JB,88,3817355,3817355,1679283104,1674535962,0,inbound,95818e024a3165fc2b8ddaed0e2a269bd3bbb192aba98b38d823f75c484feff6
803,bc1q2fhxuxguqxqpe3u6ss0lxwq68q58tf0mszqd24req5vcnuanph0qfgg7d2,89,7336497,7336497,1674711408,1674696302,0,inbound,95818e024a3165fc2b8ddaed0e2a269bd3bbb192aba98b38d823f75c484feff6
804,bc1qqxsgm4v3jhtc3rm3dtlvgvc2z0g8lxr8qujgrc,90,47339701,47339701,1674701305,1674696302,0,inbound,95818e024a3165fc2b8ddaed0e2a269bd3bbb192aba98b38d823f75c484feff6
805,37Zx8KhkMyGvEdDx9vRxaTYA4ExUDVb4nB,91,1663075,1663075,1675264421,1674410231,0,inbound,95818e024a3165fc2b8ddaed0e2a269bd3bbb192aba98b38d823f75c484feff6
806,32i4U8DBovk26Xt4krcFXfgMEY3cUQhpFw,391,3131511533,3131511533,1673374579,1622746144,0,inbound,95818e024a3165fc2b8ddaed0e2a269bd3bbb192aba98b38d823f75c484feff6
807,17AQV2fUxDb19kiVckroLF74mR9dR9gEbu,392,11506390000,11506390000,1672436954,1672238567,0,inbound,95818e024a3165fc2b8ddaed0e2a269bd3bbb192aba98b38d823f75c484feff6
808,33ooJBBqNjg7zUYBdAjh7N9vp16h6ZfBt8,393,30519282,30519282,1680630617,1665801643,0,inbound,95818e024a3165fc2b8ddaed0e2a269bd3bbb192aba98b38d823f75c484feff6
809,bc1q7fm92zvwf9yetpzg7dadr3k8usslhe2g6aq3y2,394,1730000,1730000,1672744365,1672364206,0,inbound,95818e024a3165fc2b8ddaed0e2a269bd3bbb192aba98b38d823f75c484feff6
810,bc1qgpx6se07ej50ep3cy5yjtmn83gnanhmjnq44ua,395,980000,0,1672354835,1672354835,980000,inbound,95818e024a3165fc2b8ddaed0e2a269bd3bbb192aba98b38d823f75c484feff6
811,15PWSX8n5MmUjqwTp5irVtx8c8ubXWym6Q,554,175933,175933,1672265129,1672264538,0,inbound,95818e024a3165fc2b8ddaed0e2a269bd3bbb192aba98b38d823f75c484feff6
812,3AL94co97tH1B2K7mscCHSMYDgGeuWeJqX,555,159761943,158038547,1680900330,1669755992,1723396,inbound,95818e024a3165fc2b8ddaed0e2a269bd3bbb192aba98b38d823f75c484feff6
813,bc1qrmcw77dku4z0hee7r87cwhmy5tuuc6c0jjknhk,556,3517448,3517448,1672339426,1672264538,0,inbound,95818e024a3165fc2b8ddaed0e2a269bd3bbb192aba98b38d823f75c484feff6
814,32DXFcEQyfE5f2mvgPueuJ7sB3xhhuDj91,557,54760892,54760892,1680900716,1676233883,0,outbound,95818e024a3165fc2b8ddaed0e2a269bd3bbb192aba98b38d823f75c484feff6
815,bc1qgfnu5vfj7q857xjvvca36we4dw0pk2j5m4av33,558,150955156,150955156,1676170036,1673118799,0,inbound,95818e024a3165fc2b8ddaed0e2a269bd3bbb192aba98b38d823f75c484feff6
816,3BvVsTEcdmf9wNX9EDJhe91MtgU3ur3SXG,785,1005043,1005043,1672258046,1672082849,0,inbound,95818e024a3165fc2b8ddaed0e2a269bd3bbb192aba98b38d823f75c484feff6
817,bc1qdkplh6c9ze66n8qq9slseam6esl3xsdjtakzm2,786,1424916,1424916,1672151218,1672082849,0,inbound,95818e024a3165fc2b8ddaed0e2a269bd3bbb192aba98b38d823f75c484feff6
818,339ranKa3fz8ecEvti9cftTQmfPgYyK3Ax,787,277069,277069,1672164145,1672082849,0,inbound,95818e024a3165fc2b8ddaed0e2a269bd3bbb192aba98b38d823f75c484feff6
819,366cSxHXQXNeq4bfK9oKv8H3uW9p98h1wZ,788,19800711,19292776,1680239503,1675317743,507935,outbound,95818e024a3165fc2b8ddaed0e2a269bd3bbb192aba98b38d823f75c484feff6
820,1Ak2oz7mQniQD2qW8vhqv3o5FifoYEfEAd,789,57400457,57400457,1680278599,1639186914,0,inbound,95818e024a3165fc2b8ddaed0e2a269bd3bbb192aba98b38d823f75c484feff6
821,32fvADhb637r32kQDaVmR8rEN3NBUSVZ1q,949,8162176,8162176,1671981301,1671799967,0,inbound,95818e024a3165fc2b8ddaed0e2a269bd3bbb192aba98b38d823f75c484feff6
822,bc1qxnz3vnjegkpgj00kfkqv8rx6n3vqle6ctht945,950,225886638,225880543,1681134459,1673662931,6095,inbound,95818e024a3165fc2b8ddaed0e2a269bd3bbb192aba98b38d823f75c484feff6
823,1NBSAB1xtgN5BUbUJJtoe8ejySzmqwBjHG,951,44825682065422,44822100825422,1681143031,1680914507,3581240000,outbound,95818e024a3165fc2b8ddaed0e2a269bd3bbb192aba98b38d823f75c484feff6
824,1CS5Tetn3v5f43tDkBeeeV17b6cwVWfJpf,952,49621838,49621838,1672155528,1671799967,0,inbound,95818e024a3165fc2b8ddaed0e2a269bd3bbb192aba98b38d823f75c484feff6
825,17pKgyGnkawfN1EMsKi8iYjPP1g7zEAMxm,953,54016864,0,1671799967,1671799967,54016864,inbound,95818e024a3165fc2b8ddaed0e2a269bd3bbb192aba98b38d823f75c484feff6
826,bc1qx9v5m2cmy0ffllwmm0x4tqd24s3rkssjyeuxvp,1251,3817300,0,1671389808,1671389808,3817300,inbound,95818e024a3165fc2b8ddaed0e2a269bd3bbb192aba98b38d823f75c484feff6
827,37m3aRM7TPgtJPDLNgWxA31AAnuhL15pHP,1252,38092801,38092801,1680031757,1664976164,0,inbound,95818e024a3165fc2b8ddaed0e2a269bd3bbb192aba98b38d823f75c484feff6
828,bc1q6577j8ps2zx56ar3rj8rzssfsm7rs6vhyr8qhc,1253,6445745,0,1676292058,1671389997,6445745,inbound,95818e024a3165fc2b8ddaed0e2a269bd3bbb192aba98b38d823f75c484feff6
829,bc1qg848zldka2fge6ztn34r4m05myc46kq2vaxaen,1254,1867801,1867801,1671621347,1671389808,0,inbound,95818e024a3165fc2b8ddaed0e2a269bd3bbb192aba98b38d823f75c484feff6
830,bc1q564fnmnhq88h46rw6azdycyxjdjqxvmk8avh5s,1255,3095484,0,1671389808,1671389808,3095484,inbound,95818e024a3165fc2b8ddaed0e2a269bd3bbb192aba98b38d823f75c484feff6
831,bc1q6fk7wk6uf32fgh0glr22423hnwndswqjqusdww,1738,1127000,1127000,1670761716,1670761449,0,inbound,95818e024a3165fc2b8ddaed0e2a269bd3bbb192aba98b38d823f75c484feff6
832,bc1qz5ettq59jkd33sr9cw3rrnxtd0eja67a6gw0wu,1739,12794096,12782200,1678738166,1661698266,11896,inbound,95818e024a3165fc2b8ddaed0e2a269bd3bbb192aba98b38d823f75c484feff6
833,14zJRkvPpffcqa5NpsfP9Nn8AnPYzjCdRz,1740,28309119,28309119,1674928711,1663932470,0,inbound,95818e024a3165fc2b8ddaed0e2a269bd3bbb192aba98b38d823f75c484feff6
834,32a73qJ8PYBQrCTitErNoeRrbtn2dmcKim,1741,126119030,126119030,1676809869,1666147020,0,inbound,95818e024a3165fc2b8ddaed0e2a269bd3bbb192aba98b38d823f75c484feff6
835,bc1q6nuq83r6gvc6yu5a7s3mjtvrn905gvswy83q4p,1742,158565123,158565123,1673604421,1668582016,0,inbound,95818e024a3165fc2b8ddaed0e2a269bd3bbb192aba98b38d823f75c484feff6
836,16WS1FYerHpe5vUErCPLuiDyHmJjwUk2Ea,92,470804509,470804509,1676138282,1675270929,0,inbound,67af70604a7ba416de056a38623ff4eb8ab7c283462242468b05f8aff3cf2cf1
837,3NX969VZQ7ZgcSNiET6kqE15LDsKQ3T4Ld,93,406075,406075,1674553834,1674410231,0,inbound,67af70604a7ba416de056a38623ff4eb8ab7c283462242468b05f8aff3cf2cf1
838,bc1qqks5rymtchscfsavmz8zkduq7mx95kftsncdxmgp3zwycdpqxg3qgl7uxh,94,11981129,11981129,1680217724,1668826868,0,inbound,67af70604a7ba416de056a38623ff4eb8ab7c283462242468b05f8aff3cf2cf1
839,3DKgbGzR8VWtcSRdJ25XYYdw3pT9FoCj5R,95,168626258,158995131,1681048979,1681087808,9631127,inbound,67af70604a7ba416de056a38623ff4eb8ab7c283462242468b05f8aff3cf2cf1
840,34S8LDgbyD8jTYUPr2sooLYWZRC9tiMaH9,96,153569,153569,1675126299,1674410231,0,inbound,67af70604a7ba416de056a38623ff4eb8ab7c283462242468b05f8aff3cf2cf1
841,bc1qc6sguaha040f384hq560jwyvjw4a08f2lperua,97,242326,242326,1676045498,1674410231,0,inbound,67af70604a7ba416de056a38623ff4eb8ab7c283462242468b05f8aff3cf2cf1
842,1AzqpPhFgpCU2GgzjfNZy9X2SEQae2of9A,98,188426607,188426607,1680804136,1668297704,0,outbound,67af70604a7ba416de056a38623ff4eb8ab7c283462242468b05f8aff3cf2cf1
843,1LbQL7jc7reYizoZVz5RsBSmuJek6Nu8GD,99,647511898,647511898,1681020673,1650034090,0,outbound,67af70604a7ba416de056a38623ff4eb8ab7c283462242468b05f8aff3cf2cf1
844,35Wwrbnv3ewKfbfgJraqK6cJ77K78P9kXX,100,547571909,547571909,1680919757,1679038326,0,inbound,67af70604a7ba416de056a38623ff4eb8ab7c283462242468b05f8aff3cf2cf1
845,36ZLs8SsMq6PRw6uTNoCniNPsBsmYeMWg6,101,312651,312651,1674432212,1674410231,0,inbound,67af70604a7ba416de056a38623ff4eb8ab7c283462242468b05f8aff3cf2cf1
846,bc1qltf0ypcvckac8e6t76w8cme5fwt3ulehvqr8v5,102,653108,653108,1674428674,1673091851,0,inbound,67af70604a7ba416de056a38623ff4eb8ab7c283462242468b05f8aff3cf2cf1
847,1Aoiy2Rzu1zUa2yXv3jVu89w3oMwXN7C3t,103,65124,65124,1676927835,1674410231,0,inbound,67af70604a7ba416de056a38623ff4eb8ab7c283462242468b05f8aff3cf2cf1
848,33CTXXKvYnGzG2My7U7Y81VSsvYkCjsS2H,104,1243254,1243254,1674432214,1674410231,0,inbound,67af70604a7ba416de056a38623ff4eb8ab7c283462242468b05f8aff3cf2cf1
849,bc1qu3pfr6hk7rn36ae2etc6rhdagaec4c9a32hgk8,105,108389,108389,1674410438,1674410231,0,inbound,67af70604a7ba416de056a38623ff4eb8ab7c283462242468b05f8aff3cf2cf1
850,bc1qakugda7p48pud2tmqx22e24mm0nfr7qn2ajh8k,106,774466,774466,1674411893,1674410231,0,inbound,67af70604a7ba416de056a38623ff4eb8ab7c283462242468b05f8aff3cf2cf1
851,bc1q2dk62hy8a4tsjm2ckaqzcsc4uuh2vu5qcmpezt,107,1433387,0,1674410231,1674410231,1433387,inbound,67af70604a7ba416de056a38623ff4eb8ab7c283462242468b05f8aff3cf2cf1
852,3MJZqzujTH192VzhHzCJzfNpkfBeh4c6hu,108,620675,620675,1674551279,1674410231,0,inbound,67af70604a7ba416de056a38623ff4eb8ab7c283462242468b05f8aff3cf2cf1
853,bc1q5eg9y48xc27wc3mu8panft6968rjymrz7wk0cu,109,337569,337569,1674410629,1674410231,0,inbound,67af70604a7ba416de056a38623ff4eb8ab7c283462242468b05f8aff3cf2cf1
854,bc1qc8nnd9tqqk3fmmru9c8d8avl38u6mrhd9sfuhk,110,487006369,487006369,1674653500,1663639748,0,inbound,67af70604a7ba416de056a38623ff4eb8ab7c283462242468b05f8aff3cf2cf1
855,3PAj1rFEJYfBauVEwU7Y9i8kgEVoFTLBVw,111,38500582,38500582,1675965748,1670308759,0,inbound,67af70604a7ba416de056a38623ff4eb8ab7c283462242468b05f8aff3cf2cf1
856,33NEo2ovCnn3zPgy17Degw3jhsEhVbKR4q,112,131996,131996,1674842550,1674410231,0,inbound,67af70604a7ba416de056a38623ff4eb8ab7c283462242468b05f8aff3cf2cf1
857,3G4xVAEay9YyUs3hTc6xzEQuAENsVmbfon,113,479875,479875,1674551288,1674410231,0,inbound,67af70604a7ba416de056a38623ff4eb8ab7c283462242468b05f8aff3cf2cf1
858,3H8Aqsz5cgrEjdXwF18KEsTR5MzUvjZw1d,114,436000,436000,1675120362,1674410231,0,inbound,67af70604a7ba416de056a38623ff4eb8ab7c283462242468b05f8aff3cf2cf1
859,bc1q8rtwfkup5k574pfj6p4uz0y9ujkj0nxckjjs82,115,392336,392336,1674498451,1674410231,0,inbound,67af70604a7ba416de056a38623ff4eb8ab7c283462242468b05f8aff3cf2cf1
860,bc1qnvwskma7hpkp6393w4lgp87q2arkwj86tnram6,116,99996350,0,1674410231,1674410231,99996350,inbound,67af70604a7ba416de056a38623ff4eb8ab7c283462242468b05f8aff3cf2cf1
861,bc1qvgfhv6qswnf5p53rcd5epz0gdzk7kc9ecf3j72,117,1291396,1291396,1676719243,1674410231,0,inbound,67af70604a7ba416de056a38623ff4eb8ab7c283462242468b05f8aff3cf2cf1
862,3CXA9xzb3ES54rYi2DM3QWr74yPFfUVMnb,118,487947,487947,1674551283,1674410231,0,inbound,67af70604a7ba416de056a38623ff4eb8ab7c283462242468b05f8aff3cf2cf1
863,bc1quxw0y80mgau8w0643a3f2u4sj4szptpgwczwvl,119,20106073,20106073,1680866657,1668168428,0,inbound,67af70604a7ba416de056a38623ff4eb8ab7c283462242468b05f8aff3cf2cf1
864,1Dm8EHf3hq9Fe2xfDNHfc1GteT68PijV91,120,38334,0,1674410231,1674410231,38334,inbound,67af70604a7ba416de056a38623ff4eb8ab7c283462242468b05f8aff3cf2cf1
865,33chKG6Smxr7b5Pz8JCGd4YFhzeK3kuKMv,121,1338002,1338002,1674483457,1674243610,0,inbound,67af70604a7ba416de056a38623ff4eb8ab7c283462242468b05f8aff3cf2cf1
866,19tRCXVJUfK2dxHxQiYmLDzscARF2c8vg1,122,286863455,286327101,1680701049,1649929976,536354,inbound,67af70604a7ba416de056a38623ff4eb8ab7c283462242468b05f8aff3cf2cf1
867,3ACyYDKo8wv8hGV8DJ7vPSTeVmK8B6HyQu,123,222654,222654,1674432211,1674410231,0,inbound,67af70604a7ba416de056a38623ff4eb8ab7c283462242468b05f8aff3cf2cf1
868,3GxEDPz3XrQRV9qTZU8oyKKvSakdGYZqdP,124,135167,135167,1674432210,1674410231,0,inbound,67af70604a7ba416de056a38623ff4eb8ab7c283462242468b05f8aff3cf2cf1
869,3CAD6S9fAGWqkWHudm8Un8tEGrT8dQoQcs,125,155272,155272,1674457957,1674410231,0,inbound,67af70604a7ba416de056a38623ff4eb8ab7c283462242468b05f8aff3cf2cf1
870,bc1qpmw28048hrgq6v79xzjgws5pzx0znhmd3837c7,126,1243248,1218170,1680346401,1674410231,25078,inbound,67af70604a7ba416de056a38623ff4eb8ab7c283462242468b05f8aff3cf2cf1
871,bc1qqlrcm4r6z4mpcfm0m87tagllrwckaz865xgp2g,127,1336324,1336324,1674703241,1674410231,0,inbound,67af70604a7ba416de056a38623ff4eb8ab7c283462242468b05f8aff3cf2cf1
872,bc1qh3r0gjhe0xshzqypkuf26r624yjkm4sa2m6vzv,128,7090178,7090178,1678693542,1671170708,0,inbound,67af70604a7ba416de056a38623ff4eb8ab7c283462242468b05f8aff3cf2cf1
873,bc1qacxaqvecfz4gqchsw53ptvwnfgrd9ka4qd3hzq,129,5321907,5321907,1676263946,1671578889,0,inbound,67af70604a7ba416de056a38623ff4eb8ab7c283462242468b05f8aff3cf2cf1
874,bc1qry4d6k9ces5m4ynln6c26sztq3hkr5vchlkdaj,130,36617871,0,1674410231,1674150009,36617871,inbound,67af70604a7ba416de056a38623ff4eb8ab7c283462242468b05f8aff3cf2cf1
875,16cPtarNM8JekGEdoacu2ekcAJrVkZt7Wt,131,471936,471936,1674486220,1674410231,0,inbound,67af70604a7ba416de056a38623ff4eb8ab7c283462242468b05f8aff3cf2cf1
876,1C3UmCYDXrwmofJmPefd33oPPSfj3GXUvh,132,282716,282716,1674443899,1674410231,0,inbound,67af70604a7ba416de056a38623ff4eb8ab7c283462242468b05f8aff3cf2cf1
877,194Bp2aCsXvuCUDgfQyGAGw8pi9AoxWkzN,133,915929,915929,1674412514,1674410231,0,inbound,67af70604a7ba416de056a38623ff4eb8ab7c283462242468b05f8aff3cf2cf1
878,39qHamcTpZaQEgHm4XseZjKFcGaEuAZzuJ,134,4237347,4237347,1674432044,1589166822,0,inbound,67af70604a7ba416de056a38623ff4eb8ab7c283462242468b05f8aff3cf2cf1
879,bc1qmw7974de3vpv0cff243tdunglvsnaysw6neym3,135,770375,770375,1680343750,1674410231,0,inbound,67af70604a7ba416de056a38623ff4eb8ab7c283462242468b05f8aff3cf2cf1
880,3684CsygV34ytyXfrBtbk886tyQdUD5Uki,136,9637292,0,1674410231,1674410231,9637292,inbound,67af70604a7ba416de056a38623ff4eb8ab7c283462242468b05f8aff3cf2cf1
881,3NcypKhLxQ8haA6vXZRLXhjNUfF4okKPyx,137,574010,574010,1674432204,1648415408,0,inbound,67af70604a7ba416de056a38623ff4eb8ab7c283462242468b05f8aff3cf2cf1
882,1MYA1vVrYN6jzJgcSM9DsCNuyaaQKHiFs7,138,2460758,2460758,1680609876,1666214431,0,inbound,67af70604a7ba416de056a38623ff4eb8ab7c283462242468b05f8aff3cf2cf1
883,163a81voq4t3X1mg3xwuLFi1xojjhNYrcY,139,164612,152840,1679400049,1673923946,11772,inbound,67af70604a7ba416de056a38623ff4eb8ab7c283462242468b05f8aff3cf2cf1
884,bc1qlm2fsucgzuzjy7gd9emsdaexzjfzuudf23nh3p,140,149984,149984,1674523769,1674410231,0,inbound,67af70604a7ba416de056a38623ff4eb8ab7c283462242468b05f8aff3cf2cf1
885,3LKuHhRAA3yqxREMeBF1gUqKB3f2oCYzTm,141,165794,165794,1674842561,1674410231,0,inbound,67af70604a7ba416de056a38623ff4eb8ab7c283462242468b05f8aff3cf2cf1
886,3FhU3MGKmsetPjRPgtKTUtdX74UXkvNQhJ,142,662186,662186,1674432214,1674410231,0,inbound,67af70604a7ba416de056a38623ff4eb8ab7c283462242468b05f8aff3cf2cf1
887,bc1qy9h9l9pmrjxnd9g4s607t002xwvjr62shu0ay7,143,2604269,2604269,1674436836,1673284698,0,inbound,67af70604a7ba416de056a38623ff4eb8ab7c283462242468b05f8aff3cf2cf1
888,3Ay6z3hC8dHHuW5F9exi4Sxo4ndAQwLxwr,144,45065346,44148791,1681048807,1677294487,916555,inbound,67af70604a7ba416de056a38623ff4eb8ab7c283462242468b05f8aff3cf2cf1
889,1MHGKALUCS6x8cNYrE5VxyZnkQFCQocJUy,145,52210,0,1674410231,1674410231,52210,inbound,67af70604a7ba416de056a38623ff4eb8ab7c283462242468b05f8aff3cf2cf1
890,3LrXsChhXmiyGXyU1PsKrmKd5XFdxh1U6e,146,2036595,2036595,1675264421,1674410231,0,inbound,67af70604a7ba416de056a38623ff4eb8ab7c283462242468b05f8aff3cf2cf1
891,36Hrede1iDAFffda7EgJeDHABWJ1SoGEnz,147,38294053,38294053,1676796239,1672369027,0,inbound,67af70604a7ba416de056a38623ff4eb8ab7c283462242468b05f8aff3cf2cf1
892,12XgnfNvdxJnn65hjXWPEMuYcUHqzuMFqg,148,222704,222704,1674446211,1674410231,0,inbound,67af70604a7ba416de056a38623ff4eb8ab7c283462242468b05f8aff3cf2cf1
893,1QETCf4pGNLNTCHHu1HwSxmpNsXLZQRte,149,1052226,1052226,1674417612,1674410231,0,inbound,67af70604a7ba416de056a38623ff4eb8ab7c283462242468b05f8aff3cf2cf1
894,bc1qmesh4tlg4k2z5ndkpd2gq5v0yjwxzeu0autcc8,150,2147087,2147087,1675941097,1673630686,0,inbound,67af70604a7ba416de056a38623ff4eb8ab7c283462242468b05f8aff3cf2cf1
895,bc1qdfujcgly444s004fe2nzs9hdwm7nckhdt6qufv,396,1027335,1027335,1672355114,1672354835,0,inbound,67af70604a7ba416de056a38623ff4eb8ab7c283462242468b05f8aff3cf2cf1
896,bc1qgmme0ffzxyppkefeskfcdcz7uuv83tfyuny24n,397,14630061,2218269,1678729419,1669578428,12411792,inbound,67af70604a7ba416de056a38623ff4eb8ab7c283462242468b05f8aff3cf2cf1
897,38DfJFdLAz6cQj4RF7J5fdWjD62cBntZ35,398,800880,800880,1672272139,1666126465,0,inbound,67af70604a7ba416de056a38623ff4eb8ab7c283462242468b05f8aff3cf2cf1
898,1Jgd9JAEHS6Sm6j7VANuUAYiRL2EJjuBJZ,399,21569439,2974660,1679643191,1668377511,18594779,inbound,67af70604a7ba416de056a38623ff4eb8ab7c283462242468b05f8aff3cf2cf1
899,15LqXqAN1CJyWUrHN7M7waYpMhnRqAm4za,400,189592843,189592843,1680213751,1657662821,0,inbound,67af70604a7ba416de056a38623ff4eb8ab7c283462242468b05f8aff3cf2cf1
900,bc1q7cyrfmck2ffu2ud3rn5l5a8yv6f0chkp0zpemf,401,1269505605015524,1269367624567490,1681099285,1681094125,137980448034,outbound,67af70604a7ba416de056a38623ff4eb8ab7c283462242468b05f8aff3cf2cf1
901,3Ly4XvrVNSTZsrELbyyXsK35r6ZktG1SJR,402,149002,149002,1672772267,1672264538,0,inbound,67af70604a7ba416de056a38623ff4eb8ab7c283462242468b05f8aff3cf2cf1
902,bc1qjqwtx2q2m6998k4jgdkq72n0gxyy3kp3qd5hqh,403,51262080,50822080,1681087768,1673946263,440000,outbound,67af70604a7ba416de056a38623ff4eb8ab7c283462242468b05f8aff3cf2cf1
903,1KdVXAcMsee7hAVSdfTKugLyi5zwSPkWRc,404,84250368,84250368,1680733330,1668028537,0,inbound,67af70604a7ba416de056a38623ff4eb8ab7c283462242468b05f8aff3cf2cf1
904,3JtwMTyrASJ7KFsvchXCtwFrYQnriWyyok,405,63473,63473,1672272133,1672264538,0,inbound,67af70604a7ba416de056a38623ff4eb8ab7c283462242468b05f8aff3cf2cf1
905,1JqfHmeWD2JuC52H2xBX914gkSH2pPT1DS,406,151465,151465,1672304176,1672264538,0,inbound,67af70604a7ba416de056a38623ff4eb8ab7c283462242468b05f8aff3cf2cf1
906,1GAnEuq1kM8abdS4rtTH9nTusBkVzJrmqj,407,847252,847252,1672272617,1672264538,0,inbound,67af70604a7ba416de056a38623ff4eb8ab7c283462242468b05f8aff3cf2cf1
907,bc1q8g4gns844cvh8r65adv0fnmncf0vr5z4l93aja,408,484557,484557,1672287297,1672264538,0,inbound,67af70604a7ba416de056a38623ff4eb8ab7c283462242468b05f8aff3cf2cf1
908,3QZnBCkts4iVZhKWa4UPqEyrPoxzusGvE6,409,87068,87068,1672272048,1672264538,0,inbound,67af70604a7ba416de056a38623ff4eb8ab7c283462242468b05f8aff3cf2cf1
909,191msqeHmPeYz9hK8HG3jcRvKNkWq352D1,410,38936,38936,1672278676,1672264538,0,inbound,67af70604a7ba416de056a38623ff4eb8ab7c283462242468b05f8aff3cf2cf1
910,32fr3MdfJgfZkrCHKGdnp2SY2Q8mhF38E7,411,282519,282519,1672272140,1672264538,0,inbound,67af70604a7ba416de056a38623ff4eb8ab7c283462242468b05f8aff3cf2cf1
911,3MFetg8Eif7HaqbSCcUqsBTTaLjaszi6wp,412,698775,698775,1672524025,1672264538,0,inbound,67af70604a7ba416de056a38623ff4eb8ab7c283462242468b05f8aff3cf2cf1
912,3L9eaJge2MSW43h5bv9Wn8zZYQNMv4DjTR,413,63454,63454,1672272178,1672264538,0,inbound,67af70604a7ba416de056a38623ff4eb8ab7c283462242468b05f8aff3cf2cf1
913,3Qzdk6CY82AjMdW2CecpoDT2rAJpEA35GA,414,312113,312113,1672290097,1672264538,0,inbound,67af70604a7ba416de056a38623ff4eb8ab7c283462242468b05f8aff3cf2cf1
914,bc1qrfqyuyygtu95ush2psn6nnrhtmmqpzfztzu3tc,415,163578,163578,1673131408,1672264538,0,inbound,67af70604a7ba416de056a38623ff4eb8ab7c283462242468b05f8aff3cf2cf1
915,1CFiENn1K1DxvGvPgx2iSBgwGdaM9nNcDE,416,282610,282610,1672284855,1672264538,0,inbound,67af70604a7ba416de056a38623ff4eb8ab7c283462242468b05f8aff3cf2cf1
916,3LZp8whYEJtuJLdgKmSqA3GR1kDcCMkgmr,417,732250282,732229922,1680787577,1670885071,20360,inbound,67af70604a7ba416de056a38623ff4eb8ab7c283462242468b05f8aff3cf2cf1
917,3EEXvY7dg3xD6q9LghNsGZK14hD38kH2mN,418,1173567,1173567,1672524025,1672264538,0,inbound,67af70604a7ba416de056a38623ff4eb8ab7c283462242468b05f8aff3cf2cf1
918,bc1qntafle4mvqe45n4ww40x0h5p93matjxxhmmdk7,419,88289091,88264218,1681069295,1675660854,24873,outbound,67af70604a7ba416de056a38623ff4eb8ab7c283462242468b05f8aff3cf2cf1
919,32fT4npbi1CScfjLqrU6GAT2sBE7WHHRr9,420,1766170,1766170,1672299605,1672264538,0,inbound,67af70604a7ba416de056a38623ff4eb8ab7c283462242468b05f8aff3cf2cf1
920,3L4nJm4dWEY7pr94z8sUJzANYvWtydeLAb,421,524940461,524940461,1678698499,1677014103,0,outbound,67af70604a7ba416de056a38623ff4eb8ab7c283462242468b05f8aff3cf2cf1
921,1Bh7q12vAkuRkPKVtfv9iDDW5RfeFGVPan,422,14178915,14178915,1680185014,1673040131,0,outbound,67af70604a7ba416de056a38623ff4eb8ab7c283462242468b05f8aff3cf2cf1
922,bc1qluapx62e99s3f356zj4xecksdep9mc8x3mfn4h,423,183682989,129839376,1680712223,1652099294,53843613,inbound,67af70604a7ba416de056a38623ff4eb8ab7c283462242468b05f8aff3cf2cf1
923,bc1q7ehvf5jvhrqv8ntjw922mpepjhh4msqdvac2sl,559,227017753,227017753,1672278899,1672264538,0,inbound,67af70604a7ba416de056a38623ff4eb8ab7c283462242468b05f8aff3cf2cf1
924,38pVk3xgMnVFwRvRkG7C1SoNFkVeX7d7XM,560,41226661,40900569,1681115160,1672651972,326092,inbound,67af70604a7ba416de056a38623ff4eb8ab7c283462242468b05f8aff3cf2cf1
925,16hndKWnGPF5HTpHbbo2PjCzkCa4qUv52f,561,787763,787763,1672269199,1672264538,0,inbound,67af70604a7ba416de056a38623ff4eb8ab7c283462242468b05f8aff3cf2cf1
926,bc1qh99avrwvaw8gwctztg7m33j76ekn8y25a44atm,562,575434,575434,1672293637,1672264538,0,inbound,67af70604a7ba416de056a38623ff4eb8ab7c283462242468b05f8aff3cf2cf1
927,1KWhqT7X9WDvBdG2cfcNNsDqCgq8UWx2XT,563,17996018,17996018,1681063295,1668288636,0,inbound,67af70604a7ba416de056a38623ff4eb8ab7c283462242468b05f8aff3cf2cf1
928,35AxX8UbknrNdB6ZRag5NidQYJ42M4w4Pt,564,171593586,171554473,1681115159,1672264538,39113,inbound,67af70604a7ba416de056a38623ff4eb8ab7c283462242468b05f8aff3cf2cf1
929,3HFNdFfmtVQqRKDroNYxTwxogydge1KSub,565,2690781,2690781,1674075693,1672264538,0,inbound,67af70604a7ba416de056a38623ff4eb8ab7c283462242468b05f8aff3cf2cf1
930,bc1ql6exw2ys9yazqtsyh9gwxyxxd00855yutf9zmq,566,140200,140200,1672272310,1672264538,0,inbound,67af70604a7ba416de056a38623ff4eb8ab7c283462242468b05f8aff3cf2cf1
931,35FUEjPdCf5UN1cHJmA7pofZ4BQ8WcqHug,567,28144044,27818253,1676775680,1629445359,325791,outbound,67af70604a7ba416de056a38623ff4eb8ab7c283462242468b05f8aff3cf2cf1
932,3MAAFipkJqQj431HxkNaC5dCSfZYdD5K5k,568,12275063,12275063,1676707573,1672264538,0,inbound,67af70604a7ba416de056a38623ff4eb8ab7c283462242468b05f8aff3cf2cf1
933,32G4EcKFxje9FosaRh4Y4dr98kccwDS3NP,569,1306363147,1306363147,1681108158,1678680364,0,inbound,67af70604a7ba416de056a38623ff4eb8ab7c283462242468b05f8aff3cf2cf1
934,37cftPwx36AGDJFxW1PQ7mZG26fxrj3xsV,570,51599,51599,1672330786,1672264538,0,inbound,67af70604a7ba416de056a38623ff4eb8ab7c283462242468b05f8aff3cf2cf1
935,1EjVpsEcEmYn1HDNCVLVhYezkG8qc1aKSB,571,10799570,10799570,1672265767,1672263845,0,inbound,67af70604a7ba416de056a38623ff4eb8ab7c283462242468b05f8aff3cf2cf1
936,1DqHNMhyZnL6RcJZ92EA1aqKR1N6t6d68X,572,17912,17912,1672285156,1672264538,0,inbound,67af70604a7ba416de056a38623ff4eb8ab7c283462242468b05f8aff3cf2cf1
937,bc1qpdktk3atltc42dwq9dlvns0damxt2xs9alvnmx,573,163547,163547,1672273843,1672264538,0,inbound,67af70604a7ba416de056a38623ff4eb8ab7c283462242468b05f8aff3cf2cf1
938,389BS9NWtQuynncqrBVPt3Umqdfc56WwdT,574,208872650,208872650,1680073811,1675404197,0,outbound,67af70604a7ba416de056a38623ff4eb8ab7c283462242468b05f8aff3cf2cf1
939,167YsrM97ue6K86CP5hxSZeMPxSXEQWycP,575,622194097,622194097,1680912119,1679451576,0,inbound,67af70604a7ba416de056a38623ff4eb8ab7c283462242468b05f8aff3cf2cf1
940,3F8cHwYxMQTHsNxHm9EwibJ22SdMaRUT9G,576,121235,121235,1677149779,1672264538,0,inbound,67af70604a7ba416de056a38623ff4eb8ab7c283462242468b05f8aff3cf2cf1
941,3NrnGtGCsQsXSwvkHkbPDvSviAfw6wJNGa,577,2422453,2422453,1672277164,1672264538,0,inbound,67af70604a7ba416de056a38623ff4eb8ab7c283462242468b05f8aff3cf2cf1
942,bc1qcpyjc5z5c62hutrsww842mp3vufpjd5pc0l7u3,578,1029761,1029761,1672430259,1672264538,0,inbound,67af70604a7ba416de056a38623ff4eb8ab7c283462242468b05f8aff3cf2cf1
943,3NcUPm1kgTtZZneSvGA3JB18JqCcjccqYu,579,605157,605157,1677426649,1663177405,0,inbound,67af70604a7ba416de056a38623ff4eb8ab7c283462242468b05f8aff3cf2cf1
944,34isXuD7qKpmTn5vEPfNBiZiYeYzgwCJay,580,181869,181869,1672524025,1672264538,0,inbound,67af70604a7ba416de056a38623ff4eb8ab7c283462242468b05f8aff3cf2cf1
945,bc1q9jxk7yces6970t7k93ualk247yxsl0y98kg545,581,1458333,1458333,1672295858,1672264538,0,inbound,67af70604a7ba416de056a38623ff4eb8ab7c283462242468b05f8aff3cf2cf1
946,bc1q4c97pzmh8r5w3l37jkz59mgdppvz7lp545kwsw,582,2896817,2896817,1672268903,1672264538,0,inbound,67af70604a7ba416de056a38623ff4eb8ab7c283462242468b05f8aff3cf2cf1
947,3JiEBh6ZztVjweYeogHUKqqQRm8NkoEeYH,583,18981136,18981136,1674205518,1670555434,0,outbound,67af70604a7ba416de056a38623ff4eb8ab7c283462242468b05f8aff3cf2cf1
948,32hPt61kVK3a6R39QBa4PjtzNBxHDTyTFz,584,13241894,11901820,1681115153,1675937457,1340074,inbound,67af70604a7ba416de056a38623ff4eb8ab7c283462242468b05f8aff3cf2cf1
949,36NFBML6dRuwJeY6zz6KPCzBhQXdwDfzgL,585,51587,51587,1672272048,1672264538,0,inbound,67af70604a7ba416de056a38623ff4eb8ab7c283462242468b05f8aff3cf2cf1
950,bc1q5ez9athtxl2qn0glgext40mmv3k2cp5nx3glkv,586,854211,854211,1672313033,1672264538,0,inbound,67af70604a7ba416de056a38623ff4eb8ab7c283462242468b05f8aff3cf2cf1
951,1G2Ao2uruiPNCAvxWnwxVEekj165W4AEqu,587,333564033,333088962,1677628939,1678608124,475071,outbound,67af70604a7ba416de056a38623ff4eb8ab7c283462242468b05f8aff3cf2cf1
952,1KPnTyDD51Y6K7BjzAugAAMSo8LQSGGnn1,588,496260422,496260422,1681128137,1675442692,0,inbound,67af70604a7ba416de056a38623ff4eb8ab7c283462242468b05f8aff3cf2cf1
953,bc1qaf2my7en23c0xgg4v5l94r8wd88pd8xwjkqml0,589,3839390,3839390,1678557702,1671915014,0,inbound,67af70604a7ba416de056a38623ff4eb8ab7c283462242468b05f8aff3cf2cf1
954,34v35DjgyTV1Xxbyp5PxYkSiEKG2E8g5tY,590,21993332,21993332,1680184423,1669118479,0,outbound,67af70604a7ba416de056a38623ff4eb8ab7c283462242468b05f8aff3cf2cf1
955,15nua1DTfw4Sjo9UGTretuSnWgvUxEQv6Z,591,105258,105258,1672269755,1672264538,0,inbound,67af70604a7ba416de056a38623ff4eb8ab7c283462242468b05f8aff3cf2cf1
956,38QkDFrwS9SP2akXVnqkBC7XVDHncNvbz5,592,1474027,1474027,1672524025,1672264538,0,inbound,67af70604a7ba416de056a38623ff4eb8ab7c283462242468b05f8aff3cf2cf1
957,bc1qkw4spxjm9pkcrjgsypahv9yuumlyr9ak40yz0s,593,64626923,64616221,1674194892,1668832962,10702,outbound,67af70604a7ba416de056a38623ff4eb8ab7c283462242468b05f8aff3cf2cf1
958,3HohK8qG2XXuJAXw3pTn1gFqTJqHPeSu9B,594,44267,0,1672264538,1672264538,44267,inbound,67af70604a7ba416de056a38623ff4eb8ab7c283462242468b05f8aff3cf2cf1
959,3NtE3xpduggS14JKjiYUmhfsV9LcNnA38V,595,1156075,1156075,1673161132,1672264538,0,inbound,67af70604a7ba416de056a38623ff4eb8ab7c283462242468b05f8aff3cf2cf1
960,3FPDbk8hNV2DRq3v9GMSWrFz1dRkttJ59A,596,181924,181924,1672524025,1672264538,0,inbound,67af70604a7ba416de056a38623ff4eb8ab7c283462242468b05f8aff3cf2cf1
961,1D2w98jEFvTBtGHATPdBgqkAE3ixaT2SwX,597,505830977,505830977,1681106843,1678606995,0,inbound,67af70604a7ba416de056a38623ff4eb8ab7c283462242468b05f8aff3cf2cf1
962,38pjxWcE9JyiB7wkQrqvmKsACFcWSox8s9,598,247026,247026,1672290095,1672264538,0,inbound,67af70604a7ba416de056a38623ff4eb8ab7c283462242468b05f8aff3cf2cf1
963,34weh9CNRX8mxuCFn3ZssS8gBva5Wt5N6D,599,1242852,1242852,1677755042,1670126606,0,inbound,67af70604a7ba416de056a38623ff4eb8ab7c283462242468b05f8aff3cf2cf1
964,3D1AJJmDe9bKAgkkvgouZzNKk9UaDKHgB2,600,104886,104886,1672272122,1672264538,0,inbound,67af70604a7ba416de056a38623ff4eb8ab7c283462242468b05f8aff3cf2cf1
965,14rGT4snmQ2r2ckh92oYnRbjNQuEdXPVYL,601,57468,57468,1675086734,1672264538,0,inbound,67af70604a7ba416de056a38623ff4eb8ab7c283462242468b05f8aff3cf2cf1
966,3CJV7BnfS1gwvZPywNoSdXF3nrJi8tNdWo,602,63460,63460,1672272133,1672264538,0,inbound,67af70604a7ba416de056a38623ff4eb8ab7c283462242468b05f8aff3cf2cf1
967,36emhi6myuq5w4KPZPUXDekLdae8EgVhoU,603,2333779,2333779,1674075693,1672264401,0,inbound,67af70604a7ba416de056a38623ff4eb8ab7c283462242468b05f8aff3cf2cf1
968,1FpbDfz3fn8fqhX7ioXCokyF5gBYLGFZ2C,604,147204831,147204831,1681085288,1673477552,0,inbound,67af70604a7ba416de056a38623ff4eb8ab7c283462242468b05f8aff3cf2cf1
969,1N54q5A2kD6Td4vTWbgCXkD7NLPS18yiJY,605,205572,205572,1672277290,1672264538,0,inbound,67af70604a7ba416de056a38623ff4eb8ab7c283462242468b05f8aff3cf2cf1
970,3BkUfoUPJTTXSHAjsu5qRGgSqCe3U7e4fy,606,1131938,1131938,1672299602,1672264538,0,inbound,67af70604a7ba416de056a38623ff4eb8ab7c283462242468b05f8aff3cf2cf1
971,3Q7PPez9BsQVahGY2ck2mwrDrNSfX9NjEG,607,737755258,737355462,1681048808,1678360847,399796,inbound,67af70604a7ba416de056a38623ff4eb8ab7c283462242468b05f8aff3cf2cf1
972,bc1qu3f26qtnvkpjg4jxnjt0s8x2z9s2j49mmssdy3,608,203116466,203116466,1674904762,1667323432,0,outbound,67af70604a7ba416de056a38623ff4eb8ab7c283462242468b05f8aff3cf2cf1
973,3AFX9htKKaGyAtk8NxJbtrVqhihdbT42PT,609,56538055,53960347,1681115173,1679948145,2577708,inbound,67af70604a7ba416de056a38623ff4eb8ab7c283462242468b05f8aff3cf2cf1
974,31qEishX6Qmb5CLyFYkjG5mpRxcM72DCMi,610,422869593,422869593,1680916923,1673311895,0,inbound,67af70604a7ba416de056a38623ff4eb8ab7c283462242468b05f8aff3cf2cf1
975,bc1quwas36rtyk68a6uffn4ecjyplvwlyrtgl6shwj,611,242307,242307,1673058705,1672264538,0,inbound,67af70604a7ba416de056a38623ff4eb8ab7c283462242468b05f8aff3cf2cf1
976,37vjw7Crh3CmTaNQscAhfdyBUTRiFrCmYb,612,1241824,1241824,1672343184,1672264538,0,inbound,67af70604a7ba416de056a38623ff4eb8ab7c283462242468b05f8aff3cf2cf1
977,35mBSwHSKNRvjJriD9LXnrAuU6NDwgiTjM,613,3351748,3247160,1678010046,1671158402,104588,inbound,67af70604a7ba416de056a38623ff4eb8ab7c283462242468b05f8aff3cf2cf1
978,bc1qvj42msx5dzv38xwptlcs9zkunsz788zs8nf7mz,614,181701,181701,1672273843,1672264538,0,inbound,67af70604a7ba416de056a38623ff4eb8ab7c283462242468b05f8aff3cf2cf1
979,1MSyB7x4zKLzESP4bFGScddZh5PkqMr3GJ,615,269127794,268831720,1681106669,1677636095,296074,outbound,67af70604a7ba416de056a38623ff4eb8ab7c283462242468b05f8aff3cf2cf1
980,bc1q8psm9yvtu6vv500cvncmes6w8s2slwwwad966u,616,282210964,282113496,1681011403,1679052409,97468,inbound,67af70604a7ba416de056a38623ff4eb8ab7c283462242468b05f8aff3cf2cf1
981,bc1qrq0e8fkulv7u5apjln5cryez0wk9xdy2xtdhys,617,17735265,17735265,1675660391,1669678536,0,inbound,67af70604a7ba416de056a38623ff4eb8ab7c283462242468b05f8aff3cf2cf1
982,bc1q50tngcfx3lq0kgelrt475k2nemt8ths246vkq0,790,271343713,271343713,1672083956,1672082849,0,inbound,67af70604a7ba416de056a38623ff4eb8ab7c283462242468b05f8aff3cf2cf1
983,3H1aK5SfHusAmVo3Aic4jREykYyZKTA929,791,277064,277064,1672097213,1672082849,0,inbound,67af70604a7ba416de056a38623ff4eb8ab7c283462242468b05f8aff3cf2cf1
984,3G4cyX46dZpyegovXP19eF3cbT8BbtP1YS,792,189978,189978,1672099664,1672082849,0,inbound,67af70604a7ba416de056a38623ff4eb8ab7c283462242468b05f8aff3cf2cf1
985,bc1qp2ukf5f0nujeyedsk800ssr7zg2htqupw5sjcs,793,120334,120334,1673129083,1672082849,0,inbound,67af70604a7ba416de056a38623ff4eb8ab7c283462242468b05f8aff3cf2cf1
986,18nFTGf4eR6fnSzasCJ5nh2bHG3dgRq98M,794,62285605,62285605,1680952726,1671427408,0,inbound,67af70604a7ba416de056a38623ff4eb8ab7c283462242468b05f8aff3cf2cf1
987,33gWFjKeBEmb3v4gGxjroTBaWF48DqMb4o,795,108801,108801,1673310386,1672082849,0,inbound,67af70604a7ba416de056a38623ff4eb8ab7c283462242468b05f8aff3cf2cf1
988,1NG8nj7Vv1rfjibZbdE4HBuUW5fbGHnzGS,796,6535788,6050655,1680898485,1610248603,485133,inbound,67af70604a7ba416de056a38623ff4eb8ab7c283462242468b05f8aff3cf2cf1
989,1D3xMQ8Hmxe4n3cZ3EUqRHKaxV8TPxCdQy,797,126070,126070,1672088338,1672082849,0,inbound,67af70604a7ba416de056a38623ff4eb8ab7c283462242468b05f8aff3cf2cf1
990,14jWikYi7gBd8dg2LGzWiU4w9HonUU84MJ,798,5826596,5826596,1672084666,1672082849,0,inbound,67af70604a7ba416de056a38623ff4eb8ab7c283462242468b05f8aff3cf2cf1
991,bc1qm2m0mecaxdv8p9g7egrqd5zfayrpt9dd3ncq9d,799,831610,831610,1672086521,1672082849,0,inbound,67af70604a7ba416de056a38623ff4eb8ab7c283462242468b05f8aff3cf2cf1
992,3J6VvNDvVf5MPjGfQnny4Nbh85FhQZoMei,800,335068,335068,1672090121,1672082849,0,inbound,67af70604a7ba416de056a38623ff4eb8ab7c283462242468b05f8aff3cf2cf1
993,1DRzbdSyRWwR6gPzji3NKN1EXmruYNLMfh,801,2252305,2252305,1676878644,1672082849,0,inbound,67af70604a7ba416de056a38623ff4eb8ab7c283462242468b05f8aff3cf2cf1
994,3PcRDbM5bXvEHeStz92aGg4FnzL6Mw7uwL,802,306036,306036,1672099665,1672082849,0,inbound,67af70604a7ba416de056a38623ff4eb8ab7c283462242468b05f8aff3cf2cf1
995,376SaRbh3ZE5BrMJ3hpzfzLaSaP55DpTit,803,3562103,3562103,1672103368,1672082849,0,inbound,67af70604a7ba416de056a38623ff4eb8ab7c283462242468b05f8aff3cf2cf1
996,35GB5exJu1wvRhF9RmbA8SWoJPvxHoVf3f,804,91361,91361,1672786483,1672082849,0,inbound,67af70604a7ba416de056a38623ff4eb8ab7c283462242468b05f8aff3cf2cf1
997,3GQKbyjzwu3K36QCRXvQ9TxcUmssgENRUd,805,111308,111308,1672765270,1672082849,0,inbound,67af70604a7ba416de056a38623ff4eb8ab7c283462242468b05f8aff3cf2cf1
998,3Afxza23LAUkViZxWcJ5T9xHVn1ra7cJHa,806,445280,445280,1672120927,1672082849,0,inbound,67af70604a7ba416de056a38623ff4eb8ab7c283462242468b05f8aff3cf2cf1
999,3FkaTuc2vc5bko9wWgcKxHgWkGHYRQrdhQ,807,47811571,47082159,1680505340,1677569568,729412,inbound,67af70604a7ba416de056a38623ff4eb8ab7c283462242468b05f8aff3cf2cf1
1000,1ANi1BP6iy5wcC8sG9zKuUXmxQeTzm4juE,808,50642,50642,1675863673,1672082849,0,inbound,67af70604a7ba416de056a38623ff4eb8ab7c283462242468b05f8aff3cf2cf1
1001,bc1qkwa5zg9zhh444xerx9argm2t6nd549gzxqs6ee,809,1200116,1200116,1672674726,1672082849,0,inbound,67af70604a7ba416de056a38623ff4eb8ab7c283462242468b05f8aff3cf2cf1
1002,3Qw95aji8GXgfHGy2emx4UmRPqrddTVY8g,810,60051,60051,1672160883,1672082849,0,inbound,67af70604a7ba416de056a38623ff4eb8ab7c283462242468b05f8aff3cf2cf1
1003,12G6F68a5dHaYGA3zyKsLkqpk7f7yaLdAL,811,213772573,213772573,1680206851,1678767194,0,inbound,67af70604a7ba416de056a38623ff4eb8ab7c283462242468b05f8aff3cf2cf1
1004,36mEyYzUqdiHw6aEjjvG6KRAHnZe7RDtnT,812,247986,247986,1672117297,1672082849,0,inbound,67af70604a7ba416de056a38623ff4eb8ab7c283462242468b05f8aff3cf2cf1
1005,3HiUqdGsfCg8c3dqwz6YGAc3xcHaenhNJr,813,277072,277072,1672103859,1672082849,0,inbound,67af70604a7ba416de056a38623ff4eb8ab7c283462242468b05f8aff3cf2cf1
1006,36SUormZNXbQ5xtdzsQ7GsowhyVKGrVeBs,814,4788984848,4788630485,1681140558,1680710957,354363,outbound,67af70604a7ba416de056a38623ff4eb8ab7c283462242468b05f8aff3cf2cf1
1007,bc1q457rewr8vemgf04ls46nd8wv0j77tls4ja6xkq,815,30006910,29956404,1681038263,1672069935,50506,inbound,67af70604a7ba416de056a38623ff4eb8ab7c283462242468b05f8aff3cf2cf1
1008,3QkiSf6kQhHFyAapDjh787jVJaMgmxY6Eb,816,1429558809,1429558809,1681136958,1680292575,0,inbound,67af70604a7ba416de056a38623ff4eb8ab7c283462242468b05f8aff3cf2cf1
1009,12JsgK8pvsvDgT9TN4LqVfqHSbby5iEPis,817,529590911,529590911,1680883835,1676358430,0,inbound,67af70604a7ba416de056a38623ff4eb8ab7c283462242468b05f8aff3cf2cf1
1010,37G8aqnNDSQkMajZGSs422Jf2a6cD6aUQ7,818,362744268,362744268,1674880158,1673220602,0,inbound,67af70604a7ba416de056a38623ff4eb8ab7c283462242468b05f8aff3cf2cf1
1011,32TpD8ng5NWnUzYJv6TuzNUeCByz5YLECw,819,5364444,5364444,1675301926,1657845532,0,outbound,67af70604a7ba416de056a38623ff4eb8ab7c283462242468b05f8aff3cf2cf1
1012,1G4vtqQoofgmRp1VH75ZfVRY4JmCdEE2u5,820,28267661,28267661,1681125652,1659221214,0,inbound,67af70604a7ba416de056a38623ff4eb8ab7c283462242468b05f8aff3cf2cf1
1013,1NpyYgLx1aW4ftm8sw4dhoDqwT8u2hmZoi,821,45974108,45745116,1681093469,1677823306,228992,outbound,67af70604a7ba416de056a38623ff4eb8ab7c283462242468b05f8aff3cf2cf1
1014,3D1hX9W8QJb5PmxosWW6YWP4mb1sxQhtQa,822,255287,255287,1672158270,1672082849,0,inbound,67af70604a7ba416de056a38623ff4eb8ab7c283462242468b05f8aff3cf2cf1
1015,3KzjGCm84yiPEmjJ8LQSneZAuD2RqrveM4,823,358293,358293,1672099665,1672082849,0,inbound,67af70604a7ba416de056a38623ff4eb8ab7c283462242468b05f8aff3cf2cf1
1016,122tKtCBjFQtTsgdfVs9ars72qPXrHskbW,824,335072,335072,1672088175,1672082849,0,inbound,67af70604a7ba416de056a38623ff4eb8ab7c283462242468b05f8aff3cf2cf1
1017,bc1q3zn36gln4fn3qt963wv7vfcfukrf5dpkm8fpvk,825,595174283,594994335,1681141351,1680258250,179948,outbound,67af70604a7ba416de056a38623ff4eb8ab7c283462242468b05f8aff3cf2cf1
1018,39smXTQdqD2W767ipLishHV4diSV4xNFxA,826,22529307567,11551535882,1681137935,1679968749,10977771685,outbound,67af70604a7ba416de056a38623ff4eb8ab7c283462242468b05f8aff3cf2cf1
1019,3FfSPAmk9EkdKPMsYys3eLoBN19L8Yf5YL,827,62329,62329,1672099662,1672082849,0,inbound,67af70604a7ba416de056a38623ff4eb8ab7c283462242468b05f8aff3cf2cf1
1020,bc1q6r5sqes4u9m4sa0dg4a8fznttwsvrgjpy9gy9j,828,251332359,251325086,1679810992,1675528088,7273,outbound,67af70604a7ba416de056a38623ff4eb8ab7c283462242468b05f8aff3cf2cf1
1021,35GVEXeavCB8Yg9fMemLywMqNk5sBcK5m9,829,60429,60429,1672099316,1672082849,0,inbound,67af70604a7ba416de056a38623ff4eb8ab7c283462242468b05f8aff3cf2cf1
1022,3DNyB3rvsq1MKc8NWDXxMrZ8sp8msmkCqf,830,59370,59370,1672099316,1672082849,0,inbound,67af70604a7ba416de056a38623ff4eb8ab7c283462242468b05f8aff3cf2cf1
1023,3GdnvvPADi9thJm2ZdXkJyPKyK6TpZgN96,831,134057816,132235294,1680639728,1671690113,1822522,inbound,67af70604a7ba416de056a38623ff4eb8ab7c283462242468b05f8aff3cf2cf1
1024,bc1q4uafvudvenqusrk7xcawt24n2cw9784rg9ta56,832,422111,422111,1673135340,1672082849,0,inbound,67af70604a7ba416de056a38623ff4eb8ab7c283462242468b05f8aff3cf2cf1
1025,3K4RhVKCFudnazN5gnnsLutpUQw4fJBYSS,833,99643,99643,1672117297,1672082849,0,inbound,67af70604a7ba416de056a38623ff4eb8ab7c283462242468b05f8aff3cf2cf1
1026,18yo5Y9CumnYEQYEZhRBK9w2BL4J1J59jE,834,160939,160939,1672297161,1672082849,0,inbound,67af70604a7ba416de056a38623ff4eb8ab7c283462242468b05f8aff3cf2cf1
1027,bc1qkz7zm7wxnydqj9ljc0th36fk5xhx9843762y6q,835,100017,100017,1672083163,1672082849,0,inbound,67af70604a7ba416de056a38623ff4eb8ab7c283462242468b05f8aff3cf2cf1
1028,3PZKBnW7MCPnZi726uDFcp3wsrB9D9rP8r,836,564017,564017,1672163428,1672082849,0,inbound,67af70604a7ba416de056a38623ff4eb8ab7c283462242468b05f8aff3cf2cf1
1029,3QNHGAg1sdgLDY3XvUzEwBoTUVL76kc6yE,837,73907,73907,1672099662,1672082849,0,inbound,67af70604a7ba416de056a38623ff4eb8ab7c283462242468b05f8aff3cf2cf1
1030,3Dp2FvJcQMpLFfPDKU5rkwrCrLifUs3qou,838,104897210,102688694,1681115184,1679188605,2208516,inbound,67af70604a7ba416de056a38623ff4eb8ab7c283462242468b05f8aff3cf2cf1
1031,bc1qnvdjkupyefnuygrj8sqr5vdpzdn68wzpf3xpzu,839,564008,564008,1672129233,1672082849,0,inbound,67af70604a7ba416de056a38623ff4eb8ab7c283462242468b05f8aff3cf2cf1
1032,3BDAVKbVQoyC99sV9KFw9TjSNhPYBmPGkK,840,19443600,17059889,1681115116,1678520760,2383711,inbound,67af70604a7ba416de056a38623ff4eb8ab7c283462242468b05f8aff3cf2cf1
1033,bc1qtljrtwwlre7hah250k0an90llltwcwg0pv5xqd,841,201860,201860,1672778621,1672082849,0,inbound,67af70604a7ba416de056a38623ff4eb8ab7c283462242468b05f8aff3cf2cf1
1034,3MZ8m8ojD2ipWVjEXwsic4m8KRPTw1dTVM,842,7746314241,7744085585,1681141585,1680896029,2228656,inbound,67af70604a7ba416de056a38623ff4eb8ab7c283462242468b05f8aff3cf2cf1
1035,12K4xRiMRNkkDjkCtFCNZLM2YbupHyxx5X,843,120131079,120131079,1680847723,1670925931,0,outbound,67af70604a7ba416de056a38623ff4eb8ab7c283462242468b05f8aff3cf2cf1
1036,12pDH2v32seCz4sLtPAB2DMvskkDWxYJeF,844,281620922,280883994,1680903838,1677447433,736928,inbound,67af70604a7ba416de056a38623ff4eb8ab7c283462242468b05f8aff3cf2cf1
1037,33gHbfCCnbfqs41JmCMVgnsMMMuEkmGsZU,845,567215,567215,1672099667,1672082849,0,inbound,67af70604a7ba416de056a38623ff4eb8ab7c283462242468b05f8aff3cf2cf1
1038,3JKDu9v3itx5zWhgm9g3L5FTUyfjAuVhKS,846,77429486,75660260,1681122607,1675454272,1769226,inbound,67af70604a7ba416de056a38623ff4eb8ab7c283462242468b05f8aff3cf2cf1
1039,bc1qfju4u3jdf2gmeyy5y4zzlvdxvvjn7pa30c85ex,847,8506714,8497045,1672094202,1640268000,9669,inbound,67af70604a7ba416de056a38623ff4eb8ab7c283462242468b05f8aff3cf2cf1
1040,3FfyYvSjqRopepTYsxqiQNHxXc6ipX3pQ9,848,227713208,227713208,1680435560,1673194260,0,inbound,67af70604a7ba416de056a38623ff4eb8ab7c283462242468b05f8aff3cf2cf1
1041,35y6bQD5qw6WnSZqVgRHEqw47ciiphQwC9,954,2934177,2934177,1679680861,1655188001,0,inbound,67af70604a7ba416de056a38623ff4eb8ab7c283462242468b05f8aff3cf2cf1
1042,bc1qre8r24k5hd9cvackmfzt4w0jtvwd6wjn56n3xe,955,1299000,1299000,1675079899,1671799967,0,inbound,67af70604a7ba416de056a38623ff4eb8ab7c283462242468b05f8aff3cf2cf1
1043,bc1q603hswzhqeg2ad0s0832pms0g4cw3vda4cxe6c,956,21744326,21744326,1671808505,1671799967,0,inbound,67af70604a7ba416de056a38623ff4eb8ab7c283462242468b05f8aff3cf2cf1
1044,bc1qkk8zcte2da8fy9t2d8js5kqr0x482vczl2jjsg,957,2739421,2725382,1676784271,1671025614,14039,inbound,67af70604a7ba416de056a38623ff4eb8ab7c283462242468b05f8aff3cf2cf1
1045,3A7wXX77qfyigVfUmtC6MaeAw9BFRQa5Ek,958,12607588,12607588,1671808247,1662906188,0,inbound,67af70604a7ba416de056a38623ff4eb8ab7c283462242468b05f8aff3cf2cf1
1046,3C3c3YHtjCyVSmDC6apV4zGXyfr1kSd6qU,959,101075674,101075674,1672318512,1671799967,0,inbound,67af70604a7ba416de056a38623ff4eb8ab7c283462242468b05f8aff3cf2cf1
1047,bc1ql2a38547mfaphaxqjw4nyxslcse6sw09n9apvl,960,80000,0,1671799967,1671799967,80000,inbound,67af70604a7ba416de056a38623ff4eb8ab7c283462242468b05f8aff3cf2cf1
1048,3QAo7p6uuSjvSPegvFcFbTwkRTzgM7Afoi,961,282210,282210,1671817923,1671799967,0,inbound,67af70604a7ba416de056a38623ff4eb8ab7c283462242468b05f8aff3cf2cf1
1049,bc1qxmxlc2pkk5krs98hye66ku2rs35gywhxv4wn4y,962,172113071,172113071,1672222054,1671718283,0,inbound,67af70604a7ba416de056a38623ff4eb8ab7c283462242468b05f8aff3cf2cf1
1050,bc1qleyrz9n0g8y0p8dcapz99dd8aswqcgtt3w4cx0,963,570000,570000,1674163279,1671799967,0,inbound,67af70604a7ba416de056a38623ff4eb8ab7c283462242468b05f8aff3cf2cf1
1051,1xiguhykEB1SoKhRTSPLK5f97wMtHRMjN,964,39558961,39558961,1674221988,1671799967,0,inbound,67af70604a7ba416de056a38623ff4eb8ab7c283462242468b05f8aff3cf2cf1
1052,167iyEs74DmWoQvyJeESg48GPUsQGF86Nn,965,15804881,15804881,1671917536,1668753347,0,inbound,67af70604a7ba416de056a38623ff4eb8ab7c283462242468b05f8aff3cf2cf1
1053,3Gb3FY9RrsFbiCFDU4uhbF8YH1X6q35peJ,966,10328699,0,1674243091,1671799967,10328699,inbound,67af70604a7ba416de056a38623ff4eb8ab7c283462242468b05f8aff3cf2cf1
1054,bc1q539g2cquwx7422mkd3gecfzyzp20553xedw78w,967,1499980000,1499980000,1672553732,1671799967,0,inbound,67af70604a7ba416de056a38623ff4eb8ab7c283462242468b05f8aff3cf2cf1
1055,bc1qs824ym4cjej39fulcujje5veju0s6czd0ne56x,968,1853919,0,1671799967,1671799967,1853919,inbound,67af70604a7ba416de056a38623ff4eb8ab7c283462242468b05f8aff3cf2cf1
1056,bc1q8grenc3dhtaplv24cjwtff9h0jgnzcjsv6hq8g,969,140297127,140297127,1672223213,1671797473,0,inbound,67af70604a7ba416de056a38623ff4eb8ab7c283462242468b05f8aff3cf2cf1
1057,1G9iLrAKeoXRaAefki27Ne9D59RhgFtXcx,970,4536156,4536156,1677634577,1671799967,0,inbound,67af70604a7ba416de056a38623ff4eb8ab7c283462242468b05f8aff3cf2cf1
1058,bc1qwpurhwskfg74x4694a63s3n97hcjhrlwwdjn6d,971,8699767,0,1671799967,1671799967,8699767,inbound,67af70604a7ba416de056a38623ff4eb8ab7c283462242468b05f8aff3cf2cf1
1059,bc1qk624lyl7cgtyvdzr2659k3rt57wxa5nh0nkpal,972,4413723,0,1674230200,1671799967,4413723,inbound,67af70604a7ba416de056a38623ff4eb8ab7c283462242468b05f8aff3cf2cf1
1060,bc1q2eppz2way4tjc4pjql95x802kdkyaw6y5mc7vn,973,102544048,102544048,1674565677,1666190925,0,inbound,67af70604a7ba416de056a38623ff4eb8ab7c283462242468b05f8aff3cf2cf1
1061,bc1qgdw7wt9ew9hxaqjuzk95sg8nyuu9dz493x70j6,974,685596,681398,1678560581,1671799967,4198,inbound,67af70604a7ba416de056a38623ff4eb8ab7c283462242468b05f8aff3cf2cf1
1062,bc1qzyhqec8sxcnwp57ntqxuv0ylfhyrm6zutqhuvt,975,4241270,0,1671799967,1671799967,4241270,inbound,67af70604a7ba416de056a38623ff4eb8ab7c283462242468b05f8aff3cf2cf1
1063,bc1qy0uvgmhycwl5dlsqve4t6ukp4kyqxhyla80qax,976,90000,0,1671799967,1671799967,90000,inbound,67af70604a7ba416de056a38623ff4eb8ab7c283462242468b05f8aff3cf2cf1
1064,bc1qf0uj75qlrd4xtn4qghvrgmelc4euhnv8rkr84a,977,6196379,6196379,1671926258,1671237166,0,inbound,67af70604a7ba416de056a38623ff4eb8ab7c283462242468b05f8aff3cf2cf1
1065,bc1qhx7ct7tsmr25mjnkydzwjf0sfty46kz6uh3j7v,978,44576345,44576345,1671804917,1670174290,0,inbound,67af70604a7ba416de056a38623ff4eb8ab7c283462242468b05f8aff3cf2cf1
1066,3MRiKADyR7hAGSYGicsM1cke3u6ygCqe3w,979,9188299,9045598,1681037817,1656796157,142701,inbound,67af70604a7ba416de056a38623ff4eb8ab7c283462242468b05f8aff3cf2cf1
1067,bc1qjwh4ev60mgcazs0uemrtuxcgnvvtvjzg6w5afgzl586j4zmtlrsqs85wd3,980,300789,300789,1671840580,1671752684,0,inbound,67af70604a7ba416de056a38623ff4eb8ab7c283462242468b05f8aff3cf2cf1
1068,3BRd4RivwKVXh4e4P4t7NejoQ42bQRJ4sA,981,310200,310200,1671775320,1667864803,0,inbound,67af70604a7ba416de056a38623ff4eb8ab7c283462242468b05f8aff3cf2cf1
1069,3LUtMcxz7SUqAmSmbfCir4SzsQGMQqGBjf,982,788330728,788330728,1673913825,1672358557,0,outbound,67af70604a7ba416de056a38623ff4eb8ab7c283462242468b05f8aff3cf2cf1
1070,3C8yeaqWwBWr3zFurGAcDrfpnzZeonCX7D,983,564707,564707,1671782856,1671752684,0,inbound,67af70604a7ba416de056a38623ff4eb8ab7c283462242468b05f8aff3cf2cf1
1071,3H3AWfTmJBwkr5FiLefSdhVSfDgAwjngTM,984,127035340,127035340,1680283822,1676751701,0,inbound,67af70604a7ba416de056a38623ff4eb8ab7c283462242468b05f8aff3cf2cf1
1072,3H1wnTsjP6GDdM8iVyG8m6xEMCk9JWdGe4,985,40054951,39459582,1680239477,1673589790,595369,outbound,67af70604a7ba416de056a38623ff4eb8ab7c283462242468b05f8aff3cf2cf1
1073,bc1q66m5rzhw3clylas0nly5cq8c9deymztapxhm3wwpmve38m7zpu0s89apd7,986,568360,568360,1671757730,1671752684,0,inbound,67af70604a7ba416de056a38623ff4eb8ab7c283462242468b05f8aff3cf2cf1
1074,3QZAhuaRt57uSxzEDdsEnEF96Dc1oCAB3Z,987,103470,103470,1671775430,1671752684,0,inbound,67af70604a7ba416de056a38623ff4eb8ab7c283462242468b05f8aff3cf2cf1
1075,1MounQVzr1iLtEWqzn1rV3jM4uZFHuoxAU,988,536950,536950,1672297638,1671724672,0,inbound,67af70604a7ba416de056a38623ff4eb8ab7c283462242468b05f8aff3cf2cf1
1076,3BzhVVT2pTecpmJs9LM9TPjCwVYUsxGDkd,989,907703,907703,1672074280,1671752684,0,inbound,67af70604a7ba416de056a38623ff4eb8ab7c283462242468b05f8aff3cf2cf1
1077,bc1qq8kxlh5g6f2r6zev5scasdprnhugcgjtt5ygk5z5w9qv4lkxx3ksllnv5a,990,338949,338949,1671840580,1671752684,0,inbound,67af70604a7ba416de056a38623ff4eb8ab7c283462242468b05f8aff3cf2cf1
1078,3CiA5A3dbHDaYssJvegNc5B3KEZJifEy4s,991,283680,283680,1671755496,1671752684,0,inbound,67af70604a7ba416de056a38623ff4eb8ab7c283462242468b05f8aff3cf2cf1
1079,38g3KAFwo8iRBP6iRVKDcSyfvkKpwXTgNa,992,132542,132542,1671775430,1671752684,0,inbound,67af70604a7ba416de056a38623ff4eb8ab7c283462242468b05f8aff3cf2cf1
1080,35tyRaytwp2uBjaJqrbh9biT6TgoeBU8mH,993,161559,161559,1672171496,1671752684,0,inbound,67af70604a7ba416de056a38623ff4eb8ab7c283462242468b05f8aff3cf2cf1
1081,3D64zgakZAzeBQr4bpxKFLPr55mQcptmVT,994,4664374,4499791,1681115074,1671069006,164583,inbound,67af70604a7ba416de056a38623ff4eb8ab7c283462242468b05f8aff3cf2cf1
1082,bc1qdsmkvnq0enqgnhfkeqq5qtnd0fzapw5egjnfl3,995,84027913543,84025630119,1678249505,1679105775,2283424,inbound,67af70604a7ba416de056a38623ff4eb8ab7c283462242468b05f8aff3cf2cf1
1083,3PBCuW1voAT2TgwGq7DrpbvZzRUPS7bd9k,996,33809554,33809554,1680957799,1670755129,0,outbound,67af70604a7ba416de056a38623ff4eb8ab7c283462242468b05f8aff3cf2cf1
1084,3LKk3DhedgrvKQbjZMvYwzUW7T4Ya2dvic,997,1786496,1786496,1672066709,1671752684,0,inbound,67af70604a7ba416de056a38623ff4eb8ab7c283462242468b05f8aff3cf2cf1
1085,33NqudYut4FDBnS8bp57WUmFy12qDmTnkL,998,277919,277919,1672165282,1671752684,0,inbound,67af70604a7ba416de056a38623ff4eb8ab7c283462242468b05f8aff3cf2cf1
1086,32ToQnw5QAaL9sFnrqMAR5KG3TSe7po8LT,999,19600678,19600678,1678786385,1670948693,0,inbound,67af70604a7ba416de056a38623ff4eb8ab7c283462242468b05f8aff3cf2cf1
1087,1HLrfjWttDPbixyLpLe8eAzVNDnb7hyi7W,1000,277816,277816,1672285578,1671752684,0,inbound,67af70604a7ba416de056a38623ff4eb8ab7c283462242468b05f8aff3cf2cf1
1088,3NNeTiCh6eCFBqQ5mjAS5GkGK38e4B26gj,1001,17833,17833,1671843789,1671752684,0,inbound,67af70604a7ba416de056a38623ff4eb8ab7c283462242468b05f8aff3cf2cf1
1089,bc1q3qre6kn2u76g84ad5qxfu8rl32fn82nswjag79,1002,5835452,5835452,1679063790,1666977519,0,inbound,67af70604a7ba416de056a38623ff4eb8ab7c283462242468b05f8aff3cf2cf1
1090,3Grezec8FrdeTT3RwuzMAGUx9zEzvHXesS,1003,132586,132586,1672426535,1671752684,0,inbound,67af70604a7ba416de056a38623ff4eb8ab7c283462242468b05f8aff3cf2cf1
1091,38rRYtZLwYCJNrVCa2mKD4QatPPP1NmJdk,1004,475542,475542,1671783591,1671752684,0,inbound,67af70604a7ba416de056a38623ff4eb8ab7c283462242468b05f8aff3cf2cf1
1092,3EkjZpuZZHnXkiRJpyWSMWpDi4gTMLVYhf,1005,62277719,62277719,1672417235,1670459031,0,inbound,67af70604a7ba416de056a38623ff4eb8ab7c283462242468b05f8aff3cf2cf1
1093,19A39nVMBsdGxE5BwrUJb4WWcG3k2Z4Vh3,1006,3047594064,3047594064,1681113813,1680300489,0,outbound,67af70604a7ba416de056a38623ff4eb8ab7c283462242468b05f8aff3cf2cf1
1094,bc1qqjqjjude4rk2sg4p6fm3yft7zwdqaxauvwsds5,1007,238063725,238063725,1678935572,1665435808,0,outbound,67af70604a7ba416de056a38623ff4eb8ab7c283462242468b05f8aff3cf2cf1
1095,3J32XMz5WBAWMyQnUsFgHNb2iCWXyN78cQ,1008,133273209,133273209,1681116039,1671400937,0,inbound,67af70604a7ba416de056a38623ff4eb8ab7c283462242468b05f8aff3cf2cf1
1096,3PoYwM3CyNgPiKF8zrfaJTWA8yGepoXAVs,1009,6822051,6822051,1671762245,1671752684,0,inbound,67af70604a7ba416de056a38623ff4eb8ab7c283462242468b05f8aff3cf2cf1
1097,3QBm2Y16K6oAMPzmYsDwAxsNcp3fg8WPth,1010,323206,323206,1672281026,1671752296,0,inbound,67af70604a7ba416de056a38623ff4eb8ab7c283462242468b05f8aff3cf2cf1
1098,18xHTRqn7RDoYF58NXQNZtLDTBscc9o8Ge,1011,467719863631,467624238890,1681142858,1681128207,95624741,inbound,67af70604a7ba416de056a38623ff4eb8ab7c283462242468b05f8aff3cf2cf1
1099,3NyL2NJs9swvGSv8nYhjPEND59M1cFdNTc,1012,103469,103469,1671775430,1671752684,0,inbound,67af70604a7ba416de056a38623ff4eb8ab7c283462242468b05f8aff3cf2cf1
1100,bc1qwnu7yx4s6dan90m82uerlheqs4pnhf24x3dg6z,1256,34725880,0,1671394605,1671390767,34725880,inbound,67af70604a7ba416de056a38623ff4eb8ab7c283462242468b05f8aff3cf2cf1
1101,bc1q3fdqsmyvse2g7y7p0zw25e8kkwrsvkxvygfhmn,1257,1019600,1019600,1675597078,1671389808,0,inbound,67af70604a7ba416de056a38623ff4eb8ab7c283462242468b05f8aff3cf2cf1
1102,1LdfVWuyzzVGwxBhQ2GMYar34w5SznEsLp,1258,130631,130631,1672567772,1646994901,0,inbound,67af70604a7ba416de056a38623ff4eb8ab7c283462242468b05f8aff3cf2cf1
1103,bc1q2ue3nplwcn7f4a5t9e5f35c0yqvdzzsfjyvap7,1259,5051177,0,1671389808,1671389808,5051177,inbound,67af70604a7ba416de056a38623ff4eb8ab7c283462242468b05f8aff3cf2cf1
1104,3H8b39FStYPnxCpk8CxBt425dmpmtnr4yv,1260,11934639,11934639,1671518518,1671389808,0,inbound,67af70604a7ba416de056a38623ff4eb8ab7c283462242468b05f8aff3cf2cf1
1105,bc1qd3ff75z3p5hfy63khq4kfvr708n0u6lqhgzl5v,1261,28980000,0,1671389808,1671389808,28980000,inbound,67af70604a7ba416de056a38623ff4eb8ab7c283462242468b05f8aff3cf2cf1
1106,bc1q98wyqqvl6wxejfszgk3c9ac4aflc9ht985t7ya,1262,2676527,2676527,1674588862,1671389808,0,inbound,67af70604a7ba416de056a38623ff4eb8ab7c283462242468b05f8aff3cf2cf1
1107,bc1q8rvgfxljtnnrf8kygc5jar2uedrehzdl9tn9tr,1263,565902,0,1671389808,1671389808,565902,inbound,67af70604a7ba416de056a38623ff4eb8ab7c283462242468b05f8aff3cf2cf1
1108,3NFuHh57LzVCdfoVcMEsBhuKa7bcVYeKJC,1264,1054812,1054812,1671393652,1671389808,0,inbound,67af70604a7ba416de056a38623ff4eb8ab7c283462242468b05f8aff3cf2cf1
1109,bc1qgxxnrml2hmdzjgjg9w66uwwlyjwtqqy033qgy6,1265,252660838,252660838,1681126114,1678782520,0,inbound,67af70604a7ba416de056a38623ff4eb8ab7c283462242468b05f8aff3cf2cf1
1110,13Rxue14m9xLWdB3V63tP8WR79AgrCW6gZ,1266,5428809,0,1675859278,1668090772,5428809,inbound,67af70604a7ba416de056a38623ff4eb8ab7c283462242468b05f8aff3cf2cf1
1111,1EPd8UTa6154oiZNgU2C2pgNqt9MRBTfGd,1267,2266700,0,1671337487,1671337487,2266700,inbound,67af70604a7ba416de056a38623ff4eb8ab7c283462242468b05f8aff3cf2cf1
1112,3G4dZVKvhwnsuCNdmq1d6bHTSWSUevuZU4,1268,2852152,2852152,1680154660,1657551639,0,inbound,67af70604a7ba416de056a38623ff4eb8ab7c283462242468b05f8aff3cf2cf1
1113,3BLYzSkmqukHwrB1H5mkeBf52CXAxT63Xv,1269,1432711,1432711,1671411143,1671240543,0,inbound,67af70604a7ba416de056a38623ff4eb8ab7c283462242468b05f8aff3cf2cf1
1114,bc1qpux8h0e5k8zs9uq6eqwfgyhptzmr9742fs3pfs,1270,1062715281,0,1679191898,1674312894,1062715281,inbound,67af70604a7ba416de056a38623ff4eb8ab7c283462242468b05f8aff3cf2cf1
1115,3CE7Z7G28SCGZ4RHsHaedqXoVfiHuXCKuK,1271,597273,597273,1671243315,1671240543,0,inbound,67af70604a7ba416de056a38623ff4eb8ab7c283462242468b05f8aff3cf2cf1
1116,14m1nGouhmfuK3eNGiXrBQgF2PPRYdR8ek,1272,109619093952,109615720650,1681144785,1681118694,3373302,inbound,67af70604a7ba416de056a38623ff4eb8ab7c283462242468b05f8aff3cf2cf1
1117,3FjZCEtb7dwvhGUefce7y4UiAkS4YioCFx,1273,30550571,29776499,1680677602,1675296145,774072,outbound,67af70604a7ba416de056a38623ff4eb8ab7c283462242468b05f8aff3cf2cf1
1118,32gkDAEStgEa5VvDjeTpD8qYMx1Lc4hPNa,1274,502957,502957,1671474732,1671240544,0,inbound,67af70604a7ba416de056a38623ff4eb8ab7c283462242468b05f8aff3cf2cf1
1119,16tSbakpSgHkWRRYT4qcTyejr6vUNPUcWn,1275,299448,299448,1671244277,1671240543,0,inbound,67af70604a7ba416de056a38623ff4eb8ab7c283462242468b05f8aff3cf2cf1
1120,bc1q0y80vz5pw3flkv5nxq5etzurzj882rplxqdgj2w6lsx8u4lkfmuskw28hw,1276,632463,632463,1671597984,1671240544,0,inbound,67af70604a7ba416de056a38623ff4eb8ab7c283462242468b05f8aff3cf2cf1
1121,38TNiz8wps3onboNN4pe2UXXnLsnNpoDPu,1277,305363,305363,1671246042,1671240543,0,inbound,67af70604a7ba416de056a38623ff4eb8ab7c283462242468b05f8aff3cf2cf1
1122,1FveuexLUx3PvJzFtjVEAHmSfBBKQVtEnC,1278,28739788,28739788,1681013651,1662768220,0,inbound,67af70604a7ba416de056a38623ff4eb8ab7c283462242468b05f8aff3cf2cf1
1123,1NFiz6D33u2nz7wkALxvJnfEEYnigvUx6Q,1279,612867,612867,1671259455,1671240543,0,inbound,67af70604a7ba416de056a38623ff4eb8ab7c283462242468b05f8aff3cf2cf1
1124,bc1qkxp2cxyf6yjdrrz9d7rx2m9jyhyja220mevw6u,1280,510099,510099,1671242129,1671240543,0,inbound,67af70604a7ba416de056a38623ff4eb8ab7c283462242468b05f8aff3cf2cf1
1125,38w5xi8uSkdLnp4iVDmTv5hScZxfuiTEea,1281,328187,328187,1671292799,1671226217,0,inbound,67af70604a7ba416de056a38623ff4eb8ab7c283462242468b05f8aff3cf2cf1
1126,1B5f9r5tChZrfSHQgDTbEGZKGABMyNxZeL,1282,6318080,6318080,1672306057,1664399672,0,inbound,67af70604a7ba416de056a38623ff4eb8ab7c283462242468b05f8aff3cf2cf1
1127,1HW2HiGW4Ed796uWeKzX61dEhpNmuwh73,1283,325733044,323202775,1681114452,1679936555,2530269,outbound,67af70604a7ba416de056a38623ff4eb8ab7c283462242468b05f8aff3cf2cf1
1128,1CVB5jtbX8nyPGXcfBn5V1vRf8JzgY6NkL,1284,125399,125399,1672443509,1671240543,0,inbound,67af70604a7ba416de056a38623ff4eb8ab7c283462242468b05f8aff3cf2cf1
1129,35W1oxEDaGNh9MdEacZPjApJdz9k5APdBs,1285,12690016,12690016,1675620122,1663672108,0,inbound,67af70604a7ba416de056a38623ff4eb8ab7c283462242468b05f8aff3cf2cf1
1130,35sDnCqjgmNg8BYDf58jNjYYdVmQPgnYBq,1286,119765,119765,1672162022,1671240543,0,inbound,67af70604a7ba416de056a38623ff4eb8ab7c283462242468b05f8aff3cf2cf1
1131,1KnfmJvNtFBddddrG5hP3ovNUT41SqXQqu,1287,227095,227095,1671425594,1671240543,0,inbound,67af70604a7ba416de056a38623ff4eb8ab7c283462242468b05f8aff3cf2cf1
1132,19y2YKAUZnH3S8YSugLv5dBWBwinwNvzLv,1288,179603,179603,1671427273,1671240543,0,inbound,67af70604a7ba416de056a38623ff4eb8ab7c283462242468b05f8aff3cf2cf1
1133,1MUBgHGH94cvom6SJBiohvDnrC3XTLbVPJ,1289,283232265,283232265,1680944737,1673593951,0,inbound,67af70604a7ba416de056a38623ff4eb8ab7c283462242468b05f8aff3cf2cf1
1134,1AJBYEaoC2e6ZeDwL2ViU73Ki56fTw7osq,1290,194950871,194950871,1681092801,1671740028,0,outbound,67af70604a7ba416de056a38623ff4eb8ab7c283462242468b05f8aff3cf2cf1
1135,1Af54KwcApkrMcaE1fzfPnHszxvLo67WjR,1291,532400,0,1671240543,1671240543,532400,inbound,67af70604a7ba416de056a38623ff4eb8ab7c283462242468b05f8aff3cf2cf1
1136,1JdBZKZm7HLfaFDWdSapezc3HGwXxrybwq,1292,1064358391,1064350591,1681142505,1678838502,7800,outbound,67af70604a7ba416de056a38623ff4eb8ab7c283462242468b05f8aff3cf2cf1
1137,1WdBRVjJqSE8Pm8U6NcfJcNo29EJ53B9d,1293,234452325,234452325,1680978138,1665821401,0,outbound,67af70604a7ba416de056a38623ff4eb8ab7c283462242468b05f8aff3cf2cf1
1138,bc1q90859p6hyvjrz2u3xkh2czwnv8hzccq4df4fsl,1294,52525214,29836491,1680445663,1672178526,22688723,inbound,67af70604a7ba416de056a38623ff4eb8ab7c283462242468b05f8aff3cf2cf1
1139,bc1q3zjmycj3dka0pktg4luawhsmz7g9cnlthvcx4g,1295,68852,68852,1677676509,1671240543,0,inbound,67af70604a7ba416de056a38623ff4eb8ab7c283462242468b05f8aff3cf2cf1
1140,3PXhxyezVRG7vYBgU9GE5fKjDH5fbEzhvX,1296,37240973,36696294,1681137475,1672486028,544679,inbound,67af70604a7ba416de056a38623ff4eb8ab7c283462242468b05f8aff3cf2cf1
1141,3FZfqHWT6EA2XdGniBYgSm2wU6M7xHCd9v,1297,285499,285499,1671276384,1671240543,0,inbound,67af70604a7ba416de056a38623ff4eb8ab7c283462242468b05f8aff3cf2cf1
1142,19uS6snfJ2C4XSFS1C8LpgDFSzwGh2CGcW,1298,203579,203579,1671248773,1671240543,0,inbound,67af70604a7ba416de056a38623ff4eb8ab7c283462242468b05f8aff3cf2cf1
1143,3JAGQshWhRr4xDKuLQgmqDo1qwqDw54UTr,1299,25641871,24212083,1681115159,1679284346,1429788,inbound,67af70604a7ba416de056a38623ff4eb8ab7c283462242468b05f8aff3cf2cf1
1144,3NSgLpkkdAva9EYiLeXbh5j6Q2ECZ184cG,1300,1015337,1015337,1672395660,1671240543,0,inbound,67af70604a7ba416de056a38623ff4eb8ab7c283462242468b05f8aff3cf2cf1
1145,32nwwdahYCCGZ8XBzohXiquFVC35dYkuTe,1301,424565,424565,1671301426,1671240543,0,inbound,67af70604a7ba416de056a38623ff4eb8ab7c283462242468b05f8aff3cf2cf1
1146,191u7sNTWC6Wa4EmBxAUp1P7NeW7jsxgSD,1302,159321056,159321056,1680912794,1675289582,0,outbound,67af70604a7ba416de056a38623ff4eb8ab7c283462242468b05f8aff3cf2cf1
1147,bc1q0az36zkwpgts9cnadr36jdejqzxyt32aejy98c,1303,62450637,62441824,1679763999,1672254703,8813,outbound,67af70604a7ba416de056a38623ff4eb8ab7c283462242468b05f8aff3cf2cf1
1148,1KP5BfhAxYmKY29G3PimPDBSAVyymL7i5i,1304,256371758,256371758,1680944925,1675908405,0,inbound,67af70604a7ba416de056a38623ff4eb8ab7c283462242468b05f8aff3cf2cf1
1149,3B62YGrHzfo4WfeLyG4DgGpn7UFwE1t6T9,1305,367476,367476,1671246311,1671240543,0,inbound,67af70604a7ba416de056a38623ff4eb8ab7c283462242468b05f8aff3cf2cf1
1150,14JDtqLnB3qeUcfh9o9gAiSZnwJx84Ef4P,1306,30121153,30121153,1681070978,1676381905,0,inbound,67af70604a7ba416de056a38623ff4eb8ab7c283462242468b05f8aff3cf2cf1
1151,3DHasWjhC4KPj6Uwpdh16qSD2UKhkDUGy3,1307,29947577,28930547,1681115139,1676851919,1017030,inbound,67af70604a7ba416de056a38623ff4eb8ab7c283462242468b05f8aff3cf2cf1
1152,bc1qmvl4f24w8euhuswuzd8p7eqf6pd7xwyt7qyyc7,1308,62313970,62313970,1680971563,1674026703,0,outbound,67af70604a7ba416de056a38623ff4eb8ab7c283462242468b05f8aff3cf2cf1
1153,1L1jedrLhMPk2abJMmZhdhkTmRRao3oa3s,1309,272515171,272515171,1681077307,1677607000,0,inbound,67af70604a7ba416de056a38623ff4eb8ab7c283462242468b05f8aff3cf2cf1
1154,36UZ1cv8JsmWJiw6tCDHjxPCispoWEtrL8,1310,63933539,63576768,1680845970,1670943510,356771,inbound,67af70604a7ba416de056a38623ff4eb8ab7c283462242468b05f8aff3cf2cf1
1155,3FxRJPjShX3oBsxHns7iEGhddqcvyVzuyD,1311,68633449,65786664,1680615066,1672413270,2846785,inbound,67af70604a7ba416de056a38623ff4eb8ab7c283462242468b05f8aff3cf2cf1
1156,36KUegkSeLNGqFDGKpWT3otKDkqpVKsqG3,1312,2601924642,2496821238,1681129838,1680241229,105103404,inbound,67af70604a7ba416de056a38623ff4eb8ab7c283462242468b05f8aff3cf2cf1
1157,3Lax4NqWfgej8NDinGJR6DiqamvrocPeGZ,1313,26023051,26023051,1674367331,1644345816,0,inbound,67af70604a7ba416de056a38623ff4eb8ab7c283462242468b05f8aff3cf2cf1
1158,bc1q99kfqn08tmqxl807z05fevd0dys94gmdr0hyhd,1314,319758068,319758068,1680912306,1674595531,0,outbound,67af70604a7ba416de056a38623ff4eb8ab7c283462242468b05f8aff3cf2cf1
1159,1GoAgufxRfedEtFb16rhk9kPk2WmwkjZcY,1743,28872127,28872127,1673525869,1657026522,0,inbound,67af70604a7ba416de056a38623ff4eb8ab7c283462242468b05f8aff3cf2cf1
1160,bc1qk2l5tavtel0sgv9fzdqgr36l44v8vq2w75ez56,1744,27228000,27228000,1670772160,1663691654,0,inbound,67af70604a7ba416de056a38623ff4eb8ab7c283462242468b05f8aff3cf2cf1
1161,bc1qlf5p6209g5r69y597df650s74a25rz5kujptr6ayjamm8s6pkslq08tdpa,1745,623212486,623212486,1681000971,1670567786,0,outbound,67af70604a7ba416de056a38623ff4eb8ab7c283462242468b05f8aff3cf2cf1
1162,bc1qm9gh8dzc5z0exthwmny3wg8rrmrflg3wfhxyk3,1746,2826400,2826400,1670762314,1670761449,0,inbound,67af70604a7ba416de056a38623ff4eb8ab7c283462242468b05f8aff3cf2cf1
1163,1MrMKt6JDpPHkgCpgNh58hufLHmr6PFehe,1747,106508297,37000216,1681108628,1660761703,69508081,inbound,67af70604a7ba416de056a38623ff4eb8ab7c283462242468b05f8aff3cf2cf1
1164,39BYk2qLJR8FVNg6wUYppUXCYagVUyBLN5,1748,3311000,3311000,1671451717,1670761449,0,inbound,67af70604a7ba416de056a38623ff4eb8ab7c283462242468b05f8aff3cf2cf1
1165,bc1qussych34c86n23u3daqn6yfjc4w2va0g7zc9al,1749,43819282,43819282,1678725399,1670761449,0,inbound,67af70604a7ba416de056a38623ff4eb8ab7c283462242468b05f8aff3cf2cf1
1166,bc1qv6ng2jgzql5ntjapnatnpnxv7hlx02fnepyu4l,1750,49767247,0,1670761449,1670761449,49767247,inbound,67af70604a7ba416de056a38623ff4eb8ab7c283462242468b05f8aff3cf2cf1
1167,bc1qxv97lmk5eymn9keeeau4aag8gj4qrp6fwmg94pf2yy2f3ewxhdxsdxucld,1751,332391938,332391938,1670857825,1670761449,0,inbound,67af70604a7ba416de056a38623ff4eb8ab7c283462242468b05f8aff3cf2cf1
1168,bc1q9ju77mtdh4gz5em45qgkhmky2ukac6lvpax6p9,1752,33498283,30746125,1670714027,1633540147,2752158,inbound,67af70604a7ba416de056a38623ff4eb8ab7c283462242468b05f8aff3cf2cf1
1169,bc1q5w6svj5l0p5nltz88643f66l4u4pn8wxwlgf2e,1753,1040804059,1040591359,1680578771,1660323067,212700,inbound,67af70604a7ba416de056a38623ff4eb8ab7c283462242468b05f8aff3cf2cf1
1170,bc1q5dquu4h6tea7r3fvnfha20hxnkgvunp3m6pfz3,1754,12504528,408000,1680288863,1615016159,12096528,inbound,67af70604a7ba416de056a38623ff4eb8ab7c283462242468b05f8aff3cf2cf1
1171,3HJ9u73UpQ7UeiQfjSHEa1B2x1787rYdLK,1755,2056776,2056776,1670586369,1669652881,0,inbound,67af70604a7ba416de056a38623ff4eb8ab7c283462242468b05f8aff3cf2cf1
1172,bc1qd4pgqt2jn8f8sgnet9e4us6e2s4wr7qnykev4p8qhaax73wcw73q6ntrps,1756,145693,145693,1670589906,1670584323,0,inbound,67af70604a7ba416de056a38623ff4eb8ab7c283462242468b05f8aff3cf2cf1
1173,1FbzxusXJMLLQTJqWSo1QTV3CN3WKfLQjf,1757,1134746,0,1670584323,1670584323,1134746,inbound,67af70604a7ba416de056a38623ff4eb8ab7c283462242468b05f8aff3cf2cf1
1174,16C3MBSHTxJoJpq5yatnpW2gXPJtE2ay8d,1758,6429241,6429241,1670585900,1670584323,0,inbound,67af70604a7ba416de056a38623ff4eb8ab7c283462242468b05f8aff3cf2cf1
1175,3EVrQiTv1VnN5PJjUP2U4PGdMUFsWtKd3F,1759,829438,829438,1670605300,1668505647,0,inbound,67af70604a7ba416de056a38623ff4eb8ab7c283462242468b05f8aff3cf2cf1
1176,bc1qz8a9030lx9z5h98wp48kg4ld6cmxrnzvue7n8v,1760,635339722647,632074436628,1681148420,1680846019,3265286019,inbound,67af70604a7ba416de056a38623ff4eb8ab7c283462242468b05f8aff3cf2cf1
1177,bc1qfzdkkc5vssdmdp3jfsypr3uv8gff5knln29fku,1761,27308400,0,1670574661,1670574661,27308400,inbound,67af70604a7ba416de056a38623ff4eb8ab7c283462242468b05f8aff3cf2cf1
1178,bc1qkpy9237k3f3uau69l44y47rrpqnfgkypm4hwhk,1762,993456,993456,1680745082,1659749588,0,inbound,67af70604a7ba416de056a38623ff4eb8ab7c283462242468b05f8aff3cf2cf1
1179,3NZWXdFDMiSTPPnGCf1529CikS4hZpmZGs,1763,524404,524404,1670562066,1670559791,0,inbound,67af70604a7ba416de056a38623ff4eb8ab7c283462242468b05f8aff3cf2cf1
1180,bc1qds4lrh8jqfxeax9zkclevexym9drugksv8l9p7,1764,81576419,0,1671940147,1670507887,81576419,inbound,67af70604a7ba416de056a38623ff4eb8ab7c283462242468b05f8aff3cf2cf1
1181,bc1qhc5hrszdlh5kdy7jsknyh3kudnvhxl3vwzkyjq,1765,5560273,5560273,1670560102,1670559791,0,inbound,67af70604a7ba416de056a38623ff4eb8ab7c283462242468b05f8aff3cf2cf1
1182,3CnP1AizPZFavGpnfkgmPDY6XKgTzmbiBV,1766,197039439,195299393,1681115110,1678343408,1740046,inbound,67af70604a7ba416de056a38623ff4eb8ab7c283462242468b05f8aff3cf2cf1
1183,3BkLjwz8fzbexCoKGMB6carFDHxZPjUBuF,1767,2256979,2256979,1670566650,1658958135,0,inbound,67af70604a7ba416de056a38623ff4eb8ab7c283462242468b05f8aff3cf2cf1
1184,31kzLSoitKHwVNQvNLv9xBKrRS4JFzqSUi,1768,29067,0,1670559791,1670559791,29067,inbound,67af70604a7ba416de056a38623ff4eb8ab7c283462242468b05f8aff3cf2cf1
1185,1C4fQJSYLzYdue6j9pTn4c7DP2p5vnxgic,1769,206330,206330,1671825669,1670559791,0,inbound,67af70604a7ba416de056a38623ff4eb8ab7c283462242468b05f8aff3cf2cf1
1186,3EozhHieuGKufqnKG5Lef5KBxXwzCptK3E,1770,2488781,2488781,1670836099,1670559791,0,inbound,67af70604a7ba416de056a38623ff4eb8ab7c283462242468b05f8aff3cf2cf1
1187,3Cjvoq8kGtcs1xurpmUgTWkxAGFkY1YJBv,1771,235287,235287,1670580355,1670559791,0,inbound,67af70604a7ba416de056a38623ff4eb8ab7c283462242468b05f8aff3cf2cf1
1188,34X8N6xBtZhgME7QWAJD4dMjqdgvVQ23La,1772,273339,273339,1670866208,1670559791,0,inbound,67af70604a7ba416de056a38623ff4eb8ab7c283462242468b05f8aff3cf2cf1
1189,bc1qqnktvu5cy5fen6l59hg4c4wsal98a8qjskcnf5,1773,3758512,3758512,1671082934,1669064049,0,inbound,67af70604a7ba416de056a38623ff4eb8ab7c283462242468b05f8aff3cf2cf1
1190,bc1q5u6qgyy6hk98chev8y7hh0qemzjntkcl0tk3rr,1774,290600,290600,1670952922,1670559791,0,inbound,67af70604a7ba416de056a38623ff4eb8ab7c283462242468b05f8aff3cf2cf1
1191,3Hr5dHMtdaS3yVsWfQpXgFRY1YoCNVkPSD,1775,2906227,2906227,1672453847,1670559791,0,inbound,67af70604a7ba416de056a38623ff4eb8ab7c283462242468b05f8aff3cf2cf1
1192,1HSeuksBCPoehQgtaDkZxfqrphfQ6GTkTF,1776,215065,215065,1670568620,1670559791,0,inbound,67af70604a7ba416de056a38623ff4eb8ab7c283462242468b05f8aff3cf2cf1
1193,1PHQmaGtwGvLTMxiJGiiA9zq57hBCMjYWb,1777,275772,275772,1670567172,1670559791,0,inbound,67af70604a7ba416de056a38623ff4eb8ab7c283462242468b05f8aff3cf2cf1
1194,3KhhEoKvYzbZXtzW8HnpgZdx6HMQqfZAnU,1778,1666636,1666636,1670562215,1670559791,0,inbound,67af70604a7ba416de056a38623ff4eb8ab7c283462242468b05f8aff3cf2cf1
1195,16wFa9hqanUjdEnxMHYxjj6UpuQWqAftGd,1779,592883,592883,1670565313,1670559791,0,inbound,67af70604a7ba416de056a38623ff4eb8ab7c283462242468b05f8aff3cf2cf1
1196,bc1q5nvp450pc6vr2u6eggy9tvcneh4rk27tsh8u65,1780,11546570310,11546570310,1678110639,1677509827,0,inbound,67af70604a7ba416de056a38623ff4eb8ab7c283462242468b05f8aff3cf2cf1
1197,3A52SdFTWQurMS6tEjFp1ogyyq6m4amXhk,1781,552156,552156,1670859416,1670559791,0,inbound,67af70604a7ba416de056a38623ff4eb8ab7c283462242468b05f8aff3cf2cf1
1198,3H4Z2CCgr2qiLrFJE9Ao2CUaq9MHLG9hgc,1782,674167722,674018900,1681123231,1679134722,148822,outbound,67af70604a7ba416de056a38623ff4eb8ab7c283462242468b05f8aff3cf2cf1
1199,325xwSGfSpbrMBGi851UtVL9J9VDLL9m2K,1783,221765,221765,1674433698,1670559791,0,inbound,67af70604a7ba416de056a38623ff4eb8ab7c283462242468b05f8aff3cf2cf1
1200,3PLXZTMdKUDAj8S4HZohiA1eSxVEtHscEf,1784,554384,554384,1671684987,1670559791,0,inbound,67af70604a7ba416de056a38623ff4eb8ab7c283462242468b05f8aff3cf2cf1
1201,35j2dbpfBb1TEByH2ZtAqsPxv6BTfFaa3f,1785,25316744,25316744,1672920607,1670558289,0,inbound,67af70604a7ba416de056a38623ff4eb8ab7c283462242468b05f8aff3cf2cf1
1202,3ANPpSLrH25p7iZLveKoAiGqgiyNaUFNxc,1786,1302202,1302202,1670562215,1670559791,0,inbound,67af70604a7ba416de056a38623ff4eb8ab7c283462242468b05f8aff3cf2cf1
1203,bc1qjtnfpl5j84ptzksy3u5kgt0wa9gr35mryz85q3,1787,44353430,43811098,1681088227,1670805661,542332,outbound,67af70604a7ba416de056a38623ff4eb8ab7c283462242468b05f8aff3cf2cf1
1204,bc1q26nz24c4s9ghz2d4jflz8jmy8e02ycca84yswz,1788,64000,64000,1670560848,1670559791,0,inbound,67af70604a7ba416de056a38623ff4eb8ab7c283462242468b05f8aff3cf2cf1
1205,bc1qgys72uz25z2ajayrmhk0fmavj497k6p3hld630,1789,34878,34878,1670561431,1670559791,0,inbound,67af70604a7ba416de056a38623ff4eb8ab7c283462242468b05f8aff3cf2cf1
1206,1HBcAgri4GnQsjCzynaCRXKvUfG6cxwXQW,1790,160076,160076,1670567532,1670559791,0,inbound,67af70604a7ba416de056a38623ff4eb8ab7c283462242468b05f8aff3cf2cf1
1207,bc1qf3dz50a0ulw4qha73ryup4mx9mkw4tuqd8kpjz,1791,1104597,1104597,1670561214,1670559791,0,inbound,67af70604a7ba416de056a38623ff4eb8ab7c283462242468b05f8aff3cf2cf1
1208,3Duwy4Dd9Dk3CtJ5kW43aFtwEzqw2z9xvP,1792,523281,523281,1670864354,1670559791,0,inbound,67af70604a7ba416de056a38623ff4eb8ab7c283462242468b05f8aff3cf2cf1
1209,39jXr4gRxk3iyzPwwZ2UAMhFgqnFaCB66Z,1793,13494694,13369352,1680912626,1658346744,125342,outbound,67af70604a7ba416de056a38623ff4eb8ab7c283462242468b05f8aff3cf2cf1
1210,3FYQGtJXyBS88gU86RxUQSWshCBeQwtFXA,1794,143361,143361,1672818126,1670465196,0,inbound,67af70604a7ba416de056a38623ff4eb8ab7c283462242468b05f8aff3cf2cf1
1211,1K1wChDffQLvZ5pkeuFKuM6GcMLab78xf3,1795,160111,160111,1670572698,1670559791,0,inbound,67af70604a7ba416de056a38623ff4eb8ab7c283462242468b05f8aff3cf2cf1
1212,3Q7MZo6k3Jhp4Ztxz2mht8qTsVDF5bkWsd,1796,16129310,16129310,1676783564,1665243211,0,inbound,67af70604a7ba416de056a38623ff4eb8ab7c283462242468b05f8aff3cf2cf1
1213,1KiyKVd4LbmCjLkgm8Z4NDGr9fyWyjnp71,1797,284836,284836,1670567112,1670559791,0,inbound,67af70604a7ba416de056a38623ff4eb8ab7c283462242468b05f8aff3cf2cf1
1214,3A6pA5yXejjpsacCRg1QhHphz8D3SWCVUf,1798,58140077,58140077,1678412762,1653962587,0,inbound,67af70604a7ba416de056a38623ff4eb8ab7c283462242468b05f8aff3cf2cf1
1215,3Gnq3YQLowsjKM8Wkiipta1HMbjcn2b8Rx,1799,344881229,342843317,1680828741,1673825830,2037912,inbound,67af70604a7ba416de056a38623ff4eb8ab7c283462242468b05f8aff3cf2cf1
1216,bc1q3gz49nzuw7y7ca34grzmsgvmdl2ggutdn4euat,1800,5477822,253664,1679094608,1655772068,5224158,inbound,67af70604a7ba416de056a38623ff4eb8ab7c283462242468b05f8aff3cf2cf1
1217,bc1qm0r4sqeumzghtwes8vme2yggkenlyyc4s7swl2,1801,85849922,85791225,1681147629,1678650668,58697,inbound,67af70604a7ba416de056a38623ff4eb8ab7c283462242468b05f8aff3cf2cf1
1218,bc1qg5hrrkan0gxy3kl60m8e8cw987zftuq95a5fvnlrz7knvc94s46qh5fre7,618,1733390,1733390,1672269138,1672264538,0,inbound,5973c5ebd0409e47edaadd0efa92fd0a3806012457163e14e63ab083bbf4f491
1219,3BGzLF14vCwPrTCCxZLrTN6YB4aYEMrtDW,849,108756,108756,1672117297,1672082849,0,inbound,5973c5ebd0409e47edaadd0efa92fd0a3806012457163e14e63ab083bbf4f491
1220,15KbTt11nM67mv169PCnw7PmwfmVw9jjZQ,1013,4695896084,4695747955,1681090588,1678262519,148129,outbound,5973c5ebd0409e47edaadd0efa92fd0a3806012457163e14e63ab083bbf4f491
1221,1FpfycEprodHYDnbvTaGpAf7P5CjKjnUQ8,1315,279906,279906,1671419713,1671240543,0,inbound,5973c5ebd0409e47edaadd0efa92fd0a3806012457163e14e63ab083bbf4f491
1222,32z4amF4cAb67tkaMrPUcEsC6q58T7sGgC,1802,2843960,2843960,1670857460,1670454666,0,inbound,5973c5ebd0409e47edaadd0efa92fd0a3806012457163e14e63ab083bbf4f491
1223,3NzNyLCLYUCMZySzQLn9XwWERSSDtDPG2g,619,140470,140470,1672290099,1672264538,0,inbound,5d2fbda03bd9e50b92e4dd240be24ee687be28775e6deca410afe26f8484c948
1224,12UkGUzAMjrF4o8YWx2n1TiHfsRJXPVg1Z,850,272368687,272368687,1681020354,1678629137,0,inbound,5d2fbda03bd9e50b92e4dd240be24ee687be28775e6deca410afe26f8484c948
1225,36fLcwaW3DXdibuWCMApPwSZpTwCWjSnjq,1014,564746,564746,1672281026,1671752684,0,inbound,5d2fbda03bd9e50b92e4dd240be24ee687be28775e6deca410afe26f8484c948
1226,19YLJdEpaa2cED6How4oniE69R3PbMKp3L,1316,166882438,166882438,1681099573,1679263671,0,outbound,5d2fbda03bd9e50b92e4dd240be24ee687be28775e6deca410afe26f8484c948
1227,3Ff7gPWo1Ae1Vj3ffsze3xQcLU8DZbXxxo,1803,558004,558004,1670562066,1670559791,0,inbound,5d2fbda03bd9e50b92e4dd240be24ee687be28775e6deca410afe26f8484c948
1228,3A5qqgzUgZnGrhZTzPE8CMPcbC8YK3cXJy,620,23699577,23699577,1678827289,1672193965,0,outbound,78d9c7a5a36baf6df4f6f03c8a51451750b470fe4176485b23c5dd9505f6d2a2
1229,3B517iJ5AVthzQ6niv6u9kqBuUTWDsWTZZ,621,147676278,147676278,1681003439,1672764165,0,inbound,78d9c7a5a36baf6df4f6f03c8a51451750b470fe4176485b23c5dd9505f6d2a2
1230,bc1q8lrq57f52waq2fpgza59p3jjk9c5kfnrzepv2x88n25g0qtm7t5qme4mu4,622,282594,282594,1672524025,1672264538,0,inbound,78d9c7a5a36baf6df4f6f03c8a51451750b470fe4176485b23c5dd9505f6d2a2
1231,bc1qjg73wck78dnmqfx402xqqrxfwtsf70uphnkdyq,623,11145752,11132782,1679432627,1659123478,12970,inbound,78d9c7a5a36baf6df4f6f03c8a51451750b470fe4176485b23c5dd9505f6d2a2
1232,1M1JrzEgXgYYJChhk24en57qLXgfevPHJV,851,359718080,359718080,1679504682,1674266168,0,inbound,78d9c7a5a36baf6df4f6f03c8a51451750b470fe4176485b23c5dd9505f6d2a2
1233,3FK8xPFxApfFMTVuaEuQuFEQuG59vfxxvQ,852,237485,237485,1672099516,1672082849,0,inbound,78d9c7a5a36baf6df4f6f03c8a51451750b470fe4176485b23c5dd9505f6d2a2
1234,17gtDiLoUUP5oAFKuqiQWRFbL3QDFAsLKn,853,106919792,106919792,1673431517,1670565971,0,inbound,78d9c7a5a36baf6df4f6f03c8a51451750b470fe4176485b23c5dd9505f6d2a2
1235,bc1qcyah3stq0ya02yjut8yzf55tlzvmkezr4kq7gh,854,19166578,19166578,1672264870,1661390109,0,inbound,78d9c7a5a36baf6df4f6f03c8a51451750b470fe4176485b23c5dd9505f6d2a2
1236,1F7F7Jd7aW6vEJTBxZFEVDD38RwPSSnAKU,1015,861376,861376,1671796618,1671752684,0,inbound,78d9c7a5a36baf6df4f6f03c8a51451750b470fe4176485b23c5dd9505f6d2a2
1237,1MfFSn4a6tCsZpLNBiyh7Si9meRqmcupVq,1016,225939,225939,1671779419,1671752684,0,inbound,78d9c7a5a36baf6df4f6f03c8a51451750b470fe4176485b23c5dd9505f6d2a2
1238,37zBaxFtZRnF4stm3tkvNRByMwGxpvNPjv,1017,55892374,54380732,1681069250,1671939028,1511642,inbound,78d9c7a5a36baf6df4f6f03c8a51451750b470fe4176485b23c5dd9505f6d2a2
1239,18faCJH6hwB9WDg31dZqr7AQsXXc965CH2,1018,101254333968,101253980698,1681141629,1678443169,353270,outbound,78d9c7a5a36baf6df4f6f03c8a51451750b470fe4176485b23c5dd9505f6d2a2
1240,bc1qx6crkc9l8wwjq6v2eevvn0u59aaacjg3lp983u3fxwgdcq96qswq67n83f,1317,121682,121682,1671503150,1671240543,0,inbound,78d9c7a5a36baf6df4f6f03c8a51451750b470fe4176485b23c5dd9505f6d2a2
1241,bc1qpr5s8u8wjaua02qs7x5a28slpyzukg3w0rrsht,1318,1899575602,1899575602,1681107288,1677203590,0,inbound,78d9c7a5a36baf6df4f6f03c8a51451750b470fe4176485b23c5dd9505f6d2a2
1242,3NGzs6oV6nDxkkVgzSkDidvSFzWTuipCtm,1319,748897,748897,1671253304,1671240543,0,inbound,78d9c7a5a36baf6df4f6f03c8a51451750b470fe4176485b23c5dd9505f6d2a2
1243,37cLarPbBqpRY27ZkTQL6hUBdN7MUzGdKP,1320,245629,245629,1671597983,1671240543,0,inbound,78d9c7a5a36baf6df4f6f03c8a51451750b470fe4176485b23c5dd9505f6d2a2
1244,3KWibnLPooFDAXrSqS7prZ9pwxRN37SXjU,1804,79843749,79843749,1676725542,1671861404,0,outbound,78d9c7a5a36baf6df4f6f03c8a51451750b470fe4176485b23c5dd9505f6d2a2
1245,3JeJVGtWcFuArQPzHRxkL3tEAwnEmtyj5S,1805,2223450,2223450,1670605410,1670559791,0,inbound,78d9c7a5a36baf6df4f6f03c8a51451750b470fe4176485b23c5dd9505f6d2a2
1246,bc1q20nhgpjxff0ge4r8z4pm4x0cc90xdvdvnq7vv8,1806,576551,0,1670559791,1670559791,576551,inbound,78d9c7a5a36baf6df4f6f03c8a51451750b470fe4176485b23c5dd9505f6d2a2
1247,bc1qdw2h8sglams22vp546lmwzyjck2usxcj5h3myw,1807,277335,277335,1670703618,1670559791,0,inbound,78d9c7a5a36baf6df4f6f03c8a51451750b470fe4176485b23c5dd9505f6d2a2
1248,18uHMVag16Dqc9uHoR3CoCJBn6Hp4T4Eci,624,400851,0,1672264538,1672264538,400851,inbound,7a5f1e348d19b90dbd81d59cb84fc8a93fbb657707fd180c327db1bfb2c3d034
1249,3B6c3yPH6QTbFnGDyibGmpcESARzgABd27,625,225601,225601,1672292796,1672264538,0,inbound,7a5f1e348d19b90dbd81d59cb84fc8a93fbb657707fd180c327db1bfb2c3d034
1250,3GRJDJbpkZjb9j899PLBqyQDXbwVpiSkrW,855,181009,181009,1672083044,1672082849,0,inbound,7a5f1e348d19b90dbd81d59cb84fc8a93fbb657707fd180c327db1bfb2c3d034
1251,1N54dHahNtbxrANzv1XRimMWz8yY2ZnKGC,856,7862935,7862935,1681045639,1672078869,0,inbound,7a5f1e348d19b90dbd81d59cb84fc8a93fbb657707fd180c327db1bfb2c3d034
1252,34sd6pYZoSb7XyoUYapPFNYnqBevgmgFXg,1019,84636513,84447833,1681115120,1672018738,188680,inbound,7a5f1e348d19b90dbd81d59cb84fc8a93fbb657707fd180c327db1bfb2c3d034
1253,bc1qxvktj70nl7k7rh55j496plfjmf9e7e4jg4v89v,1020,202047,202047,1671992128,1671752684,0,inbound,7a5f1e348d19b90dbd81d59cb84fc8a93fbb657707fd180c327db1bfb2c3d034
1254,18EFMzQfPSbi9KT11UCGk5ph6P7Btv2cQ9,1321,24391445,23256749,1681125652,1671510293,1134696,outbound,7a5f1e348d19b90dbd81d59cb84fc8a93fbb657707fd180c327db1bfb2c3d034
1255,bc1qgh08ad5nm75x0fd6uf63kza0gy7h9cj5vplfsl,1322,16645057,16645057,1680778763,1657795769,0,outbound,7a5f1e348d19b90dbd81d59cb84fc8a93fbb657707fd180c327db1bfb2c3d034
1256,bc1qluwg36wk7ua4z7w0r8dkpgs0x2hkk94c3vefgq0zakcd3qq0l9tqyfgzxt,1808,1378024,1378024,1673248418,1670548149,0,inbound,7a5f1e348d19b90dbd81d59cb84fc8a93fbb657707fd180c327db1bfb2c3d034
1257,3EZPzvLEyGhUk55tQDBGVuUaSFDJkX2FfH,1809,80676,80676,1670565789,1670559791,0,inbound,7a5f1e348d19b90dbd81d59cb84fc8a93fbb657707fd180c327db1bfb2c3d034
1258,1BW4bNgPdMn8kSfn2xLyFZndjvaZWxCUyZ,626,105198578,105198578,1680977965,1667251271,0,inbound,4d8d865d0e1e1101b9b5135c8ce1ad6870987f36e946535eaae59e417867ec94
1259,bc1q8t7mw9yau308t4xjxfms2e4gn2ddnjwr6v2kzq,627,442600349,442600349,1681004723,1671226549,0,inbound,4d8d865d0e1e1101b9b5135c8ce1ad6870987f36e946535eaae59e417867ec94
1260,bc1q3uf2w0lh96aukz8w62qzsn3zj3hyse69hmvcr4,857,630744,630744,1672155905,1672082849,0,inbound,4d8d865d0e1e1101b9b5135c8ce1ad6870987f36e946535eaae59e417867ec94
1261,1PkcEDLJmPicQivLyKqmiT8FrLkLBdY6KM,858,421528,421528,1672086649,1672082849,0,inbound,4d8d865d0e1e1101b9b5135c8ce1ad6870987f36e946535eaae59e417867ec94
1262,3PoeXgZ52aa4YXdYFqUbcmgDDvo8RiTJje,1021,83855248,83164024,1680701345,1673083144,691224,outbound,4d8d865d0e1e1101b9b5135c8ce1ad6870987f36e946535eaae59e417867ec94
1263,bc1qnd50zsmpfrfaq8s97dxuyfv8j54f22l96w5qd7,1022,773531303,773531303,1678812802,1675903393,0,outbound,4d8d865d0e1e1101b9b5135c8ce1ad6870987f36e946535eaae59e417867ec94
1264,3KGUKLEfzbq5o4JGEDmEf7VCazC6n46gdS,1323,47567652,46838620,1681115166,1678394839,729032,inbound,4d8d865d0e1e1101b9b5135c8ce1ad6870987f36e946535eaae59e417867ec94
1265,19cxmZLWTC46Uf1mkLR8EFBQSa2Ls4RK7E,1324,203646,203646,1671248773,1671240543,0,inbound,4d8d865d0e1e1101b9b5135c8ce1ad6870987f36e946535eaae59e417867ec94
1266,bc1qhcptthyvcmvu2tmq3yac00asgevkszcmphnsv2,1810,217954,217954,1670941192,1670559791,0,inbound,4d8d865d0e1e1101b9b5135c8ce1ad6870987f36e946535eaae59e417867ec94
1267,3J8dvSUUWLJuuV5qBTG4JcGVmfzYhpp9sE,1811,1180028,1180028,1676553854,1670129110,0,inbound,4d8d865d0e1e1101b9b5135c8ce1ad6870987f36e946535eaae59e417867ec94
1268,1Ei9W1NkwViFWVzUfWuu99vFr5vYQkKPtm,628,54940811,46243494,1678617237,1632039339,8697317,inbound,1dfce722ac8711093ab680f05a33db4bdd6f6cc38ef29726e6aea485d7a75927
1269,bc1q7z5quy7exyp9zqh8mngn99q0kpxaqflntnsr2j,629,41171204,41171204,1674230586,1672595649,0,inbound,1dfce722ac8711093ab680f05a33db4bdd6f6cc38ef29726e6aea485d7a75927
1270,13fjmGf1RvTXhK1bBL56GyXxPu8QppKE7V,859,1415275,1415275,1672087880,1672082849,0,inbound,1dfce722ac8711093ab680f05a33db4bdd6f6cc38ef29726e6aea485d7a75927
1271,1CtobifAV6wUu41uKZjEwTxRDbeENFqdm7,1023,1739782,1739782,1671775512,1671752684,0,inbound,1dfce722ac8711093ab680f05a33db4bdd6f6cc38ef29726e6aea485d7a75927
1272,bc1qnum0j7yte6p6w7dpsxcv3z46ppaaq6pch5xaa3,1024,423172,423172,1671958977,1671752684,0,inbound,1dfce722ac8711093ab680f05a33db4bdd6f6cc38ef29726e6aea485d7a75927
1273,bc1q6qk8lcs2c8kuc5jru297lcm93cql9czvfxp9xz,1325,33231431,31491319,1681085101,1667352735,1740112,inbound,1dfce722ac8711093ab680f05a33db4bdd6f6cc38ef29726e6aea485d7a75927
1274,bc1qegv5yxfgg8h2atm3g8yzu0yxswkuxqzv8v5zwl,1326,57288,57288,1671260628,1671240543,0,inbound,1dfce722ac8711093ab680f05a33db4bdd6f6cc38ef29726e6aea485d7a75927
1275,3F58m5nFKWfd6t5BdtbsjJsH5rHS8twrGw,1812,15172301,9793319,1672165689,1670559791,5378982,inbound,1dfce722ac8711093ab680f05a33db4bdd6f6cc38ef29726e6aea485d7a75927
1276,15ov9DMPKD2rMzs5xUnkdjuMJXo9yTQTB2,1813,23627412,23627412,1674384309,1670513625,0,inbound,1dfce722ac8711093ab680f05a33db4bdd6f6cc38ef29726e6aea485d7a75927
1277,3MYxtTXmjoDxpNbggj6Ke5cYvKHJyHrgYR,630,134517,134517,1672772267,1672264538,0,inbound,a47a6169afe5ee1954c23ddb7bde0cb8939217c2628e424387b374907533f6fe
1278,3GZv4EwNfoXoysDHbgRNzxRFqiDaUWCmnQ,631,122659,122659,1672788274,1672264538,0,inbound,a47a6169afe5ee1954c23ddb7bde0cb8939217c2628e424387b374907533f6fe
1279,bc1qtmllppsvsyyxjs59k0ahga2wl22s8hhe9e255z,632,104924,104924,1672796470,1672264538,0,inbound,a47a6169afe5ee1954c23ddb7bde0cb8939217c2628e424387b374907533f6fe
1280,bc1qpp2lw5ujnqkrp9ycl4735ez6j3wfrqcmc2hw28,633,184979508,184979508,1679219406,1674634039,0,outbound,a47a6169afe5ee1954c23ddb7bde0cb8939217c2628e424387b374907533f6fe
1281,bc1q96ushyuw46uctatxqex2rsjack3r2wrcayn69k,634,12115316,12115316,1672268823,1672264538,0,inbound,a47a6169afe5ee1954c23ddb7bde0cb8939217c2628e424387b374907533f6fe
1282,3Qk4u6BozhqSEDL3jxVnin2SF45wVRL2k2,1025,136757,136757,1672426535,1671752684,0,inbound,a47a6169afe5ee1954c23ddb7bde0cb8939217c2628e424387b374907533f6fe
1283,bc1qxtcf66mps6nfkew79t88enkyzptxqzwfewr9dt,1026,299502051,299479077,1680842570,1671814097,22974,inbound,a47a6169afe5ee1954c23ddb7bde0cb8939217c2628e424387b374907533f6fe
1284,bc1qcu45tj9sql4j6lhzjur62hnurl74jr76v4wdt9,1027,6383833,6383833,1680747304,1661128735,0,inbound,a47a6169afe5ee1954c23ddb7bde0cb8939217c2628e424387b374907533f6fe
1285,3QpoANk3Uc1wgzgBjnfotxwAZWbaNPyfhz,1028,62818,62818,1671775429,1671752684,0,inbound,a47a6169afe5ee1954c23ddb7bde0cb8939217c2628e424387b374907533f6fe
1286,1HsbiHV59Vh1ghZtdBdDuNxGRui466mSan,1029,365034,365034,1672076054,1671752684,0,inbound,a47a6169afe5ee1954c23ddb7bde0cb8939217c2628e424387b374907533f6fe
1287,bc1qud7cersksh07dqz2tmjjxm9zqflne3gugrpgpr,1327,367662,367662,1671260628,1671240543,0,inbound,a47a6169afe5ee1954c23ddb7bde0cb8939217c2628e424387b374907533f6fe
1288,bc1qhujjxzh3qlwzk52fjtwueg6s6khustlfskhvuy,1328,104323,104323,1671273779,1671240543,0,inbound,a47a6169afe5ee1954c23ddb7bde0cb8939217c2628e424387b374907533f6fe
1289,3LQPqqwifZjNnDRhAGat3Pg7EEGWPtVPfp,1329,598802,598802,1671253300,1671240543,0,inbound,a47a6169afe5ee1954c23ddb7bde0cb8939217c2628e424387b374907533f6fe
1290,1LPHHjpyY3iundteb1tM19Yy8gzAussMS1,1330,209462,209462,1671306852,1671240543,0,inbound,a47a6169afe5ee1954c23ddb7bde0cb8939217c2628e424387b374907533f6fe
1291,3Dt2nqApYUm3UnVEMx8dx7XfQysiG7HXzP,1331,262148,262148,1671253291,1671240543,0,inbound,a47a6169afe5ee1954c23ddb7bde0cb8939217c2628e424387b374907533f6fe
1292,bc1qg5x5rvvruyvexlq4jprdld6dlwjle8e397rkz4,1814,23254,0,1670559791,1670559791,23254,inbound,a47a6169afe5ee1954c23ddb7bde0cb8939217c2628e424387b374907533f6fe
1293,3GnZo3TXPsLBb613WXTCp9mUPo4GjX2GYy,1815,533276,533276,1671684987,1670559791,0,inbound,a47a6169afe5ee1954c23ddb7bde0cb8939217c2628e424387b374907533f6fe
1294,bc1qcv6rav94zlkm4cfykmlnq79dsnlxj8g8np6jcy,1816,4023971,4023971,1670562645,1670559791,0,inbound,a47a6169afe5ee1954c23ddb7bde0cb8939217c2628e424387b374907533f6fe
1295,13SqLQpCUK722aQGY2yzGSVLpP4MzQtDtD,635,2880863588,2880863588,1678790494,1673469622,0,outbound,dcbdff8087beaa3a41a94d638f126367ad0fda5816d05b49d35da9e4552ae784
1296,3PYzz87qbBApvyd7eobxRdA2BmKoecekxk,1030,132559,132559,1671771706,1671752684,0,inbound,dcbdff8087beaa3a41a94d638f126367ad0fda5816d05b49d35da9e4552ae784
1297,1E72MNXLDkpf7U2KHiAakg6LJKfy2czPpc,1332,407302973,395994319,1680333768,1626405285,11308654,inbound,dcbdff8087beaa3a41a94d638f126367ad0fda5816d05b49d35da9e4552ae784
1298,bc1q0dthvx8tzfpdg4970hf09s9plpxju8szpmusg7,636,4002642780,3999447856,1679148150,1677968623,3194924,inbound,32109ed86ba84fa3652b5044ea7d716c019343017b6b8c8c214d4971fd8c0b62
1299,3HW32pnt3xnJciDm7whp4z6bjZJxAzZVMe,637,312120,312120,1672272140,1672264538,0,inbound,32109ed86ba84fa3652b5044ea7d716c019343017b6b8c8c214d4971fd8c0b62
1300,3HoxYCWon3DZNZZ92SqWj69gSZLT3nKZeG,638,645442,645442,1672272143,1672264538,0,inbound,32109ed86ba84fa3652b5044ea7d716c019343017b6b8c8c214d4971fd8c0b62
1301,351gu9mPShiMjF4Xgac68Pk3D4agi2CrcP,639,78417577,77870115,1681115158,1677780048,547462,outbound,32109ed86ba84fa3652b5044ea7d716c019343017b6b8c8c214d4971fd8c0b62
1302,bc1qday004nf0wgq7kwx5r6sx4r6fz5qpec2azyy27,640,220307867,220307867,1680285859,1676796342,0,inbound,32109ed86ba84fa3652b5044ea7d716c019343017b6b8c8c214d4971fd8c0b62
1303,18QBsBkap5sbF5k81wZ6MKa7PGnnq7hEB5,641,145374,145374,1672315879,1672264538,0,inbound,32109ed86ba84fa3652b5044ea7d716c019343017b6b8c8c214d4971fd8c0b62
1304,bc1qn9pggknerqqjflts07x3lu6hr8mt7l0pqhujt0m54s6h5rl4zctsejk9gv,642,272254,272254,1672524025,1672264538,0,inbound,32109ed86ba84fa3652b5044ea7d716c019343017b6b8c8c214d4971fd8c0b62
1305,3Mk8VMypu2SiXRhvu1jUmQYvdhTtNJ5xBx,643,121169,121169,1672788274,1672264538,0,inbound,32109ed86ba84fa3652b5044ea7d716c019343017b6b8c8c214d4971fd8c0b62
1306,bc1qlurpmwa3z4vp6e4ghpafcu0l8lr48tczcr92ur,644,674780170,674780170,1673318289,1671325438,0,inbound,32109ed86ba84fa3652b5044ea7d716c019343017b6b8c8c214d4971fd8c0b62
1307,bc1q395unn2ld6vrljj8yumv5pn5wp360j3cxsfch7,645,227017753,227017753,1672278899,1672264538,0,inbound,32109ed86ba84fa3652b5044ea7d716c019343017b6b8c8c214d4971fd8c0b62
1308,1Fqdx4YUMeQbNqM5c82qcjUJa69AB6Lfbo,646,327936609,326227404,1681066407,1676126977,1709205,outbound,32109ed86ba84fa3652b5044ea7d716c019343017b6b8c8c214d4971fd8c0b62
1309,bc1qq78kgnwyyqh27n8yqdxx7rzyz3y52xkht722d3,647,9880,9880,1672645987,1672264538,0,inbound,32109ed86ba84fa3652b5044ea7d716c019343017b6b8c8c214d4971fd8c0b62
1310,1ABxPzoZpeRrnituusEBAvdWdWLzX38qGj,648,119761135,119761135,1680818569,1674745179,0,outbound,32109ed86ba84fa3652b5044ea7d716c019343017b6b8c8c214d4971fd8c0b62
1311,1PRJ4VbgjJ1Gftm9GTGGHhqLHTX5M91qbB,649,8934605,8934605,1672265024,1672264538,0,inbound,32109ed86ba84fa3652b5044ea7d716c019343017b6b8c8c214d4971fd8c0b62
1312,1787PXoqznpj91ovoTs5FJNfR6erwkLmcm,650,1173661,1173661,1672272614,1672264538,0,inbound,32109ed86ba84fa3652b5044ea7d716c019343017b6b8c8c214d4971fd8c0b62
1313,35XcfK5mjkgFwnbE6MUNQifLSS4qEgzegN,651,209824,209824,1672746206,1672264538,0,inbound,32109ed86ba84fa3652b5044ea7d716c019343017b6b8c8c214d4971fd8c0b62
1314,38noviEYMKv1GB8nSAqgWYu2AukpmDY9da,652,1173842,1173842,1674121123,1672264538,0,inbound,32109ed86ba84fa3652b5044ea7d716c019343017b6b8c8c214d4971fd8c0b62
1315,bc1qd5zq8cqhct0f9ne5w50zrqf99u9ekephgjvm0k,653,163536,163536,1672275824,1672264538,0,inbound,32109ed86ba84fa3652b5044ea7d716c019343017b6b8c8c214d4971fd8c0b62
1316,3JUAgQVs7bVe5Gd1JtgbVHpTaUJa7Tp8Ub,654,881198712,864212762,1680679101,1679237629,16985950,outbound,32109ed86ba84fa3652b5044ea7d716c019343017b6b8c8c214d4971fd8c0b62
1317,1BfJqN1KQhYRD3Fa8YJ9zKK9ajcWHnjSDC,655,740438,740438,1672266040,1672264538,0,inbound,32109ed86ba84fa3652b5044ea7d716c019343017b6b8c8c214d4971fd8c0b62
1318,bc1qsdwlrtmsydrek9u6965eu2kyugpf5qdxlm6srt,656,341789,341789,1672275824,1672264538,0,inbound,32109ed86ba84fa3652b5044ea7d716c019343017b6b8c8c214d4971fd8c0b62
1319,bc1qup57nt4j6sz6gt8cdzycdvejfecatu5ygxzqtn,657,18647622,18647622,1675553199,1669988362,0,inbound,32109ed86ba84fa3652b5044ea7d716c019343017b6b8c8c214d4971fd8c0b62
1320,bc1qw928pn9hgd658yeca7jtmpd72q8474ngw2k62f,658,135590741,135583677,1680109031,1670387064,7064,inbound,32109ed86ba84fa3652b5044ea7d716c019343017b6b8c8c214d4971fd8c0b62
1321,3PEkye3g1uswF5vLiwwmmXng9sdWQrDXTe,659,1445024,1445024,1672155149,1672082849,0,inbound,32109ed86ba84fa3652b5044ea7d716c019343017b6b8c8c214d4971fd8c0b62
1322,18Jxqo6Z8EgbaM4DJmqx8KtTeqFifaoE6w,660,15712526735,15712526735,1681140143,1680900401,0,inbound,32109ed86ba84fa3652b5044ea7d716c019343017b6b8c8c214d4971fd8c0b62
1323,bc1qwvx44jcdu3k09g8v0g0g6guvczqwmhzlkc6ut4,661,13742627371,13740806835,1681138370,1680734268,1820536,inbound,32109ed86ba84fa3652b5044ea7d716c019343017b6b8c8c214d4971fd8c0b62
1324,17xhdXEzyxy1zDNKFkZbSpepWEZ2NxCKUn,662,39382384,39382384,1672963592,1662633595,0,inbound,32109ed86ba84fa3652b5044ea7d716c019343017b6b8c8c214d4971fd8c0b62
1325,3DWuMj4Nbkn4QBWTeVGzVTVnZmtEsXt7Bc,663,750041311,749577018,1680981658,1665709467,464293,inbound,32109ed86ba84fa3652b5044ea7d716c019343017b6b8c8c214d4971fd8c0b62
1326,bc1qees387hhnfrt65zmwhf4vz4j8mcgns9v5quqem,664,88616,88616,1672792584,1672082849,0,inbound,32109ed86ba84fa3652b5044ea7d716c019343017b6b8c8c214d4971fd8c0b62
1327,bc1q9ylq9wewv7ttwzg472wmu9fgf07tunyemwdprc,665,9904,9904,1672084688,1672082849,0,inbound,32109ed86ba84fa3652b5044ea7d716c019343017b6b8c8c214d4971fd8c0b62
1328,bc1qhs7cuxcndnqphwkx86z2gqgxcyfesre7ytjfew,666,1335830,1335830,1672135247,1672082849,0,inbound,32109ed86ba84fa3652b5044ea7d716c019343017b6b8c8c214d4971fd8c0b62
1329,15QLXKx3Ah3cnVtLLr2egDcxwPAs2BC6iu,1031,1926780,1926780,1671776353,1671752684,0,inbound,32109ed86ba84fa3652b5044ea7d716c019343017b6b8c8c214d4971fd8c0b62
1330,bc1q8kzs6rh8869wxsjwsnnt6gg8hrpj95943l4s8e,1032,29779937,29767597,1679511184,1660210506,12340,inbound,32109ed86ba84fa3652b5044ea7d716c019343017b6b8c8c214d4971fd8c0b62
1331,bc1qnnsxq76cn32jnugp2jlanj2feyvf0t5562n3y8p3vf2p2km2ct2sd05nva,1033,594429,594429,1671840580,1671752684,0,inbound,32109ed86ba84fa3652b5044ea7d716c019343017b6b8c8c214d4971fd8c0b62
1332,3GDkv4wJxHzcjZhZKaBPsu3Xb8yzgweEQX,1034,570063,570063,1671796931,1671752684,0,inbound,32109ed86ba84fa3652b5044ea7d716c019343017b6b8c8c214d4971fd8c0b62
1333,1QH64XvhEHDsC6VLmhwpaTLnzCSUfbh4do,1035,45177,45177,1671801050,1671752684,0,inbound,32109ed86ba84fa3652b5044ea7d716c019343017b6b8c8c214d4971fd8c0b62
1334,3EDzBftLxjNd5svhJEpts1VGrtaSCEYc3w,1036,105226,105226,1671775430,1671752684,0,inbound,32109ed86ba84fa3652b5044ea7d716c019343017b6b8c8c214d4971fd8c0b62
1335,1H9F6XcrQLtKpitUNwYJvtJ4UCFcYa8uUw,1037,12975387,12975387,1677161018,1671235687,0,inbound,32109ed86ba84fa3652b5044ea7d716c019343017b6b8c8c214d4971fd8c0b62
1336,3LEu6jfEaSuEX8feE5jJcatwuAtDkg9A5V,1038,7591756,7591756,1677776421,1667702082,0,inbound,32109ed86ba84fa3652b5044ea7d716c019343017b6b8c8c214d4971fd8c0b62
1337,3N88j1g8apjykw8JUQsnuvyJmS3ieT5QVg,1039,49510072,49510072,1681051789,1676989758,0,outbound,32109ed86ba84fa3652b5044ea7d716c019343017b6b8c8c214d4971fd8c0b62
1338,164YUtbffTXaJjnFZ82ktGY6Z1stoMgapJ,1040,662447,662447,1671798733,1671752684,0,inbound,32109ed86ba84fa3652b5044ea7d716c019343017b6b8c8c214d4971fd8c0b62
1339,1FkrdkzKMLJVTvrTy7fUXZ8yS8en1miCC,1041,2906164,2906164,1671774975,1671752684,0,inbound,32109ed86ba84fa3652b5044ea7d716c019343017b6b8c8c214d4971fd8c0b62
1340,bc1qqkxfp0uekv7x6t0gvqdqmaca4vmu56cz7tmz2z,1042,279390,279390,1671755636,1671752684,0,inbound,32109ed86ba84fa3652b5044ea7d716c019343017b6b8c8c214d4971fd8c0b62
1341,bc1qgv2wr8vzhfzzlfqaw0ee7ut6rs2uylguxws2q0,1043,57125754,57125754,1673783385,1670776489,0,inbound,32109ed86ba84fa3652b5044ea7d716c019343017b6b8c8c214d4971fd8c0b62
1342,bc1ql6ku86sj2c8z73mw887dj2yxwxd549the5t4yx,1044,160683340,160683340,1673037427,1670304408,0,outbound,32109ed86ba84fa3652b5044ea7d716c019343017b6b8c8c214d4971fd8c0b62
1343,3QnEcuxC3gkjWaRRCS4sijj6Q7QSsdy1z9,1045,248816,248816,1671775432,1671752684,0,inbound,32109ed86ba84fa3652b5044ea7d716c019343017b6b8c8c214d4971fd8c0b62
1344,39fWdonQwEaaf9EoAn47geG3XiinBN1kGg,1046,5950062,5770570,1679099881,1671113242,179492,inbound,32109ed86ba84fa3652b5044ea7d716c019343017b6b8c8c214d4971fd8c0b62
1345,38KQHrUm7ZtWVSjipHth1zBNqqqkfEug7m,1047,292112395,292112395,1680838157,1673023817,0,outbound,32109ed86ba84fa3652b5044ea7d716c019343017b6b8c8c214d4971fd8c0b62
1346,3FpP89VvWqHgsc7rpepJiCxnoDKHW4gqxj,1048,364959,364959,1671775432,1671752684,0,inbound,32109ed86ba84fa3652b5044ea7d716c019343017b6b8c8c214d4971fd8c0b62
1347,bc1qa9e7syxmre5tpu57szsfy8df0s6xq97nlzlqdr,1049,236322228,236310064,1680668422,1667667999,12164,outbound,32109ed86ba84fa3652b5044ea7d716c019343017b6b8c8c214d4971fd8c0b62
1348,1HjTTYpKuKKCtM37B2uTFB7R46KGRwSCh5,1050,886815408,886815408,1680825727,1672889709,0,inbound,32109ed86ba84fa3652b5044ea7d716c019343017b6b8c8c214d4971fd8c0b62
1349,19ymKRzH1iv28DEboAdCJ1MRtTRHB7dEtP,1051,7893897,7893897,1672331754,1671752684,0,inbound,32109ed86ba84fa3652b5044ea7d716c019343017b6b8c8c214d4971fd8c0b62
1350,3BU1ZRjhdfH6DX1XLofacujuH7oNQP4QPc,1052,132594,132594,1671775431,1671752684,0,inbound,32109ed86ba84fa3652b5044ea7d716c019343017b6b8c8c214d4971fd8c0b62
1351,3AuijhL2soddj3t5mmCPiWa3gUgPTNjo1U,1053,3795140,3307327,1680432742,1677148323,487813,inbound,32109ed86ba84fa3652b5044ea7d716c019343017b6b8c8c214d4971fd8c0b62
1352,385Kq1YNsvfmQRx8JYM1HYKY1PsFqD36vM,1054,132582,132582,1671771704,1671752684,0,inbound,32109ed86ba84fa3652b5044ea7d716c019343017b6b8c8c214d4971fd8c0b62
1353,3QbHN721X1VNExviQr4u75Fg67B1dQ4Znu,1055,223867,223867,1671775432,1671752684,0,inbound,32109ed86ba84fa3652b5044ea7d716c019343017b6b8c8c214d4971fd8c0b62
1354,1N4yF8r7Ne4ysPcNX1zHgi6rHS2seD6eT3,1056,52891290,52891290,1679080212,1671853185,0,inbound,32109ed86ba84fa3652b5044ea7d716c019343017b6b8c8c214d4971fd8c0b62
1355,3NVNg1Y2Rmby4RcmrE2iGVgnukciC34s1f,1057,3437445,3437445,1679935272,1667401241,0,inbound,32109ed86ba84fa3652b5044ea7d716c019343017b6b8c8c214d4971fd8c0b62
1356,3L2cDRF1eCLbtYUYk96ytFRzHhBeRpGGJy,1058,336000,336000,1671771700,1671752684,0,inbound,32109ed86ba84fa3652b5044ea7d716c019343017b6b8c8c214d4971fd8c0b62
1357,12eyN8bYvpyQfms2vm9316967aWJqQV7nU,1059,335889,335889,1671782436,1671752684,0,inbound,32109ed86ba84fa3652b5044ea7d716c019343017b6b8c8c214d4971fd8c0b62
1358,3KhaopKnjCUY4n9RP9MGXwYBDwuVUAJSqX,1060,118888,118888,1672391817,1671752684,0,inbound,32109ed86ba84fa3652b5044ea7d716c019343017b6b8c8c214d4971fd8c0b62
1359,19xnC67H9xmKbCcQiGNdPsV34EemGnrs4K,1061,103501,103501,1675147755,1671752684,0,inbound,32109ed86ba84fa3652b5044ea7d716c019343017b6b8c8c214d4971fd8c0b62
1360,3Q4quhYs3SHNJHds6QGYAjABPuibSL8itZ,1333,257546,257546,1671521604,1671240543,0,inbound,32109ed86ba84fa3652b5044ea7d716c019343017b6b8c8c214d4971fd8c0b62
1361,bc1q8le2eywdj8cs59rwewsat390ujfr7lvmzehpw5,1334,133405,133405,1671572556,1671240543,0,inbound,32109ed86ba84fa3652b5044ea7d716c019343017b6b8c8c214d4971fd8c0b62
1362,3QPJQ5G7qQCzxr4zf41od8pzRVMXhKFNvr,1335,426780361,422228779,1681123232,1680878338,4551582,outbound,32109ed86ba84fa3652b5044ea7d716c019343017b6b8c8c214d4971fd8c0b62
1363,38uVTtdbKLbgRDuNxQxq794Lfd4rR2kn97,1336,572328,572328,1671301438,1671240543,0,inbound,32109ed86ba84fa3652b5044ea7d716c019343017b6b8c8c214d4971fd8c0b62
1364,3AVqJv28uTSptrSJYnbXPDviQbbhzCgtmW,1337,197771,197771,1671240832,1671240543,0,inbound,32109ed86ba84fa3652b5044ea7d716c019343017b6b8c8c214d4971fd8c0b62
1365,bc1qa3d0gt8e4nkzea2xcamcdfc4m6xtyhuf9m23k3,1338,143760082,143760082,1671371073,1661880789,0,inbound,32109ed86ba84fa3652b5044ea7d716c019343017b6b8c8c214d4971fd8c0b62
1366,bc1qekj84fwrql5aq5ya6akgwskwgsk3q762gzfypx,1339,74841,74841,1671509552,1671240543,0,inbound,32109ed86ba84fa3652b5044ea7d716c019343017b6b8c8c214d4971fd8c0b62
1367,bc1qm77e3dlqsdtekm9lkr4d4er9s0achzgu2jju05,1340,20391239,20391239,1671568465,1669665439,0,inbound,32109ed86ba84fa3652b5044ea7d716c019343017b6b8c8c214d4971fd8c0b62
1368,bc1q796p9kg666l0f7cdxz5ywpwnfxd0gtytrxdaya,1341,455656,455656,1671310299,1671240543,0,inbound,32109ed86ba84fa3652b5044ea7d716c019343017b6b8c8c214d4971fd8c0b62
1369,bc1q0yz6egqf58v32rt0vlxqqhkjy52ducra2alr2a,1342,179374206,177210500,1680990097,1655493701,2163706,outbound,32109ed86ba84fa3652b5044ea7d716c019343017b6b8c8c214d4971fd8c0b62
1370,1E12SYYJ8duXuZC2Movp3zTmBTczZQh7tK,1343,209540,209540,1671240646,1671238939,0,inbound,32109ed86ba84fa3652b5044ea7d716c019343017b6b8c8c214d4971fd8c0b62
1371,369gi3nMbCYg9n1sHWXv7GGTJp9odxfj3U,1344,437647,437647,1671246312,1671240543,0,inbound,32109ed86ba84fa3652b5044ea7d716c019343017b6b8c8c214d4971fd8c0b62
1372,bc1qfmcgc7emxqghxzghq45nfrg2vfxyuts8g0nvw4,1345,74830,74830,1671240771,1671240544,0,inbound,32109ed86ba84fa3652b5044ea7d716c019343017b6b8c8c214d4971fd8c0b62
1373,3HhE1tNBHywXUnY9smKTRANZG1CWyE1EP4,1346,510067128,510067128,1680615865,1651445372,0,inbound,32109ed86ba84fa3652b5044ea7d716c019343017b6b8c8c214d4971fd8c0b62
1374,bc1qgzdj3fs32ydjty25v44607s04s4k7smdz632lr,1347,203318720,203318720,1680529501,1671130014,0,inbound,32109ed86ba84fa3652b5044ea7d716c019343017b6b8c8c214d4971fd8c0b62
1375,3PcKDRmAFizTojS4FQjrAMgHDvvPM7C83A,1348,139279,139279,1671254010,1671240544,0,inbound,32109ed86ba84fa3652b5044ea7d716c019343017b6b8c8c214d4971fd8c0b62
1376,3FH4dii93RugP6nPEu5MbcwXxrQMVUFdpv,1349,113031470,111465755,1681115123,1679314613,1565715,inbound,32109ed86ba84fa3652b5044ea7d716c019343017b6b8c8c214d4971fd8c0b62
1377,17rbgVyr14h3Dpyc2DCFyoe8BjpEyJkV3W,1350,32772242,32772242,1680826424,1668608086,0,inbound,32109ed86ba84fa3652b5044ea7d716c019343017b6b8c8c214d4971fd8c0b62
1378,1Ej2BQTiLiTRRAjbZn2f2dzF1JyvHiat6,1351,303621892,303621892,1678838562,1672675383,0,outbound,32109ed86ba84fa3652b5044ea7d716c019343017b6b8c8c214d4971fd8c0b62
1379,3NosMDp4WGAdKgCTCPaL2XBhRw3HXbHXdY,1352,46415872,46415872,1677773354,1675515380,0,inbound,32109ed86ba84fa3652b5044ea7d716c019343017b6b8c8c214d4971fd8c0b62
1380,39Uy6gyoRU2ipDB3NpCy45kEis6SCATXvU,1353,117901,117901,1672162031,1671240543,0,inbound,32109ed86ba84fa3652b5044ea7d716c019343017b6b8c8c214d4971fd8c0b62
1381,3CfifG1GQybXqTJUvFLswsujwrBZSQEy6b,1354,2392000,2392000,1671303233,1671240544,0,inbound,32109ed86ba84fa3652b5044ea7d716c019343017b6b8c8c214d4971fd8c0b62
1382,bc1qyns2kzksx2d5adntwn2zhmkqq5hqqd6wyuyy6v,1355,487376677,487376677,1680816676,1671725182,0,inbound,32109ed86ba84fa3652b5044ea7d716c019343017b6b8c8c214d4971fd8c0b62
1383,3HNCZvX9GMwkgff7bia1MeQumrrnm6caza,1356,1479870,1479870,1680232680,1669487084,0,inbound,32109ed86ba84fa3652b5044ea7d716c019343017b6b8c8c214d4971fd8c0b62
1384,bc1q8spuh2n82qfsra5nqry6qycu2txn0ukp6pz2jf,1357,133411,133411,1671572556,1671240544,0,inbound,32109ed86ba84fa3652b5044ea7d716c019343017b6b8c8c214d4971fd8c0b62
1385,3Dbzc7odqJnPQiGA28mN3JBTknCF7KN6At,1358,2927758,2927758,1671528152,1671240543,0,inbound,32109ed86ba84fa3652b5044ea7d716c019343017b6b8c8c214d4971fd8c0b62
1386,bc1q6mdaswyhkl8aakjr7vlj9g8wv9zxhmvfjfsphw,1359,5049331079,5049331079,1681142452,1679550656,0,inbound,32109ed86ba84fa3652b5044ea7d716c019343017b6b8c8c214d4971fd8c0b62
1387,35tvbnqcxKsQB9BzkWjbXmZ1HJRQdT8hUA,1360,2153000,2153000,1671246057,1671240543,0,inbound,32109ed86ba84fa3652b5044ea7d716c019343017b6b8c8c214d4971fd8c0b62
1388,33PAB5ccksuGj5Y8o2ph2WSue3ynWf8TP9,1361,604695,604695,1673862978,1671240543,0,inbound,32109ed86ba84fa3652b5044ea7d716c019343017b6b8c8c214d4971fd8c0b62
1389,3HVyBfskXLPUHm7oQCNDcPfsiW8txKYxdm,1362,9410099,9410099,1671523245,1664697956,0,inbound,32109ed86ba84fa3652b5044ea7d716c019343017b6b8c8c214d4971fd8c0b62
1390,32DvUA7UtBmKkkNcgeJyZxTXS8iyBE1y6H,1363,1652256021,1650905326,1680689454,1675624221,1350695,inbound,32109ed86ba84fa3652b5044ea7d716c019343017b6b8c8c214d4971fd8c0b62
1391,38UWbTrAPkL4cqkdTVUM2Zv9PScTYWEJrp,667,397712,397712,1672765270,1672082849,0,inbound,c2f4dbb9490cf97c844557b34d53b0ec77b334a23b334bde3eebd456c4c023af
1392,34axfkwpGJGmRhg8rMDMz1FhSLpurTvHYe,1062,49047,49047,1671759951,1671752684,0,inbound,c2f4dbb9490cf97c844557b34d53b0ec77b334a23b334bde3eebd456c4c023af
1393,3Qaa6YbkBw97P7sk2GkDTZtbWSsNpgNM9n,1364,227031,227031,1671597983,1671240543,0,inbound,c2f4dbb9490cf97c844557b34d53b0ec77b334a23b334bde3eebd456c4c023af
1394,bc1qndux2v2hcqsnq85s2h2cejlcmq8xewqkn3t4v8,668,269863,269863,1672140533,1672082849,0,inbound,25770c89c6e8e19f2c88a5b6c95685124e67186d3b9b626afab1add34f26d526
1395,3Hp8hiFFKuedBCHrr3HZPsiQhEBnncFtLz,669,24045,24045,1672099519,1672082849,0,inbound,25770c89c6e8e19f2c88a5b6c95685124e67186d3b9b626afab1add34f26d526
1396,1LxFJnGqMaDo898CwrsMXAzkTDM29uK5zV,670,288646,288646,1672083113,1672082849,0,inbound,25770c89c6e8e19f2c88a5b6c95685124e67186d3b9b626afab1add34f26d526
1397,16vxibAA1VM33S2tzzkfo2LoSA51qCky1E,671,73316548,73316548,1681070799,1667513642,0,inbound,25770c89c6e8e19f2c88a5b6c95685124e67186d3b9b626afab1add34f26d526
1398,bc1qp5nh5vdgp3e2k9y880p3xglvnm465v3qp3lnyv,672,375641,375641,1673135202,1672082849,0,inbound,25770c89c6e8e19f2c88a5b6c95685124e67186d3b9b626afab1add34f26d526
1399,3CTFTF4a8ifDbbMXybJGNtZbRFnKGMjtSX,673,8606933,8155684,1681115138,1669677198,451249,inbound,25770c89c6e8e19f2c88a5b6c95685124e67186d3b9b626afab1add34f26d526
1400,3KABVWspZ7qvuycSwBWPtGsi5zjfmmL6DE,674,483533846,483119640,1679551307,1671555217,414206,outbound,25770c89c6e8e19f2c88a5b6c95685124e67186d3b9b626afab1add34f26d526
1401,33ueRG2yNpAwinSSNtS9vqeDyeq6j5isGw,675,154365,154365,1672879469,1672082849,0,inbound,25770c89c6e8e19f2c88a5b6c95685124e67186d3b9b626afab1add34f26d526
1402,32BzYg7XWwCvmrLDBTaHktztLfx5iTysQs,676,597793,597793,1672163184,1672082849,0,inbound,25770c89c6e8e19f2c88a5b6c95685124e67186d3b9b626afab1add34f26d526
1403,12K767MYma5nyEJPm5dVKzryBiLpy4TidF,677,277064,277064,1672287799,1672082849,0,inbound,25770c89c6e8e19f2c88a5b6c95685124e67186d3b9b626afab1add34f26d526
1404,bc1qxtelzudq4cchajcudhlq47qmqaye3q2g2m8vdy,678,69300187,69202433,1680993356,1670370681,97754,inbound,25770c89c6e8e19f2c88a5b6c95685124e67186d3b9b626afab1add34f26d526
1405,1FCJ28gJ3X57fp15wZk6HctDDTyTatYxFh,1063,131872460,131872460,1681120940,1677621663,0,inbound,25770c89c6e8e19f2c88a5b6c95685124e67186d3b9b626afab1add34f26d526
1406,bc1qjklx0f3f8cxy8w6pu6v0xaxqftd8swalk9nv4s,1064,847939,847939,1672078534,1671748381,0,inbound,25770c89c6e8e19f2c88a5b6c95685124e67186d3b9b626afab1add34f26d526
1407,bc1qsp8myjskrjc6etadk2ayt0lkrvdjj8nrrgayujs9kdw23p8g9zzqsaf6st,1065,150002,150002,1671840580,1671752684,0,inbound,25770c89c6e8e19f2c88a5b6c95685124e67186d3b9b626afab1add34f26d526
1408,16RbspcbSRUJJAT2YiyNsbY7KmsoT5VU9t,1066,235405,235405,1672291756,1671752684,0,inbound,25770c89c6e8e19f2c88a5b6c95685124e67186d3b9b626afab1add34f26d526
1409,14PpuGrhANd3pyXPaaBva2DQzSVXLfxRgU,1067,1421051601,1421048093,1678428106,1679056630,3508,inbound,25770c89c6e8e19f2c88a5b6c95685124e67186d3b9b626afab1add34f26d526
1410,36xeW5My1pfYcJCvauXQ44656EuSqUcCvh,1068,132543,132543,1672281026,1671752684,0,inbound,25770c89c6e8e19f2c88a5b6c95685124e67186d3b9b626afab1add34f26d526
1411,bc1qfh26vcr7hg768trlsxunpayc93lr6z3lxvt9ld,1069,1323659,1317718,1677183865,1668266279,5941,inbound,25770c89c6e8e19f2c88a5b6c95685124e67186d3b9b626afab1add34f26d526
1412,bc1qtj907l2d4dxtl6trxjpk5k2dcnnnvuglszja5d,1070,277891,277891,1671777028,1671752684,0,inbound,25770c89c6e8e19f2c88a5b6c95685124e67186d3b9b626afab1add34f26d526
1413,36iLBRXDFzP1whaLZmZHCgx32HBHMtZcjA,1071,595000,595000,1671756959,1671752684,0,inbound,25770c89c6e8e19f2c88a5b6c95685124e67186d3b9b626afab1add34f26d526
1414,16i5F8Lk39CUpFqTVAnWDvUy9vzsBF6VTc,1072,118425867,118425867,1675730973,1670994733,0,outbound,25770c89c6e8e19f2c88a5b6c95685124e67186d3b9b626afab1add34f26d526
1415,39Zrft4xAP4VBUywiE9Jv5FVuf6NajxpXf,1073,132705,132705,1671771706,1671752684,0,inbound,25770c89c6e8e19f2c88a5b6c95685124e67186d3b9b626afab1add34f26d526
1416,3DodNwJydCKpF49SxJwWo5pfmg5qJVV5mC,1365,162608,162608,1671282107,1671240544,0,inbound,25770c89c6e8e19f2c88a5b6c95685124e67186d3b9b626afab1add34f26d526
1417,3BRjiWXdHBuS4msPKdYTpKooYNCXYCwZqs,1366,21879757,21879757,1672315367,1666820963,0,inbound,25770c89c6e8e19f2c88a5b6c95685124e67186d3b9b626afab1add34f26d526
1418,3D3LQgcBchN1xeJ4QJqpBCv3dwiGDV1aor,1367,868256,868256,1671253304,1671240543,0,inbound,25770c89c6e8e19f2c88a5b6c95685124e67186d3b9b626afab1add34f26d526
1419,3DZxVPUGJUwpvnt3aokMto171UdUYek5zd,1368,118984363,118658526,1680184359,1678343944,325837,inbound,25770c89c6e8e19f2c88a5b6c95685124e67186d3b9b626afab1add34f26d526
1420,34k15gAVb7tqjksDNZkhPDrTFQJbAHspcg,1369,599063,599063,1671271284,1671240543,0,inbound,25770c89c6e8e19f2c88a5b6c95685124e67186d3b9b626afab1add34f26d526
1421,1DHtCgYQguakptMKTJxZsXqNdgRXaByyQ1,1370,3207877,3207877,1679341231,1671240543,0,inbound,25770c89c6e8e19f2c88a5b6c95685124e67186d3b9b626afab1add34f26d526
1422,38LENZ8sMQUuXFmqGsT7Yu8BVgVmQ8gpvb,1371,60482,60482,1671596041,1671240543,0,inbound,25770c89c6e8e19f2c88a5b6c95685124e67186d3b9b626afab1add34f26d526
1423,36T7g5sZZ7KWA2RNBSyKgpdnaMMs7oYkGt,1372,20286687,20286687,1676511337,1658946221,0,outbound,25770c89c6e8e19f2c88a5b6c95685124e67186d3b9b626afab1add34f26d526
1424,37jee1wSCdociEz6i9tHG7Hmn9atnuKdoN,1373,367443,367443,1671253292,1671240543,0,inbound,25770c89c6e8e19f2c88a5b6c95685124e67186d3b9b626afab1add34f26d526
1425,1LcWpDtUkMEMApoJnwrXRNfJuFTGRBsJBo,1374,135984,135984,1671252189,1671240543,0,inbound,25770c89c6e8e19f2c88a5b6c95685124e67186d3b9b626afab1add34f26d526
1426,34m9JWa4z7GXbSHwLd35KHxCY55bzC2hpJ,1375,119824,119824,1672162022,1671240543,0,inbound,25770c89c6e8e19f2c88a5b6c95685124e67186d3b9b626afab1add34f26d526
1427,bc1q37lf73t7kgu7308n2r0kp0g989jjkqt5m2vety,679,108755,108755,1672110568,1672082849,0,inbound,cb0e5b807a8831cd1ca2474c57ea1cd0467b2611938d78a1cfdf948a49b5f7e6
1428,1K3SxFTzoW5kBE4FtvvEaJd7BW6XmAQ6Me,680,11592320,11592320,1673107722,1663257238,0,inbound,cb0e5b807a8831cd1ca2474c57ea1cd0467b2611938d78a1cfdf948a49b5f7e6
1429,3K5Ab8idZEGgXbicU98niYZxS9kFTorV5i,681,3062000,3062000,1672086209,1672082849,0,inbound,cb0e5b807a8831cd1ca2474c57ea1cd0467b2611938d78a1cfdf948a49b5f7e6
1430,bc1qzeq6yt2x3hcj29zltgdh0948mtnp4ecxkgumu4,682,20192417,20192417,1673876425,1670632017,0,inbound,cb0e5b807a8831cd1ca2474c57ea1cd0467b2611938d78a1cfdf948a49b5f7e6
1431,13QAVbPFJomDPdshJHvEdXdckvFH7imeUF,683,90000,90000,1672116174,1672082849,0,inbound,cb0e5b807a8831cd1ca2474c57ea1cd0467b2611938d78a1cfdf948a49b5f7e6
1432,bc1qfppzundkfrg4k84273hgv2a0x0u388fsuzcx44,684,69089806,69089806,1679971268,1674917333,0,inbound,cb0e5b807a8831cd1ca2474c57ea1cd0467b2611938d78a1cfdf948a49b5f7e6
1433,3G5hEnBx6ebA8Fb98cCM6DFmAEkd6LBqsG,685,306043,306043,1672099665,1672082849,0,inbound,cb0e5b807a8831cd1ca2474c57ea1cd0467b2611938d78a1cfdf948a49b5f7e6
1434,15Ygnx3U4BywnifQ5Sa2Zn7pQj7ZvT2Qti,686,60870489,60870489,1680725600,1668054230,0,inbound,cb0e5b807a8831cd1ca2474c57ea1cd0467b2611938d78a1cfdf948a49b5f7e6
1435,3Q8kzaVGMZ1G4mrHS4CPRLiBkuPaKQSzXs,687,120351851,118784310,1681115192,1678850351,1567541,inbound,cb0e5b807a8831cd1ca2474c57ea1cd0467b2611938d78a1cfdf948a49b5f7e6
1436,3B2XeDmtK4wWcsR7XmwJcarFxKQFbjJyxp,688,178399,178399,1672767823,1672082849,0,inbound,cb0e5b807a8831cd1ca2474c57ea1cd0467b2611938d78a1cfdf948a49b5f7e6
1437,334GT6qRXh29enzDueHsNaSup3wyexkMQD,689,13089429,12600034,1681115162,1674540117,489395,outbound,cb0e5b807a8831cd1ca2474c57ea1cd0467b2611938d78a1cfdf948a49b5f7e6
1438,3PgfU1Lv4nvgcuZR5wPCPmosyiUHK2CvAi,690,100931,100931,1672099662,1672082849,0,inbound,cb0e5b807a8831cd1ca2474c57ea1cd0467b2611938d78a1cfdf948a49b5f7e6
1439,1PQdhSoLsMcvBY1vrg5zP27Neac4Y8vkmV,691,1187403,1187403,1672084455,1672082849,0,inbound,cb0e5b807a8831cd1ca2474c57ea1cd0467b2611938d78a1cfdf948a49b5f7e6
1440,bc1qhqwfcqqmv8pu8a8gfcz37c0medg03x9ru9hmey,692,173942058,173942058,1681071428,1674931922,0,inbound,cb0e5b807a8831cd1ca2474c57ea1cd0467b2611938d78a1cfdf948a49b5f7e6
1441,1DHQMJkfW9eNtm9nuKWzD4ANenbG7428or,693,2659644053,2659644053,1678039315,1676169101,0,inbound,cb0e5b807a8831cd1ca2474c57ea1cd0467b2611938d78a1cfdf948a49b5f7e6
1442,3MvtWKpHkeARF4eSf9i8jNJCodHoQaYqzn,694,71042,71042,1672099316,1672082849,0,inbound,cb0e5b807a8831cd1ca2474c57ea1cd0467b2611938d78a1cfdf948a49b5f7e6
1443,bc1qkhundhz02xqmt8g8kkf0jyfdvf09ympctyasg6,695,1820151,1818940,1672093380,1644789227,1211,inbound,cb0e5b807a8831cd1ca2474c57ea1cd0467b2611938d78a1cfdf948a49b5f7e6
1444,32P4U7o4MPiKQmqQxGKCRXutz6uzAEZx74,696,118742,118742,1673310386,1672082849,0,inbound,cb0e5b807a8831cd1ca2474c57ea1cd0467b2611938d78a1cfdf948a49b5f7e6
1445,3JSXNAiCUMp1h7kQG8rBjKnhXjCbQF39gV,697,362157,362157,1672117294,1672082849,0,inbound,cb0e5b807a8831cd1ca2474c57ea1cd0467b2611938d78a1cfdf948a49b5f7e6
1446,3Fmw3wNhJnaHzybGcHi1zZVX3VX8we38Kk,698,89055,89055,1672099514,1672082849,0,inbound,cb0e5b807a8831cd1ca2474c57ea1cd0467b2611938d78a1cfdf948a49b5f7e6
1447,3HtLMpqwdVLiwMUFMpGoSk5LiZHAw4Jieb,699,340077449,335090053,1677880814,1677275709,4987396,inbound,cb0e5b807a8831cd1ca2474c57ea1cd0467b2611938d78a1cfdf948a49b5f7e6
1448,bc1q3fktruyp5qr4m772ghkdmlusk37dv2tqu9amk3y9nll995zgad3s2ktr2x,1074,219679,219679,1671804222,1671752684,0,inbound,cb0e5b807a8831cd1ca2474c57ea1cd0467b2611938d78a1cfdf948a49b5f7e6
1449,1AVd8SzQSPaefoAwZ2vBJJPezv1iML6Hec,1075,16086,16086,1671828373,1671752684,0,inbound,cb0e5b807a8831cd1ca2474c57ea1cd0467b2611938d78a1cfdf948a49b5f7e6
1450,1JMXVQQjKqZJhQvQTgksXoNFkysEtSfEBB,1076,110439,110439,1674004572,1671752684,0,inbound,cb0e5b807a8831cd1ca2474c57ea1cd0467b2611938d78a1cfdf948a49b5f7e6
1451,32de6auPQ1TmP8Fcj1DMs1bReAEMsGf89D,1077,17881936,17881936,1679024425,1668360074,0,inbound,cb0e5b807a8831cd1ca2474c57ea1cd0467b2611938d78a1cfdf948a49b5f7e6
1452,3MR89aDmu3eXVb4zVPNNRrWY1qGowGubED,1078,150134,150134,1671775326,1671752684,0,inbound,cb0e5b807a8831cd1ca2474c57ea1cd0467b2611938d78a1cfdf948a49b5f7e6
1453,bc1qj8pgfekla9en3vqum73gmfwdt9m2cp2nyea8sw9vf0epcs8e72vs53y4x0,1079,301096,301096,1672281026,1671752684,0,inbound,cb0e5b807a8831cd1ca2474c57ea1cd0467b2611938d78a1cfdf948a49b5f7e6
1454,1NVnhymVNk6dFCo7Q4cF8oRwnW7zggq9oT,1080,197718506,197718506,1681143132,1679342817,0,outbound,cb0e5b807a8831cd1ca2474c57ea1cd0467b2611938d78a1cfdf948a49b5f7e6
1455,bc1qncg0sygxyssvgw33yp35ryele75aqeqmmq6gce,1081,628116,628116,1671754701,1671752684,0,inbound,cb0e5b807a8831cd1ca2474c57ea1cd0467b2611938d78a1cfdf948a49b5f7e6
1456,3KNEma8KHvbAJiGp2YGrLGQsTPJua4ujrk,1082,20004289,20004289,1675695878,1670989224,0,inbound,cb0e5b807a8831cd1ca2474c57ea1cd0467b2611938d78a1cfdf948a49b5f7e6
1457,36Tq9AzjEhozgL6PZMRyQuPmMWrSEMBukU,1083,135129291,135018334,1678803981,1677024665,110957,outbound,cb0e5b807a8831cd1ca2474c57ea1cd0467b2611938d78a1cfdf948a49b5f7e6
1458,37Vuoqb1muP8yj8bEPS6AurA4fwQsRqWcj,1084,208000,208000,1671756611,1671752684,0,inbound,cb0e5b807a8831cd1ca2474c57ea1cd0467b2611938d78a1cfdf948a49b5f7e6
1459,3P43VTqyoCuK4sMhvyZb6NzZnTKVktztoV,1085,103502,103502,1671775430,1671752684,0,inbound,cb0e5b807a8831cd1ca2474c57ea1cd0467b2611938d78a1cfdf948a49b5f7e6
1460,12eiqo5NDAPEzJ8E45Xz2juxuzZCo3HZNv,1086,134880649,134880649,1681121044,1679559085,0,outbound,cb0e5b807a8831cd1ca2474c57ea1cd0467b2611938d78a1cfdf948a49b5f7e6
1461,bc1qj89grljll5m3a94qltv2ppdrymgmd0du9s77z3,1087,28182516,28182516,1675107846,1669173979,0,inbound,cb0e5b807a8831cd1ca2474c57ea1cd0467b2611938d78a1cfdf948a49b5f7e6
1462,bc1qgnlx4yhrurpxhdqzeh9ydu6j5ptq9l3x0yr8r4,1088,3536624,3536624,1673341073,1671730571,0,inbound,cb0e5b807a8831cd1ca2474c57ea1cd0467b2611938d78a1cfdf948a49b5f7e6
1463,3DdDpJWiBLhjhhuVyKF5MWbjc8hQE2Ue38,1089,132583,132583,1672098136,1671752684,0,inbound,cb0e5b807a8831cd1ca2474c57ea1cd0467b2611938d78a1cfdf948a49b5f7e6
1464,1Hafi1FAqSB4vKKuG78cE6W2LYnABjmyvw,1090,611716,0,1671752684,1671752684,611716,inbound,cb0e5b807a8831cd1ca2474c57ea1cd0467b2611938d78a1cfdf948a49b5f7e6
1465,1BPvug7JaxpPhnS4Q7aMJ3y5Rm2jHkczBa,1091,166494253,166494253,1681135627,1676957195,0,inbound,cb0e5b807a8831cd1ca2474c57ea1cd0467b2611938d78a1cfdf948a49b5f7e6
1466,3K43tutVnFEfXhZaeNN6hEsLqdaJHzkC9C,1092,370864,370864,1671775432,1671752684,0,inbound,cb0e5b807a8831cd1ca2474c57ea1cd0467b2611938d78a1cfdf948a49b5f7e6
1467,bc1qmvz8rfnqf7hq7v4p24kdvwrsvcj7r9vtlc6ztl,1093,61684171,61675562,1679561965,1647024606,8609,inbound,cb0e5b807a8831cd1ca2474c57ea1cd0467b2611938d78a1cfdf948a49b5f7e6
1468,3EMGWZTPkyY2XaFdXRKKtGK85g1ExbWQfg,1094,594446,594446,1671782855,1671752684,0,inbound,cb0e5b807a8831cd1ca2474c57ea1cd0467b2611938d78a1cfdf948a49b5f7e6
1469,3BLp1MMMETNTkuCUBZ8HDSxCq5pP8hFpzX,1095,114282565,114282565,1675188118,1669597245,0,outbound,cb0e5b807a8831cd1ca2474c57ea1cd0467b2611938d78a1cfdf948a49b5f7e6
1470,bc1qurpeqve6crsnztkvsf5w3vp7hkz8n590y5p7rf,1096,13743051,13743051,1680291213,1657101713,0,inbound,cb0e5b807a8831cd1ca2474c57ea1cd0467b2611938d78a1cfdf948a49b5f7e6
1471,37kKHnkGkoTbk91pohoVgVwxnjyxDfLP9P,1097,115076,115076,1671775430,1671752684,0,inbound,cb0e5b807a8831cd1ca2474c57ea1cd0467b2611938d78a1cfdf948a49b5f7e6
1472,1QEdtSwkKzKdw7mrjzRRiBi5kdd9uhpP4s,1098,3910165,3910165,1674716332,1650090003,0,inbound,cb0e5b807a8831cd1ca2474c57ea1cd0467b2611938d78a1cfdf948a49b5f7e6
1473,bc1qz9tfgdyglxdv2slmd3ta0ldmfdvdqqzucg8k46,1099,68575,68575,1671763882,1671752684,0,inbound,cb0e5b807a8831cd1ca2474c57ea1cd0467b2611938d78a1cfdf948a49b5f7e6
1474,17VXwfttVCW8AfahAKNiMZLgaUNTxfaHFG,1100,308939476,308939476,1680010378,1670915747,0,inbound,cb0e5b807a8831cd1ca2474c57ea1cd0467b2611938d78a1cfdf948a49b5f7e6
1475,3K4fKD9zR5sgZqdywJ1sjePtFCnJBVaFio,1101,616563,616563,1672281026,1671752684,0,inbound,cb0e5b807a8831cd1ca2474c57ea1cd0467b2611938d78a1cfdf948a49b5f7e6
1476,3PjFJSieppmt83BCuNVPK95ejJE84rYhB8,1102,657211,657211,1671775435,1671752684,0,inbound,cb0e5b807a8831cd1ca2474c57ea1cd0467b2611938d78a1cfdf948a49b5f7e6
1477,36b8RSzfPjZ3jWhxxeaDn4L43NmB5tSDBP,1103,103504,103504,1671777664,1671752684,0,inbound,cb0e5b807a8831cd1ca2474c57ea1cd0467b2611938d78a1cfdf948a49b5f7e6
1478,bc1qy5gln4eyrgxhveavxqm9hl447f2ulaj7dsg0f2pyfjjdlq63gssqmcsmsg,1104,151592,151592,1671804222,1671752684,0,inbound,cb0e5b807a8831cd1ca2474c57ea1cd0467b2611938d78a1cfdf948a49b5f7e6
1479,151m1M48xYQe9DGTwjJdjBmerbiiV6gqaq,1105,33385,33385,1671770413,1671752684,0,inbound,cb0e5b807a8831cd1ca2474c57ea1cd0467b2611938d78a1cfdf948a49b5f7e6
1480,3Dk1jE2Q1wPpc7Dt2DmkYMTRoKGrQXPoPS,1106,301021,301021,1671775432,1671752684,0,inbound,cb0e5b807a8831cd1ca2474c57ea1cd0467b2611938d78a1cfdf948a49b5f7e6
1481,3DZG7a1HWnXozQNkiTVLFtVkgxAxhJpyzv,1107,214002,214002,1671775325,1671752684,0,inbound,cb0e5b807a8831cd1ca2474c57ea1cd0467b2611938d78a1cfdf948a49b5f7e6
1482,1CodkApg3M1pMP2N2SdkyYTJrmrh1gRnsn,1108,219747,219747,1671771617,1671752684,0,inbound,cb0e5b807a8831cd1ca2474c57ea1cd0467b2611938d78a1cfdf948a49b5f7e6
1483,3H4SqH5qJeRxzKCpfZmmwL2qFebRasbjdy,1109,161562,161562,1671771703,1671752684,0,inbound,cb0e5b807a8831cd1ca2474c57ea1cd0467b2611938d78a1cfdf948a49b5f7e6
1484,3A76UHTV9XNZQhwuDYVHQe43evETzAT7R9,1110,304581830,303484731,1680920067,1673612280,1097099,outbound,cb0e5b807a8831cd1ca2474c57ea1cd0467b2611938d78a1cfdf948a49b5f7e6
1485,3Gyio4A9yqYtAMYUttDh9QgWMaibx3cJco,1111,796593,796593,1671775432,1671752684,0,inbound,cb0e5b807a8831cd1ca2474c57ea1cd0467b2611938d78a1cfdf948a49b5f7e6
1486,38R7bQHgpgFpLeA1bUqZkrcjThY5gs8hpc,1112,103509,103509,1672100228,1671752684,0,inbound,cb0e5b807a8831cd1ca2474c57ea1cd0467b2611938d78a1cfdf948a49b5f7e6
1487,bc1q6yt83ww0l03k688zeuz03tugvwd47jsj8cftrs,1113,160501,160501,1671805138,1671752684,0,inbound,cb0e5b807a8831cd1ca2474c57ea1cd0467b2611938d78a1cfdf948a49b5f7e6
1488,3Ke3n5FtHnngmNJD4eVNdWsa4sUV6K8oRd,1114,136297,136297,1671753273,1671752684,0,inbound,cb0e5b807a8831cd1ca2474c57ea1cd0467b2611938d78a1cfdf948a49b5f7e6
1489,3DtGMpRMzqABNuLUUzxG2jrcdn2DpX5ELv,1115,306908,306908,1672133412,1671752684,0,inbound,cb0e5b807a8831cd1ca2474c57ea1cd0467b2611938d78a1cfdf948a49b5f7e6
1490,19YC3xtxvT7M7nz4hjaXnw1gxWbosFLxXp,1116,686918053,684727489,1681136698,1679380254,2190564,inbound,cb0e5b807a8831cd1ca2474c57ea1cd0467b2611938d78a1cfdf948a49b5f7e6
1491,3LR4K3W8GBWR3wXiMpvt6o9MXbnGZgLYBG,1117,522500,522500,1672165282,1671752684,0,inbound,cb0e5b807a8831cd1ca2474c57ea1cd0467b2611938d78a1cfdf948a49b5f7e6
1492,3AMH8wAgVAYgJjL2zPv8ReTUTDCt4TGhmK,1118,36792043,36792043,1680992750,1670346622,0,outbound,cb0e5b807a8831cd1ca2474c57ea1cd0467b2611938d78a1cfdf948a49b5f7e6
1493,38oXPVDbxdJSw8NJF8LhdPXyu8K3XiSQdi,1119,6471759,6328006,1681048803,1672519230,143753,inbound,cb0e5b807a8831cd1ca2474c57ea1cd0467b2611938d78a1cfdf948a49b5f7e6
1494,35zzKitKDqVHFq4REesxJ8kPSh2K317kjV,1120,301195329,299823726,1680757844,1673880133,1371603,inbound,cb0e5b807a8831cd1ca2474c57ea1cd0467b2611938d78a1cfdf948a49b5f7e6
1495,33a6Sc6HEy8oejvVcqRfX2zUTHFTwfnsyz,1121,826313,826313,1671782853,1671752684,0,inbound,cb0e5b807a8831cd1ca2474c57ea1cd0467b2611938d78a1cfdf948a49b5f7e6
1496,3PuCpeDWEmeW97j2nuEE62mfkLQsgaj64w,1122,148609,148609,1671771705,1671752684,0,inbound,cb0e5b807a8831cd1ca2474c57ea1cd0467b2611938d78a1cfdf948a49b5f7e6
1497,bc1qyp2g56x0gfqw59s240qh69tfg7fpvrkjn3zjz6,1376,179655,179655,1671256836,1671240543,0,inbound,cb0e5b807a8831cd1ca2474c57ea1cd0467b2611938d78a1cfdf948a49b5f7e6
1498,3HBKdUsMDfEimcKHkvL38RCxh9GYHegoWU,1377,162508,162508,1671253294,1671240543,0,inbound,cb0e5b807a8831cd1ca2474c57ea1cd0467b2611938d78a1cfdf948a49b5f7e6
1499,3921vhAHwEMbC9QLN7MbX29sM63ND2QPrR,1378,10806063,10806063,1678914978,1670392296,0,inbound,cb0e5b807a8831cd1ca2474c57ea1cd0467b2611938d78a1cfdf948a49b5f7e6
1500,3BysPwdC5fhbTvkMWaX84FBRi5S4y3u8kL,1379,163260,163260,1672162031,1671240543,0,inbound,cb0e5b807a8831cd1ca2474c57ea1cd0467b2611938d78a1cfdf948a49b5f7e6
1501,bc1qkzk35l6mz2xr4uefxluq695elyzyjk2d3mvcme,1380,67881543,67881543,1680452207,1676489494,0,inbound,cb0e5b807a8831cd1ca2474c57ea1cd0467b2611938d78a1cfdf948a49b5f7e6
1502,1BKFThypSxp8d5aG5WWyzQkNokusdtwuV1,1381,143027607,143027607,1680595512,1674423137,0,inbound,cb0e5b807a8831cd1ca2474c57ea1cd0467b2611938d78a1cfdf948a49b5f7e6
1503,1Bmc7G16tz5FecREgkgrC9P7pgKePBqCak,1382,864926,864926,1671253334,1671240544,0,inbound,cb0e5b807a8831cd1ca2474c57ea1cd0467b2611938d78a1cfdf948a49b5f7e6
1504,bc1qk70td5ym905s7dlfm7yxv366w8ntd2qs7wjv27,1383,106914084,106914084,1679063964,1662711819,0,inbound,cb0e5b807a8831cd1ca2474c57ea1cd0467b2611938d78a1cfdf948a49b5f7e6
1505,bc1quqnef22sygte40zk8537ye9fh27mf7skt9aeg342hw6t2kjeyaaq9h5fk6,1384,314766,314766,1671463105,1671240543,0,inbound,cb0e5b807a8831cd1ca2474c57ea1cd0467b2611938d78a1cfdf948a49b5f7e6
1506,39Yu4E2qQQpzL9kZftvQj62UaDNcPKtNXh,1385,71278,71278,1671253294,1671240543,0,inbound,cb0e5b807a8831cd1ca2474c57ea1cd0467b2611938d78a1cfdf948a49b5f7e6
1507,1JZEytcrUFRBTPWFkyxhtBzEAo9uV5jeBJ,1386,55947,55947,1677481463,1671240543,0,inbound,cb0e5b807a8831cd1ca2474c57ea1cd0467b2611938d78a1cfdf948a49b5f7e6
1508,3Gzaots15vNynWnRbByi18FwtEG8ojyy1s,1387,838110,838110,1671241579,1671240543,0,inbound,cb0e5b807a8831cd1ca2474c57ea1cd0467b2611938d78a1cfdf948a49b5f7e6
1509,36mRqg7y9P5V5ChsFz2Y8KhDBgNT3s97MQ,1388,311590,311590,1671299340,1671240543,0,inbound,cb0e5b807a8831cd1ca2474c57ea1cd0467b2611938d78a1cfdf948a49b5f7e6
1510,3JA3XrqEHCkDgrzjk1UG4VMz3LrqaCQHrs,1389,22781168,22287296,1680766319,1677053575,493872,inbound,cb0e5b807a8831cd1ca2474c57ea1cd0467b2611938d78a1cfdf948a49b5f7e6
1511,bc1q9k4qpn6nd8ml47j7nscahs696lpue0kd8f0pw5,1390,285536,285536,1671261302,1671240543,0,inbound,cb0e5b807a8831cd1ca2474c57ea1cd0467b2611938d78a1cfdf948a49b5f7e6
1512,bc1qrq2vfdslf0pjh20hz9pz6jztg5sea3xp7z0749,1391,445690,445690,1671557349,1671240543,0,inbound,cb0e5b807a8831cd1ca2474c57ea1cd0467b2611938d78a1cfdf948a49b5f7e6
1513,3PdrTqFraf3ZHtYm3Zbdd9scdGV5dDyGZa,1392,107783,0,1671240543,1671240543,107783,inbound,cb0e5b807a8831cd1ca2474c57ea1cd0467b2611938d78a1cfdf948a49b5f7e6
1514,3EFXBD2UDFu1rVTarqW1fSmymDCyzzrtv7,1393,186053467,185874749,1679807324,1663092384,178718,outbound,cb0e5b807a8831cd1ca2474c57ea1cd0467b2611938d78a1cfdf948a49b5f7e6
1515,bc1qlvgduhpk68fvzdhgmqvtx6hg82qg7eqf2hvqg5,1394,101838,101838,1671243033,1671240544,0,inbound,cb0e5b807a8831cd1ca2474c57ea1cd0467b2611938d78a1cfdf948a49b5f7e6
1516,35dFpxp7hhfq1k1GBcKJmRnpccmppDHJwb,1395,2410781,2410781,1671512554,1671240543,0,inbound,cb0e5b807a8831cd1ca2474c57ea1cd0467b2611938d78a1cfdf948a49b5f7e6
1517,3KDVUvN24pFG6m4KmjQniEGmvmV5JQRdzm,1396,41336814,41336814,1678885282,1645214445,0,inbound,cb0e5b807a8831cd1ca2474c57ea1cd0467b2611938d78a1cfdf948a49b5f7e6
1518,37GPk8RjrGCdiVaK3ecP3o47HRVmXPsFrp,1397,28163629,27879168,1680363578,1658549692,284461,outbound,cb0e5b807a8831cd1ca2474c57ea1cd0467b2611938d78a1cfdf948a49b5f7e6
1519,3Au9PLug7Vh7F9CiPfYSDUD4RTXewSn8k2,1398,6715054,6715054,1674070362,1671149651,0,inbound,cb0e5b807a8831cd1ca2474c57ea1cd0467b2611938d78a1cfdf948a49b5f7e6
1520,12FHCyGC4SVy8fH4CJkY1hRczafLXNf4Jx,1399,346621108,346621108,1681139189,1678383513,0,inbound,cb0e5b807a8831cd1ca2474c57ea1cd0467b2611938d78a1cfdf948a49b5f7e6
1521,3Hs8tEiVBT6PeBXKjGttwBszJqV3x9iryX,1400,76363209,76363209,1680239501,1673179332,0,outbound,cb0e5b807a8831cd1ca2474c57ea1cd0467b2611938d78a1cfdf948a49b5f7e6
1522,34VTW7YPYh4Q39qL6gaYvDiQizySve5DxZ,1401,221183,221183,1671242444,1671240543,0,inbound,cb0e5b807a8831cd1ca2474c57ea1cd0467b2611938d78a1cfdf948a49b5f7e6
1523,3KmdCC8H7PWAggYeeBk8qTPb5BnmVjGcDi,1402,39124102410,39079622493,1681140105,1681027929,44479917,inbound,cb0e5b807a8831cd1ca2474c57ea1cd0467b2611938d78a1cfdf948a49b5f7e6
1524,1JC1FRAHY68fzaAYjZ5tUbxSDmRjVFKDEi,1403,107786,107786,1674046333,1671240543,0,inbound,cb0e5b807a8831cd1ca2474c57ea1cd0467b2611938d78a1cfdf948a49b5f7e6
1525,39L3TcRpgeLYmqujYMVCXEuuvvhbsuTS5w,1404,33252228,31315388,1681115173,1678144541,1936840,inbound,cb0e5b807a8831cd1ca2474c57ea1cd0467b2611938d78a1cfdf948a49b5f7e6
1526,3JNvCh8UtFmXE6KMh5JXfpLAbES7dthSfq,1405,221191,221191,1671310738,1671240543,0,inbound,cb0e5b807a8831cd1ca2474c57ea1cd0467b2611938d78a1cfdf948a49b5f7e6
1527,3QePYJWGZAtTdc7vfEPohp1fdwb1GCBaMY,1406,149642,149642,1671597983,1671240543,0,inbound,cb0e5b807a8831cd1ca2474c57ea1cd0467b2611938d78a1cfdf948a49b5f7e6
1528,1KQ7tLbKgiASHu9qXqky2d7JJTEA4Tn75P,1407,478657,478657,1671263840,1671240543,0,inbound,cb0e5b807a8831cd1ca2474c57ea1cd0467b2611938d78a1cfdf948a49b5f7e6
1529,344FtnHTVZa95emNm5d7yGPvJbTS494ruZ,1408,1161810,1161810,1671253304,1671240543,0,inbound,cb0e5b807a8831cd1ca2474c57ea1cd0467b2611938d78a1cfdf948a49b5f7e6
1530,3ACGLJoxYEAEmkfUgyoibe7Q9AkfoAKcQP,1409,104118,0,1671240544,1671240544,104118,inbound,cb0e5b807a8831cd1ca2474c57ea1cd0467b2611938d78a1cfdf948a49b5f7e6
1531,1Hz7gHY5gA13eax8EzX1Bb7npxRWVXkYJ1,1410,179621,179621,1672162395,1671240543,0,inbound,cb0e5b807a8831cd1ca2474c57ea1cd0467b2611938d78a1cfdf948a49b5f7e6
1532,3BGSNL9f73vwPUBFRaKM2366jZD9SvxXMv,1411,113744,113744,1671251425,1671240543,0,inbound,cb0e5b807a8831cd1ca2474c57ea1cd0467b2611938d78a1cfdf948a49b5f7e6
1533,14rdsvEUzoJ1E3fdp5MWdvyweaKfp2e1t3,1412,9637168,7198504,1675890434,1652041310,2438664,inbound,cb0e5b807a8831cd1ca2474c57ea1cd0467b2611938d78a1cfdf948a49b5f7e6
1534,3QicAzXsLzVUWiBz9XEWmc9Exf49cNsW2z,1413,133406,133406,1671260448,1671240543,0,inbound,cb0e5b807a8831cd1ca2474c57ea1cd0467b2611938d78a1cfdf948a49b5f7e6
1535,bc1qyc2xg66dqpvlzcz6dj3lk9fxhlycvtu6t4m24q,1414,299393,299393,1671294529,1671240543,0,inbound,cb0e5b807a8831cd1ca2474c57ea1cd0467b2611938d78a1cfdf948a49b5f7e6
1536,1FaREBFZkr3bdJZ1mTxnoaCLkyurY9Qtg7,1415,497820948,497820948,1679285299,1676128023,0,inbound,cb0e5b807a8831cd1ca2474c57ea1cd0467b2611938d78a1cfdf948a49b5f7e6
1537,14hYS48B2PqpM1ifBsWE6QQYtXf684rV3n,1416,299492,0,1671240543,1671240543,299492,inbound,cb0e5b807a8831cd1ca2474c57ea1cd0467b2611938d78a1cfdf948a49b5f7e6
1538,37WmjfSe7WrpnnpaEAfQmJsGZoDDGFse9i,1417,119752,119752,1672162022,1671240543,0,inbound,cb0e5b807a8831cd1ca2474c57ea1cd0467b2611938d78a1cfdf948a49b5f7e6
1539,3Q6qtDKcptL7baphfJ7kXg9dmDaYYLhS5q,1418,104130,104130,1671260448,1671240543,0,inbound,cb0e5b807a8831cd1ca2474c57ea1cd0467b2611938d78a1cfdf948a49b5f7e6
1540,32RSk5eaB1oQM79L6Tr4jAGXr7hn2jRamx,1419,20027721,20027721,1674864118,1670314295,0,inbound,cb0e5b807a8831cd1ca2474c57ea1cd0467b2611938d78a1cfdf948a49b5f7e6
1541,1PUGgLeurVwzzedEPXEENaDuRMYc771JtF,1420,2092106230,2088295645,1681144563,1680228121,3810585,outbound,cb0e5b807a8831cd1ca2474c57ea1cd0467b2611938d78a1cfdf948a49b5f7e6
1542,1FPJWDehD29uVFW7qv5BVmDu1Kme2fYebp,1421,299399,299399,1671240778,1671240543,0,inbound,cb0e5b807a8831cd1ca2474c57ea1cd0467b2611938d78a1cfdf948a49b5f7e6
1543,3EYw65t9R7h2i6za1gMnC8Y16buXmtinbn,1422,60217,60217,1671256851,1671240543,0,inbound,cb0e5b807a8831cd1ca2474c57ea1cd0467b2611938d78a1cfdf948a49b5f7e6
1544,3Ja3RP1wFSqkgo92SACe15SmFWACLaTFmH,1423,49763279,49763279,1680861946,1673960039,0,inbound,cb0e5b807a8831cd1ca2474c57ea1cd0467b2611938d78a1cfdf948a49b5f7e6
1545,3KYzsxLZfbdY8Zu8WXmrdTndJLucdBiz36,1424,113689290,113689290,1677040625,1668432697,0,inbound,cb0e5b807a8831cd1ca2474c57ea1cd0467b2611938d78a1cfdf948a49b5f7e6
1546,3JJSeY8oT7EmqrcGsYy3MLfbYeGvGbZN7E,1123,326335116,322011675,1680797252,1661018411,4323441,inbound,4f685781dfc711b7104b2d83c780905995db2be5d12359e32d681256651b422a
1547,35zAi4Rbprza9DUZ9uo9qKU5hfPp2qxjDi,1425,74848,74848,1671278493,1671240543,0,inbound,4f685781dfc711b7104b2d83c780905995db2be5d12359e32d681256651b422a
1548,1Ei6HcG92BufRLyDHhKDAaJS4DdY4EXS1J,1124,103489,103489,1671804824,1671752684,0,inbound,316fb96f4f81adc32c089e4c79f83f28b16231738db08ad39374a8d05e3fa552
1549,38MjQhuSbtPStkLH5nM3gGzaTR26g4ghCD,1426,65584234,65584234,1678797567,1668420049,0,outbound,316fb96f4f81adc32c089e4c79f83f28b16231738db08ad39374a8d05e3fa552
1550,bc1qk9d0p3hr0527twvr23t8jsnvun548htfz0n8u2,1125,154596,154596,1671775239,1671752684,0,inbound,d6111b826e2fcebde14333370e1da3b3e8d44dca81ddd2d86d0136ecd223d328
1551,1MAZYTbz6jdnGVF2t5jBAx6ag8MnwbMKuN,1126,2016688290,2016158353,1681115256,1679498893,529937,inbound,d6111b826e2fcebde14333370e1da3b3e8d44dca81ddd2d86d0136ecd223d328
1552,bc1qqflkx060fzr7yexw4nhdfq9tyqj5r7qqvcfknl,1127,77279,77279,1671974802,1671752684,0,inbound,d6111b826e2fcebde14333370e1da3b3e8d44dca81ddd2d86d0136ecd223d328
1553,1AfhLKDLxAjvimzx57QyCz164LrS8kJZpA,1128,133006,133006,1672337532,1671752684,0,inbound,d6111b826e2fcebde14333370e1da3b3e8d44dca81ddd2d86d0136ecd223d328
1554,3C8MPKRoAjfBpVAQkjA1fhYxdkgakCtEDU,1129,452235,452235,1671783591,1671752684,0,inbound,d6111b826e2fcebde14333370e1da3b3e8d44dca81ddd2d86d0136ecd223d328
1555,1HhrKyfEJVC3mw3X2hgXvSLKsJya8PgVpz,1130,402884,402884,1671773049,1671752684,0,inbound,d6111b826e2fcebde14333370e1da3b3e8d44dca81ddd2d86d0136ecd223d328
1556,bc1qnxetfe0wr9aelgcghunkdjh0rx03uf9ya4vde8rr70qpsnr2hdvqagq3e9,1131,564686,564686,1671840580,1671752684,0,inbound,d6111b826e2fcebde14333370e1da3b3e8d44dca81ddd2d86d0136ecd223d328
1557,bc1qfrvg2egy22vjed7aja2upndg0l5p7ez6qwpuux,1132,2992630,2992630,1672375279,1671721928,0,inbound,d6111b826e2fcebde14333370e1da3b3e8d44dca81ddd2d86d0136ecd223d328
1558,3HvVV6FyY9D6vh6JqrEXX6LTC6BcQHjuvz,1133,4405769,4405769,1680017357,1651945774,0,inbound,d6111b826e2fcebde14333370e1da3b3e8d44dca81ddd2d86d0136ecd223d328
1559,bc1qcld8mjnevnjjcc4t43y7he8whlz3mxkdncqqch,1134,462512,462512,1676369199,1666937045,0,inbound,d6111b826e2fcebde14333370e1da3b3e8d44dca81ddd2d86d0136ecd223d328
1560,bc1qswahjjcuct223qavz0dlncpsarc9zett50rvud,1135,1843380,1843380,1672256011,1671752684,0,inbound,d6111b826e2fcebde14333370e1da3b3e8d44dca81ddd2d86d0136ecd223d328
1561,bc1qms869d6uezwq9792u6w9r4hq02ezg6qhjkfras,1136,277827,277827,1671755130,1671752684,0,inbound,d6111b826e2fcebde14333370e1da3b3e8d44dca81ddd2d86d0136ecd223d328
1562,bc1qj20ve7456wnshskzr28a3ppzgxmgrqxk7qgwx2ljtt0xka32lraq423ap4,1137,555708,555708,1671757730,1671752684,0,inbound,d6111b826e2fcebde14333370e1da3b3e8d44dca81ddd2d86d0136ecd223d328
1563,3NLtrSTVEkVwp7Ndzp5yt3zAW7mzssHdc5,1138,394113,394113,1671775432,1671752684,0,inbound,d6111b826e2fcebde14333370e1da3b3e8d44dca81ddd2d86d0136ecd223d328
1564,bc1q0mj9q2fvwq8vu5x8crulx9fpugz5xj4vsmwf9f,1139,85836089,85836089,1675105759,1666140643,0,outbound,d6111b826e2fcebde14333370e1da3b3e8d44dca81ddd2d86d0136ecd223d328
1565,19AxiqDkUhwRDF9FytTvC4L9PeB97M3q4Z,1140,568518,568518,1671807312,1671752684,0,inbound,d6111b826e2fcebde14333370e1da3b3e8d44dca81ddd2d86d0136ecd223d328
1566,3MLohxaJjRmPEEoAHnw4SFo9U88KErMPys,1141,225515,225515,1672281026,1671752684,0,inbound,d6111b826e2fcebde14333370e1da3b3e8d44dca81ddd2d86d0136ecd223d328
1567,39TW6uRMs7gfJvDGftS6BG4JT8nPH7AH76,1142,277872,277872,1671775432,1671752684,0,inbound,d6111b826e2fcebde14333370e1da3b3e8d44dca81ddd2d86d0136ecd223d328
1568,3EzhuRL3n1GTpw8Mj1Jk9C1ts9QSxq1SzX,1143,21146966,20813789,1680427130,1663981503,333177,outbound,d6111b826e2fcebde14333370e1da3b3e8d44dca81ddd2d86d0136ecd223d328
1569,bc1qm96hqwvg50uvqhgz2rvpk4u37n3pl263q028q9,1144,7799284,7799284,1671866971,1671662230,0,inbound,d6111b826e2fcebde14333370e1da3b3e8d44dca81ddd2d86d0136ecd223d328
1570,3Mbmc3ngGuN4oYiPBue4r4oG2nGbYi9iJV,1145,338827,338827,1671788242,1671752684,0,inbound,d6111b826e2fcebde14333370e1da3b3e8d44dca81ddd2d86d0136ecd223d328
1571,1BDtNC9f3iuzk6StrENTw2NR5UrFt9V7SX,1146,595996,595996,1671772871,1671752684,0,inbound,d6111b826e2fcebde14333370e1da3b3e8d44dca81ddd2d86d0136ecd223d328
1572,3NBvBHfB8djAnKJkwj96NHLBF4aimfnuq6,1147,1968314,1968314,1672057749,1671752684,0,inbound,d6111b826e2fcebde14333370e1da3b3e8d44dca81ddd2d86d0136ecd223d328
1573,bc1q2mu0kae4ga48znlwlda20jqd4jrwmztev4n6cw,1148,17883172,17883172,1680444720,1670364620,0,inbound,d6111b826e2fcebde14333370e1da3b3e8d44dca81ddd2d86d0136ecd223d328
1574,17VgfRu3zTwApQ11uA5p8JQ3qzkyRQURrB,1149,325969341,325969341,1680501872,1675253062,0,outbound,d6111b826e2fcebde14333370e1da3b3e8d44dca81ddd2d86d0136ecd223d328
1575,bc1qqqrswdvcteg3vn3ak5nllvf2cx9fezvxcwp36w,1150,4771445,4771445,1671876442,1671751255,0,inbound,d6111b826e2fcebde14333370e1da3b3e8d44dca81ddd2d86d0136ecd223d328
1576,1KSAiNkhEJhPckNu9fC1CFPeMfVAakdgFC,1151,4470205,4470205,1671773538,1671752684,0,inbound,d6111b826e2fcebde14333370e1da3b3e8d44dca81ddd2d86d0136ecd223d328
1577,1KSibrwxP4SqjbCBYuG6x4ooSYcGrnm5wa,1152,411570,411570,1671846016,1671752684,0,inbound,d6111b826e2fcebde14333370e1da3b3e8d44dca81ddd2d86d0136ecd223d328
1578,bc1q5c4x7qg8hkq27x4v7dwht3nwcypwpmt2546lnr,1153,182967771,182967771,1675370869,1673275862,0,inbound,d6111b826e2fcebde14333370e1da3b3e8d44dca81ddd2d86d0136ecd223d328
1579,3EtPongJcHLoqo3biDyJmj5zNBNc6c1FnS,1154,41616,41616,1671775429,1671752684,0,inbound,d6111b826e2fcebde14333370e1da3b3e8d44dca81ddd2d86d0136ecd223d328
1580,16ULNPhhv8Vj2ZHfQx9vfZRoMFMNPPxYDa,1155,593142,593142,1671793933,1671752684,0,inbound,d6111b826e2fcebde14333370e1da3b3e8d44dca81ddd2d86d0136ecd223d328
1581,1E7xQEHRQUXtSVGnCMRtiBABJxoBwj6qhQ,1156,277887,277887,1672285309,1671752684,0,inbound,d6111b826e2fcebde14333370e1da3b3e8d44dca81ddd2d86d0136ecd223d328
1582,bc1qc0h9xc34gh4ea98y9qkunv582648yzskkd5czy,1157,46637868,46637868,1679586086,1674935976,0,inbound,d6111b826e2fcebde14333370e1da3b3e8d44dca81ddd2d86d0136ecd223d328
1583,bc1qv025cdd23hmpv460p3005pnlefl4kh86mjrlgc,1158,265465253,265465253,1671753760,1671752684,0,inbound,d6111b826e2fcebde14333370e1da3b3e8d44dca81ddd2d86d0136ecd223d328
1584,1Q29xrdEmHzsaTKEE74xosYDt3vuF5rzDk,1159,279991,279991,1672237993,1671752684,0,inbound,d6111b826e2fcebde14333370e1da3b3e8d44dca81ddd2d86d0136ecd223d328
1585,bc1q8afh2p4xeg4nvjy5tqfanpsvu0te3qzxpc8mmd,1160,2484933584,2477605040,1681142386,1681077013,7328544,inbound,d6111b826e2fcebde14333370e1da3b3e8d44dca81ddd2d86d0136ecd223d328
1586,bc1quedpzfmvzd0vf9dfjsfny9d2sj795w4s2qr45u,1161,575626,575626,1671755087,1671752684,0,inbound,d6111b826e2fcebde14333370e1da3b3e8d44dca81ddd2d86d0136ecd223d328
1587,38Gg4Dt7ZeYB3iGjyGRQTWXoazQXCfaHQS,1162,1189100,1189100,1671775432,1671752684,0,inbound,d6111b826e2fcebde14333370e1da3b3e8d44dca81ddd2d86d0136ecd223d328
1588,1Cujt7m8EZacP77JP4ATdYE2n5Xzf3jPcN,1163,208034,208034,1671758774,1671752684,0,inbound,d6111b826e2fcebde14333370e1da3b3e8d44dca81ddd2d86d0136ecd223d328
1589,3Ez1wDsPm9FuyoxfJsj9LDurD83ezqgTMn,1164,585644,585644,1671782855,1671752684,0,inbound,d6111b826e2fcebde14333370e1da3b3e8d44dca81ddd2d86d0136ecd223d328
1590,bc1qg297c3r4f0rz9a6pyddwkap83lzk9t78c88nhy,1165,56453940,56139622,1680046552,1662426013,314318,inbound,d6111b826e2fcebde14333370e1da3b3e8d44dca81ddd2d86d0136ecd223d328
1591,1PJqUCqJE3V4XvL9anpPsPtCC3Bju49imy,1427,2128541052,2128541052,1680323251,1669652476,0,outbound,d6111b826e2fcebde14333370e1da3b3e8d44dca81ddd2d86d0136ecd223d328
1592,3KjeCZGsQJn7eTnN53ruM2i7GU89UtZWEW,1428,296682050,293094987,1680202387,1658790296,3587063,inbound,d6111b826e2fcebde14333370e1da3b3e8d44dca81ddd2d86d0136ecd223d328
1593,bc1qd45lqw92tr8k0umdtem8sfqz7gu7yfzuuszxc3,1429,597207,597207,1671315360,1671240543,0,inbound,d6111b826e2fcebde14333370e1da3b3e8d44dca81ddd2d86d0136ecd223d328
1594,3MyYiXaPCQrKQq1d9tLPgxHR7V8Aqnnjwt,1430,105069,105069,1671260448,1671240543,0,inbound,d6111b826e2fcebde14333370e1da3b3e8d44dca81ddd2d86d0136ecd223d328
1595,34qLtzZnQKzqmkkaw8FN9ZBuRN52rbxQuA,1431,572571,572571,1671428559,1671240543,0,inbound,d6111b826e2fcebde14333370e1da3b3e8d44dca81ddd2d86d0136ecd223d328
1596,13A2VEYkeZy2WGtJE1Qn6G9wBHpm3ZXzUD,1432,113768,113768,1672783152,1671240543,0,inbound,d6111b826e2fcebde14333370e1da3b3e8d44dca81ddd2d86d0136ecd223d328
1597,1QEqWs6GPEWormtRLUHEJSt9r4cpL1fqVp,1433,628919,628919,1671249646,1671240543,0,inbound,d6111b826e2fcebde14333370e1da3b3e8d44dca81ddd2d86d0136ecd223d328
1598,1PkisPmNuUvbuQavfcx59k7Cg7Lu5Aoxq5,1434,188324530,188324530,1678514507,1673481738,0,outbound,d6111b826e2fcebde14333370e1da3b3e8d44dca81ddd2d86d0136ecd223d328
1599,32EZwQmYXecc5JdHctqb1PqJfyumnrzFhh,1435,13302465,13302465,1671328956,1667340354,0,inbound,d6111b826e2fcebde14333370e1da3b3e8d44dca81ddd2d86d0136ecd223d328
1600,3E493Pv3hFGn1Rvxg7n5Sgz5FUDifYJi7a,1436,106288,106288,1671260454,1671240543,0,inbound,d6111b826e2fcebde14333370e1da3b3e8d44dca81ddd2d86d0136ecd223d328
1601,3HfhtUENUKD7aLw8q77Tf4vkhzt1epXFXB,1437,10041058,10041058,1674005912,1660365541,0,outbound,d6111b826e2fcebde14333370e1da3b3e8d44dca81ddd2d86d0136ecd223d328
1602,bc1q3zjspyztmtkqsv3ecnv0smq5uf006nxudnchhy,1438,134579,134579,1677484456,1671240543,0,inbound,d6111b826e2fcebde14333370e1da3b3e8d44dca81ddd2d86d0136ecd223d328
1603,bc1qrhxu304wtvx3tz0za9yezpmswu0dw82cnlfy5tmdd27xtw3de0sqzcle8q,1439,45636,45636,1671597983,1671240543,0,inbound,d6111b826e2fcebde14333370e1da3b3e8d44dca81ddd2d86d0136ecd223d328
1604,3QnnRyE7dxZcALq7KUqiPkVsCaQPzrmYqD,1440,822507469,822507469,1681055358,1676224418,0,inbound,d6111b826e2fcebde14333370e1da3b3e8d44dca81ddd2d86d0136ecd223d328
1605,15mbrKAVqU7QPFSqzPXKk44Po5Y1xkrjoC,1441,340887,340887,1671243676,1671240544,0,inbound,d6111b826e2fcebde14333370e1da3b3e8d44dca81ddd2d86d0136ecd223d328
1606,36mekpT9CDnxjZSTdZzseh3ky4vxYM6nVX,1442,104116,104116,1671260448,1671240543,0,inbound,d6111b826e2fcebde14333370e1da3b3e8d44dca81ddd2d86d0136ecd223d328
1607,3H5WVTowh989HaWjpsXJjgKfjUmJqcaLaA,1443,191331571,191331571,1673157974,1663267655,0,inbound,d6111b826e2fcebde14333370e1da3b3e8d44dca81ddd2d86d0136ecd223d328
1608,bc1qf9hzhjuu7tn7vafeql66dgerph3079tug2tv2s,1444,75751,75751,1671999338,1671240543,0,inbound,d6111b826e2fcebde14333370e1da3b3e8d44dca81ddd2d86d0136ecd223d328
1609,3JwfHkgRygcwqKetwMvAk4hVX7yk59aQm6,1445,23553061,23553061,1672807023,1670665179,0,inbound,d6111b826e2fcebde14333370e1da3b3e8d44dca81ddd2d86d0136ecd223d328
1610,bc1q9cdq0y2fqxdug7avzer60njr7auwr86kvlual3,1446,1993196844,1852087291,1680089667,1671280790,141109553,outbound,d6111b826e2fcebde14333370e1da3b3e8d44dca81ddd2d86d0136ecd223d328
1611,3DQo8Z1jm92b3EkXVooqPASXgjeBi6GYLw,1447,48550832,47184832,1680485308,1671209224,1366000,inbound,d6111b826e2fcebde14333370e1da3b3e8d44dca81ddd2d86d0136ecd223d328
1612,bc1q369pkzn9qhcglqpqf4m6r8vd2hvtxrc8eu9pfc,1448,187654,187654,1671265588,1669248364,0,inbound,d6111b826e2fcebde14333370e1da3b3e8d44dca81ddd2d86d0136ecd223d328
1613,bc1qe06hpj9ut2szc2fzyt34fpcxam8u8mpz0ppx4p,1449,549429337,549429337,1674647222,1670723454,0,inbound,d6111b826e2fcebde14333370e1da3b3e8d44dca81ddd2d86d0136ecd223d328
1614,3Jd5USmnjrhmoanoiPcBq48KuZc42fr1Ug,1450,20877714,19291229,1681008405,1670093336,1586485,inbound,d6111b826e2fcebde14333370e1da3b3e8d44dca81ddd2d86d0136ecd223d328
1615,bc1q08jm5rr04nrcjucp0nem5u06m2mhrd3cntl9gq,1451,20783287,20783287,1672519379,1668944002,0,inbound,d6111b826e2fcebde14333370e1da3b3e8d44dca81ddd2d86d0136ecd223d328
1616,32mUudcJKbqgqRupLasVhpDGvtw7o2vnmb,1452,31141632,29633414,1681115159,1678400462,1508218,inbound,d6111b826e2fcebde14333370e1da3b3e8d44dca81ddd2d86d0136ecd223d328
1617,bc1qkur2mgnst8ewspdxpc6exmk4r0dfetsad64kj5,1453,65800,65800,1671240637,1671240543,0,inbound,d6111b826e2fcebde14333370e1da3b3e8d44dca81ddd2d86d0136ecd223d328
1618,1MjSXXQ1837Mqpo1na2UZG8j2EVBeuCuaf,1454,59865,0,1671240543,1671240543,59865,inbound,d6111b826e2fcebde14333370e1da3b3e8d44dca81ddd2d86d0136ecd223d328
1619,34zW7EztPUTTD4aQnmNndJrYQZWeUKZSWs,1455,98258,98258,1671597983,1671240543,0,inbound,d6111b826e2fcebde14333370e1da3b3e8d44dca81ddd2d86d0136ecd223d328
1620,359yyZQtvdbVs8ADyZ4GyZeBWo1ux8R7XA,1456,45351002,44077729,1680239529,1676270083,1273273,outbound,d6111b826e2fcebde14333370e1da3b3e8d44dca81ddd2d86d0136ecd223d328
1621,bc1qll4h7slkfpcqg74jre3yu3345ksl6muf700egj,1457,338195,338195,1671311462,1671240543,0,inbound,d6111b826e2fcebde14333370e1da3b3e8d44dca81ddd2d86d0136ecd223d328
1622,3Ph7iZvZfxsUj9F87sRFwq2vumWuPD7qyy,1458,104122,104122,1671253294,1671240543,0,inbound,d6111b826e2fcebde14333370e1da3b3e8d44dca81ddd2d86d0136ecd223d328
1623,3Di6FKR8LhAYDBiY3uVVj7DD1PtMz8yqqj,1459,45639,45639,1671256851,1671240543,0,inbound,d6111b826e2fcebde14333370e1da3b3e8d44dca81ddd2d86d0136ecd223d328
1624,1N7hToJeRDabzAmgSPAcKyeXUQsezJqVLa,1460,2215481,2215481,1671582702,1671240543,0,inbound,d6111b826e2fcebde14333370e1da3b3e8d44dca81ddd2d86d0136ecd223d328
1625,bc1q0cauf672k709t9wvjp6kvuy9nntvq0xsg87ffs,1461,592599,592599,1671310299,1671240543,0,inbound,d6111b826e2fcebde14333370e1da3b3e8d44dca81ddd2d86d0136ecd223d328
1626,bc1qttuvhlgn07hnasllcpvyhp7tfyrsphd56clk86a04a68fsfxaxnq24mj8k,1462,104110,104110,1671243346,1671240543,0,inbound,d6111b826e2fcebde14333370e1da3b3e8d44dca81ddd2d86d0136ecd223d328
1627,3M4oGzxuJRY2HqTzLYB22PYENtZN3bwLPi,1463,600158,600158,1671597983,1671240543,0,inbound,d6111b826e2fcebde14333370e1da3b3e8d44dca81ddd2d86d0136ecd223d328
1628,32jNTtTP35abmzoNC4X9PCxDnVarnUQgff,1464,3632467,3632467,1680427129,1669825553,0,inbound,d6111b826e2fcebde14333370e1da3b3e8d44dca81ddd2d86d0136ecd223d328
1629,19eHYKGcTEEAYabtLZne49Sf5tNegjdUYb,1465,714666,714666,1671259333,1671240543,0,inbound,d6111b826e2fcebde14333370e1da3b3e8d44dca81ddd2d86d0136ecd223d328
1630,33KvyFu6pWSRc36TN85CczBWx27aRdCPEY,1466,107831,107831,1671260448,1671240543,0,inbound,d6111b826e2fcebde14333370e1da3b3e8d44dca81ddd2d86d0136ecd223d328
1631,1B4FRoppbLWeJvUov11tgYKCApgeKw1KiB,1467,2457969,2457969,1671260987,1661559132,0,inbound,d6111b826e2fcebde14333370e1da3b3e8d44dca81ddd2d86d0136ecd223d328
1632,bc1qrk7p2ewe6v8swvclnugj84py6t6ed2hkwxw68x52a8085h948skqyqwggd,1468,1222389,1222389,1671463105,1671240543,0,inbound,d6111b826e2fcebde14333370e1da3b3e8d44dca81ddd2d86d0136ecd223d328
1633,3HfjgtJtxGczZkazPX9swkqtovZffMjsYU,1469,113446179,113394167,1680677608,1678009665,52012,outbound,d6111b826e2fcebde14333370e1da3b3e8d44dca81ddd2d86d0136ecd223d328
1634,bc1qkr9e3c3q6lw2fpxej7gklv6v865c34k84r4e0m,1470,179167078,179167078,1671240585,1671240543,0,inbound,d6111b826e2fcebde14333370e1da3b3e8d44dca81ddd2d86d0136ecd223d328
1635,33aEBcmP1hqJv12K4VRK8xtwDGLb6CaURN,1471,133374,133374,1671260448,1671240543,0,inbound,d6111b826e2fcebde14333370e1da3b3e8d44dca81ddd2d86d0136ecd223d328
1636,bc1q4tydd74ccwv02l3hrtmjt3mc2d5vj0wu580mnz,1472,215314,215314,1671296183,1671240543,0,inbound,d6111b826e2fcebde14333370e1da3b3e8d44dca81ddd2d86d0136ecd223d328
1637,13jmR9ERy1rDtPDqoAL5oymATLtjbMJnhK,1473,193424302,193424302,1681006169,1672500550,0,inbound,d6111b826e2fcebde14333370e1da3b3e8d44dca81ddd2d86d0136ecd223d328
1638,3PBWQSTsnmwHXbno7AQHdkadaU9UAQshHc,1474,221173,221173,1671253291,1671240543,0,inbound,d6111b826e2fcebde14333370e1da3b3e8d44dca81ddd2d86d0136ecd223d328
1639,1L4fvDxa3er4AcugyH4Dwkp7KErmKsrey7,1475,1380732,1380732,1671220909,1634065642,0,inbound,d6111b826e2fcebde14333370e1da3b3e8d44dca81ddd2d86d0136ecd223d328
1640,1Jyx8muAzM66NHr7qqknpBhuns2nvqq6hr,1476,1814500000,1814500000,1671222485,1671212574,0,inbound,d6111b826e2fcebde14333370e1da3b3e8d44dca81ddd2d86d0136ecd223d328
1641,bc1qxfp9ppdj50pt2z62ut7r6s3fnugf0ztfyzmfg0,1477,768009852,644258305,1680334558,1657524726,123751547,inbound,d6111b826e2fcebde14333370e1da3b3e8d44dca81ddd2d86d0136ecd223d328
1642,bc1qe35hf7dxk9ffsff9vurqg5hh58mrs8j5s849cg,1478,51100000,999000,1672806164,1668780956,50101000,inbound,d6111b826e2fcebde14333370e1da3b3e8d44dca81ddd2d86d0136ecd223d328
1643,13jABAbcaJDf3oCwho3jFMPbnaF5AzzLQy,1479,3240849198,3240849198,1678524415,1450185496,0,inbound,d6111b826e2fcebde14333370e1da3b3e8d44dca81ddd2d86d0136ecd223d328
1644,34BCHcivJe8VxPZ8MSB83YQy3gd2Qe4oYj,1480,12054000,0,1671212574,1671212574,12054000,inbound,d6111b826e2fcebde14333370e1da3b3e8d44dca81ddd2d86d0136ecd223d328
1645,13pWqmXrbiC5U13AKMDrZw3xauMnPwBawD,1481,10733955757,10678587429,1681084811,1672414265,55368328,outbound,d6111b826e2fcebde14333370e1da3b3e8d44dca81ddd2d86d0136ecd223d328
1646,3BkNA9YDtGYkxPu6YMuMrzgZnk4SDjZoCK,1482,1370770000,1263987000,1673976242,1617200105,106783000,inbound,d6111b826e2fcebde14333370e1da3b3e8d44dca81ddd2d86d0136ecd223d328
1647,bc1q7ewc3z3k249j7zhrhn0whxdrgckw9mylxfnl34,1483,787000,787000,1671214524,1670955063,0,inbound,d6111b826e2fcebde14333370e1da3b3e8d44dca81ddd2d86d0136ecd223d328
1648,bc1qv9kdj9k6yur2835mf5xgm7ln0as4rz5thwyzyk,1484,142791948,142791948,1676552974,1657613505,0,inbound,d6111b826e2fcebde14333370e1da3b3e8d44dca81ddd2d86d0136ecd223d328
1649,3MUqUeto9oCtTaHY2288AHp3CtkDZeV7Wq,1485,254616826,254616826,1676484679,1665799691,0,inbound,d6111b826e2fcebde14333370e1da3b3e8d44dca81ddd2d86d0136ecd223d328
1650,33EwHe5SZvM5o9C4JADM4J9VnzBTBkSdaV,1486,380835,380835,1671223907,1671212573,0,inbound,d6111b826e2fcebde14333370e1da3b3e8d44dca81ddd2d86d0136ecd223d328
1651,bc1q7dw7qeq3v855qxanw9a6z6c8ew2dh9h550qnmh4fllucc993sx6qlqgajv,1487,221136647107,220928863745,1681132813,1680821713,207783362,outbound,d6111b826e2fcebde14333370e1da3b3e8d44dca81ddd2d86d0136ecd223d328
1652,bc1q7n037jg6kpwd2el5mt5dztet4uflnpvrla2p8a,1488,746000,0,1671212573,1671212573,746000,inbound,baad8bfb7356156fe529bc5a64f0fd6ea35091d8808a7a14963d7938ffe8f5e9
1653,bc1qcx4pe22v6e2lqzx8jv75m5lssak9x45d4mz5qa,1489,1271239261,1260286136,1680796110,1666301597,10953125,inbound,baad8bfb7356156fe529bc5a64f0fd6ea35091d8808a7a14963d7938ffe8f5e9
1654,bc1q0nd9kj3ysshlaav3jqgklsjegm9sed5lltsj86,1490,17377000,17377000,1680344290,1641567097,0,inbound,baad8bfb7356156fe529bc5a64f0fd6ea35091d8808a7a14963d7938ffe8f5e9
1655,bc1qa4j2z657sxwf952aamultaxd9cyp7qr4v9vkq4,1491,80998000,0,1674744618,1671212574,80998000,inbound,baad8bfb7356156fe529bc5a64f0fd6ea35091d8808a7a14963d7938ffe8f5e9
1656,185MiykmY1tN3BbUBZPpmwamKXVdqCCH1E,1492,3850000,3850000,1672818732,1671212573,0,inbound,baad8bfb7356156fe529bc5a64f0fd6ea35091d8808a7a14963d7938ffe8f5e9
1657,1BG2en1rzDp9NpxFjsxfvBMSF25S6SZApq,1493,43048781915,43048781915,1681106566,1677247345,0,outbound,baad8bfb7356156fe529bc5a64f0fd6ea35091d8808a7a14963d7938ffe8f5e9
1658,bc1qwsztn2vhwwuvma57l3pcdjtsgvjrfs59j0m3ld,1494,9997120,9997120,1675246793,1670542806,0,inbound,baad8bfb7356156fe529bc5a64f0fd6ea35091d8808a7a14963d7938ffe8f5e9
1659,3Lmcr4nx9mr9DXrxns5Q5KQ6rNXGLUa75h,1495,2693351552,2693351552,1677604836,1665001037,0,inbound,baad8bfb7356156fe529bc5a64f0fd6ea35091d8808a7a14963d7938ffe8f5e9
1660,bc1qule7wx0x4j6p707mfdk4lgctv4hmlvg9wduwfh,1496,4486442,4486442,1676921911,1669711285,0,inbound,baad8bfb7356156fe529bc5a64f0fd6ea35091d8808a7a14963d7938ffe8f5e9
1661,bc1qldkuduqqqaftlz7wau60f5gry2anetzcq7psnv,1497,4229596,4229596,1671213781,1671212574,0,inbound,baad8bfb7356156fe529bc5a64f0fd6ea35091d8808a7a14963d7938ffe8f5e9
1662,bc1qk8rfwx72w9wxq6e5pzp3ulqr3hvl42dcfdmrfyylxth7344umj9shzvf76,1498,2249724912,2249724912,1675935188,1656602126,0,inbound,baad8bfb7356156fe529bc5a64f0fd6ea35091d8808a7a14963d7938ffe8f5e9
1663,3QeqFpQSoi3MLzcC2n2xEYWAaf1181LjcP,1499,168413847162,168377453351,1677536768,1680806254,36393811,outbound,baad8bfb7356156fe529bc5a64f0fd6ea35091d8808a7a14963d7938ffe8f5e9
1664,bc1qrnl5smz77rnde6th0uuyfc99lxp8gsxex493cz98w520fgwqtwtscrzpar,1500,9685077245,9685077245,1671218582,1671212573,0,inbound,baad8bfb7356156fe529bc5a64f0fd6ea35091d8808a7a14963d7938ffe8f5e9
1665,34qT44RRTQu7ThUBekRhL95kii7GQfUL35,1501,1986828,1986828,1673487516,1670018648,0,inbound,baad8bfb7356156fe529bc5a64f0fd6ea35091d8808a7a14963d7938ffe8f5e9
1666,153BUCqWrza9QeTpCvh3jQwYWV1Tsexwtp,1502,38484735,38484735,1679321363,1668881689,0,outbound,baad8bfb7356156fe529bc5a64f0fd6ea35091d8808a7a14963d7938ffe8f5e9
1667,15JjR3ukwuZTY4i9XMPGrT6HBxnJeEDC6M,1503,555752,555752,1671032890,1671029050,0,inbound,baad8bfb7356156fe529bc5a64f0fd6ea35091d8808a7a14963d7938ffe8f5e9
1668,1Mo3qA5VYomwHLb67PY2oPFx1RHRgmTjFk,1504,13175869,13175869,1678572987,1666968311,0,inbound,baad8bfb7356156fe529bc5a64f0fd6ea35091d8808a7a14963d7938ffe8f5e9
1669,bc1qqg2vt5eezfw93ynhlws9tywj5qfth5k5c6n8ar,1505,3136252,3136252,1671132494,1671029050,0,inbound,baad8bfb7356156fe529bc5a64f0fd6ea35091d8808a7a14963d7938ffe8f5e9
1670,3GZUY9K8eHnhTDfFKyhE4szx6quJEK2EcT,1506,221493389,220508289,1681125781,1670419093,985100,outbound,baad8bfb7356156fe529bc5a64f0fd6ea35091d8808a7a14963d7938ffe8f5e9
1671,bc1q7dl7dvpykle7dsfnt3rn2ujrh56nwuq9s74klf,1507,101884474,101884474,1671031088,1671029050,0,inbound,baad8bfb7356156fe529bc5a64f0fd6ea35091d8808a7a14963d7938ffe8f5e9
1672,13YcUBHac53X2gXjVnYF32ogPNS8nDcRTo,1508,420689,420689,1671032114,1671029050,0,inbound,baad8bfb7356156fe529bc5a64f0fd6ea35091d8808a7a14963d7938ffe8f5e9
1673,3JSX43LtarPFet7VCd1VpmRRvHMvjqUbdp,1509,732368,732368,1671033219,1671029050,0,inbound,baad8bfb7356156fe529bc5a64f0fd6ea35091d8808a7a14963d7938ffe8f5e9
1674,bc1qp4umr9a7jak208fhqy2mlk7aeh644y9ahh7hzn,1510,59445845478,58888520021,1681140678,1678741703,557325457,inbound,baad8bfb7356156fe529bc5a64f0fd6ea35091d8808a7a14963d7938ffe8f5e9
1675,1AUZaNgiXBTgS74Nf3cc7NqvQzcVsutHNj,1511,2916613,2916613,1671031992,1671029050,0,inbound,baad8bfb7356156fe529bc5a64f0fd6ea35091d8808a7a14963d7938ffe8f5e9
1676,bc1q9pscvk48xvjzmzuswzd4z5kyjpczf3y8j565et,1512,446913039,446913039,1672217685,1658353416,0,inbound,baad8bfb7356156fe529bc5a64f0fd6ea35091d8808a7a14963d7938ffe8f5e9
1677,bc1qpnum2z4uy28frxsumr9702mytveune59lzy44z7afs6m0rju0u5q5af950,1513,2313450,2313450,1671169468,1670782215,0,inbound,baad8bfb7356156fe529bc5a64f0fd6ea35091d8808a7a14963d7938ffe8f5e9
1678,bc1q73tewvzxwj4c530p59mqj8vme2ce7r29q25z3e,1514,718547341,718547341,1681141462,1671775987,0,inbound,baad8bfb7356156fe529bc5a64f0fd6ea35091d8808a7a14963d7938ffe8f5e9
1679,1CFcCuSQGXjNmafkRqEeXRSYTZFdhfyCbT,1515,8241493,8241493,1671032971,1657398331,0,inbound,baad8bfb7356156fe529bc5a64f0fd6ea35091d8808a7a14963d7938ffe8f5e9
1680,3C6HY8BbNnt6t21cz8nCzeZfniDXy7R2gd,1516,795158,795158,1671032406,1671029050,0,inbound,baad8bfb7356156fe529bc5a64f0fd6ea35091d8808a7a14963d7938ffe8f5e9
1681,1DfjY3iJG7XeMctnVvad4EFXK3mrmZTd2M,1517,7060427,7060427,1680941959,1654425796,0,inbound,baad8bfb7356156fe529bc5a64f0fd6ea35091d8808a7a14963d7938ffe8f5e9
1682,bc1q9pmvjd6kz38r482684zmvzuk7mprm5wv5xlfyk,1518,780431,780431,1671029594,1671029050,0,inbound,baad8bfb7356156fe529bc5a64f0fd6ea35091d8808a7a14963d7938ffe8f5e9
1683,15kvDG7kdrQqRLTQrfksFRUZYDtNuXcBVa,1519,20766002,20766002,1675470589,1655589765,0,outbound,baad8bfb7356156fe529bc5a64f0fd6ea35091d8808a7a14963d7938ffe8f5e9
1684,1Cs87GM3c2Ugk2EAVAfgeCvXwGNF1Nfixp,1520,502409,502409,1671032114,1671029050,0,inbound,baad8bfb7356156fe529bc5a64f0fd6ea35091d8808a7a14963d7938ffe8f5e9
1685,1NdiSe69GQeEy45tZe126vCtJRygoECrzo,1521,105486,105486,1677233295,1671029050,0,inbound,baad8bfb7356156fe529bc5a64f0fd6ea35091d8808a7a14963d7938ffe8f5e9
1686,bc1qe2zufsf04kwrze9ghprvav2626nrclk6emmefp,1522,8700362,0,1671032392,1671029050,8700362,inbound,baad8bfb7356156fe529bc5a64f0fd6ea35091d8808a7a14963d7938ffe8f5e9
1687,39wQPfNCnuofH5M2Tbkt9RkkGkMseS9ZEt,1523,1110072,1110072,1671034861,1671029050,0,inbound,baad8bfb7356156fe529bc5a64f0fd6ea35091d8808a7a14963d7938ffe8f5e9
1688,37SvCQzkJh3xPn49tMv7jM8FJniQ4FDBiT,1524,169709,169709,1671066301,1671029050,0,inbound,baad8bfb7356156fe529bc5a64f0fd6ea35091d8808a7a14963d7938ffe8f5e9
1689,3JDVY1Yo5nuhBudMEvG9yYXcZX7ov3DNjn,1525,1698837,1698837,1671486149,1671029050,0,inbound,baad8bfb7356156fe529bc5a64f0fd6ea35091d8808a7a14963d7938ffe8f5e9
1690,1MmpcqfdgAJ9vY4waLrgaX8dHHsD2euaVx,1526,543935,543935,1671032114,1671029050,0,inbound,baad8bfb7356156fe529bc5a64f0fd6ea35091d8808a7a14963d7938ffe8f5e9
1691,bc1qder6snpvsn3h3resz2pdrpqdzfhyyqeql6ug80,1527,12800556,12776905,1671029050,1642334976,23651,inbound,baad8bfb7356156fe529bc5a64f0fd6ea35091d8808a7a14963d7938ffe8f5e9
1692,398NEAyGVpNubkXac2om79p9YKP7BYtqAd,1528,136579,136579,1671816573,1671029050,0,inbound,baad8bfb7356156fe529bc5a64f0fd6ea35091d8808a7a14963d7938ffe8f5e9
1693,3Ex4Q9YVe95PNZEdmhTcpX561nMTCzm6Ld,1529,555509,555509,1671570112,1671029050,0,inbound,baad8bfb7356156fe529bc5a64f0fd6ea35091d8808a7a14963d7938ffe8f5e9
1694,3K7xBS9k9kj5q2vfjoc7wQisQUjaProW18,1530,17381664,15157638,1681115143,1679020145,2224026,inbound,baad8bfb7356156fe529bc5a64f0fd6ea35091d8808a7a14963d7938ffe8f5e9
1695,1BUjADE78qmt7hDwpXt67MSy6yR9q7a3dy,1531,88936192,88936192,1673419605,1652056266,0,inbound,baad8bfb7356156fe529bc5a64f0fd6ea35091d8808a7a14963d7938ffe8f5e9
1696,1HsFdYwrB8mbbNTfGA6qPbyb3MWJQkBKJ6,1532,838049,838049,1671031568,1671029050,0,inbound,baad8bfb7356156fe529bc5a64f0fd6ea35091d8808a7a14963d7938ffe8f5e9
1697,3MXn86WHvCM3JHuNUzSib9qLqDmonhNpAE,1533,28677744,28677744,1674345785,1671073296,0,outbound,baad8bfb7356156fe529bc5a64f0fd6ea35091d8808a7a14963d7938ffe8f5e9
1698,bc1qg47c45djveeh72v3f75e5utchktaynjv3kgv49,1534,32013005,32013005,1681048834,1672386584,0,outbound,baad8bfb7356156fe529bc5a64f0fd6ea35091d8808a7a14963d7938ffe8f5e9
1699,39Mi5Q4tvWFCviAzydsoJcyHKYtbf9G9W9,1535,111429,111429,1672947028,1671029050,0,inbound,baad8bfb7356156fe529bc5a64f0fd6ea35091d8808a7a14963d7938ffe8f5e9
1700,17EQ1chvPGD6UbrURZ3PFyLz4dquJkjhCi,1536,414565,414565,1671033736,1669915817,0,inbound,baad8bfb7356156fe529bc5a64f0fd6ea35091d8808a7a14963d7938ffe8f5e9
1701,3QFCfrbWbhgTuykCqTFAp6xGQ66MdFft95,1537,54568516,54406650,1673673353,1643891612,161866,inbound,baad8bfb7356156fe529bc5a64f0fd6ea35091d8808a7a14963d7938ffe8f5e9
1702,bc1qtuu2srsmadwjjz29cdvld6y8xmr5ezuqtk2u4c,1538,10001104,10001104,1680058495,1667993887,0,inbound,f3f783e66b62c9525fbcbc9ab3eceb0273e777fe4c23633485b14aadfdc151b8
1703,1DC6ZcKyXCwhDAWjV4G939YtLbS1gMQHSX,1539,17000000,17000000,1671468821,1671029050,0,inbound,cee5383c2dd172b0b1500993598051cc24a1391866f952556eb2b38ab579c7da
1704,bc1qsdl6nrepwxvux4frslrlzqcjaag0agz0sgtmhd,1540,12082362,12082362,1672510850,1670203569,0,inbound,cee5383c2dd172b0b1500993598051cc24a1391866f952556eb2b38ab579c7da
1705,13NDh6JJB2zRKVvxkNSVxkKZqVnz4iq4iK,1541,95409,95409,1679530875,1671029050,0,inbound,cee5383c2dd172b0b1500993598051cc24a1391866f952556eb2b38ab579c7da
1706,bc1qc2yek3fslyrm5je669u3jtrgmn59vz5h88tsls,1542,17670,17670,1671033822,1671029050,0,inbound,a723fc0eb99d50bd4a4861d548a1dc6adfe9d52da6519ffe4ff29a6b3f1a48b8
1707,3NRoyjR6kiB9myFCPTssrFxzZkae8RL4K8,1543,80960,80960,1671033599,1669930327,0,inbound,a723fc0eb99d50bd4a4861d548a1dc6adfe9d52da6519ffe4ff29a6b3f1a48b8
1708,1MsuP2VafG8DeCs5gwPZ5MxA9qUkXrceFK,1544,101602,0,1671029050,1671029050,101602,inbound,a723fc0eb99d50bd4a4861d548a1dc6adfe9d52da6519ffe4ff29a6b3f1a48b8
1709,3PHTKQBQs48fa9q9tGE3qyprgeKzmnM25i,1545,3715252,3715252,1671178925,1671029050,0,inbound,a723fc0eb99d50bd4a4861d548a1dc6adfe9d52da6519ffe4ff29a6b3f1a48b8
1710,1396i2nEpiy5uokJpqwvKLcfGCXTYd4uxx,1546,67612,67612,1671033555,1671029050,0,inbound,a723fc0eb99d50bd4a4861d548a1dc6adfe9d52da6519ffe4ff29a6b3f1a48b8
1711,349wmUhRRV1nbZxS9VmF6ULHjXgVVQVgRj,1547,25305868,24067144,1676146629,1670219887,1238724,inbound,a723fc0eb99d50bd4a4861d548a1dc6adfe9d52da6519ffe4ff29a6b3f1a48b8
1712,3658LfE7ovZ8DG8acNtsNQU6RwJVZhxx31,1548,421282,421282,1671048067,1671028149,0,inbound,a723fc0eb99d50bd4a4861d548a1dc6adfe9d52da6519ffe4ff29a6b3f1a48b8
1713,3HhFgwKq9L89QMzQjKm98RHXnvmdnnSeee,1549,424097,424097,1671030101,1671029050,0,inbound,a723fc0eb99d50bd4a4861d548a1dc6adfe9d52da6519ffe4ff29a6b3f1a48b8
1714,3JH3kt6vzDN4RLXRhFULT8M3LKYTnfDURx,1550,751140,751140,1671822037,1667999590,0,inbound,a723fc0eb99d50bd4a4861d548a1dc6adfe9d52da6519ffe4ff29a6b3f1a48b8
1715,363LZ5ufQjAk7try39MP9P9eJZTDUt4Lp3,1551,58029,58029,1671033599,1671029050,0,inbound,a723fc0eb99d50bd4a4861d548a1dc6adfe9d52da6519ffe4ff29a6b3f1a48b8
1716,3LacU9gheFwQXz4RKC3VWj4sBpBzhXfxZH,1552,11021297,11021297,1677621731,1655317446,0,inbound,a723fc0eb99d50bd4a4861d548a1dc6adfe9d52da6519ffe4ff29a6b3f1a48b8
1717,37W78J2JoVyuGXXbGy4sBjKZQfCRWzN7zn,1553,92968,92968,1676022297,1671029050,0,inbound,a723fc0eb99d50bd4a4861d548a1dc6adfe9d52da6519ffe4ff29a6b3f1a48b8
1718,3FQZEgTGWRmF6Lbu7Pkxxs4V1FJRjrxtkr,1554,136645,136645,1671079008,1671029050,0,inbound,a723fc0eb99d50bd4a4861d548a1dc6adfe9d52da6519ffe4ff29a6b3f1a48b8
1719,bc1qlwzl2hw35fl7wt4mzeuvlg66xjezr5pat5kyld,1555,138745,138745,1676862104,1671029050,0,inbound,a723fc0eb99d50bd4a4861d548a1dc6adfe9d52da6519ffe4ff29a6b3f1a48b8
1720,1Cxu8rwkhQ6X4AEbfvz9pesw4Pf3JV2RAV,1556,765275479,764998779,1681132510,1680691585,276700,inbound,a723fc0eb99d50bd4a4861d548a1dc6adfe9d52da6519ffe4ff29a6b3f1a48b8
1721,3A6mYUAig16EPad5MJMaANTcPM6KX2Pgid,1557,180709,180709,1671816573,1671029050,0,inbound,a723fc0eb99d50bd4a4861d548a1dc6adfe9d52da6519ffe4ff29a6b3f1a48b8
1722,38d8FePHF4dSmwhFu3pAfiDzCpyuhHQUnu,1558,11100,11100,1677066695,1671029050,0,inbound,a723fc0eb99d50bd4a4861d548a1dc6adfe9d52da6519ffe4ff29a6b3f1a48b8
1723,bc1qxluskkg698aht9vv9s4aldxltyu9vwfz6l3vdt,1559,217626369,217626369,1680243958,1676426958,0,inbound,a723fc0eb99d50bd4a4861d548a1dc6adfe9d52da6519ffe4ff29a6b3f1a48b8
1724,bc1qnpehr4y55lxvkpztgcz8ujkexpdvdaq70csq3d,1560,28661909,28661909,1678835396,1664082583,0,inbound,ef4bcd11f632d0393e6cef244c2db6512f0e55ce610cd66cff7795e167b60834
1725,bc1q336mr4juux7llc0lpmcq2p9jcljhkny9ya7enq,1561,47973,47973,1671597929,1671029050,0,inbound,ef4bcd11f632d0393e6cef244c2db6512f0e55ce610cd66cff7795e167b60834
1726,bc1q2n5gjtmxfuu84chaku0gs9ujzvqdsyqlf0gnj2,1562,6759503,6759503,1671812643,1670974216,0,inbound,ef0135b597d647703c2847d1f3a283caf89cd8fb39d0ad96528cb7cc84e03025
1727,3E3W2qqy1dbs7XuYVmypuM3RPS2UcCNszR,1563,2000000,2000000,1671057639,1671025110,0,inbound,ef0135b597d647703c2847d1f3a283caf89cd8fb39d0ad96528cb7cc84e03025
1728,bc1q9glx97qmcexf0gftjfac474lxk3mpnaxsmqksg,1564,103208994,103208994,1673508197,1671025100,0,inbound,ef0135b597d647703c2847d1f3a283caf89cd8fb39d0ad96528cb7cc84e03025
1729,3H93dvTEG7XNRVcBJwYU6Rn5zyoV9bzHNH,1565,366341151,366341151,1680696560,1661644150,0,inbound,ef0135b597d647703c2847d1f3a283caf89cd8fb39d0ad96528cb7cc84e03025
1730,bc1q5mtmkgw573ku5dkajwftqpad9uulf7jes0v98p,1566,38367,0,1671025110,1671025110,38367,inbound,ef0135b597d647703c2847d1f3a283caf89cd8fb39d0ad96528cb7cc84e03025
1731,bc1qgjaclwy25cvxtnuscv0t287gmej8hj9724uxk7,1567,419407,0,1671025089,1671024910,419407,inbound,445073af9be5f425321e7fa5d7472488810a1625e4c062e5b1997b2cf12bcfab
1732,bc1qz6hteq0yfnflwrfak33urkdxvjy3n2zvyx2fc0,1568,97174,97174,1671072690,1671025096,0,inbound,445073af9be5f425321e7fa5d7472488810a1625e4c062e5b1997b2cf12bcfab
1733,3JLBLknFWCzFaDrsM7fXSeouMjkmz2fptT,1569,223746391,10973561,1681130165,1679701966,212772830,inbound,445073af9be5f425321e7fa5d7472488810a1625e4c062e5b1997b2cf12bcfab
1734,3Dw8Kibuc1LrHvVwX7XLHhHhjqpJGWyHyA,1570,1074642195,1074642195,1680257818,1676210896,0,inbound,445073af9be5f425321e7fa5d7472488810a1625e4c062e5b1997b2cf12bcfab
1735,36tfSxMUxdwrFTinFRbUy8cnZ1XUTivnHF,1571,140413,140413,1671063018,1670454730,0,inbound,445073af9be5f425321e7fa5d7472488810a1625e4c062e5b1997b2cf12bcfab
1736,1AK4ACAmAEfbZEDQ3aoAAtqdbbT61zUQ5y,1572,15497665935,15497665935,1678632419,1673100125,0,outbound,445073af9be5f425321e7fa5d7472488810a1625e4c062e5b1997b2cf12bcfab
1737,1Eae23d9GjH7oucS5PqketKy26xFNqX8Vo,1573,9342489,9342489,1680535986,1670437991,0,outbound,445073af9be5f425321e7fa5d7472488810a1625e4c062e5b1997b2cf12bcfab
1738,1JhtreBuf7neYvTpan7aaxsoLWNSBD7xEm,1574,250356171,250356171,1673965512,1668612370,0,inbound,445073af9be5f425321e7fa5d7472488810a1625e4c062e5b1997b2cf12bcfab
1739,15mWF8vzxmHuRjb7piTE2Xnvtogh4ncYos,1575,5319119,5226281,1680688969,1586450380,92838,inbound,445073af9be5f425321e7fa5d7472488810a1625e4c062e5b1997b2cf12bcfab
1740,3NByEdFzvPmBoMzb6g1D2D6okoS8YgKhWD,1576,4935291,4935291,1672305997,1671025089,0,inbound,445073af9be5f425321e7fa5d7472488810a1625e4c062e5b1997b2cf12bcfab
1741,13RS8JShmoWXeYbu9c5tJeVswhgkq9C9bL,1577,499920073,492834437,1681104597,1672415590,7085636,inbound,445073af9be5f425321e7fa5d7472488810a1625e4c062e5b1997b2cf12bcfab
1742,bc1qkakg8w7a29a3thadx65nhxugk8mptx6zl3vlm5,1578,200551622,199774330,1680988749,1671850452,777292,inbound,445073af9be5f425321e7fa5d7472488810a1625e4c062e5b1997b2cf12bcfab
1743,355d6fv1otWniMUuVakzW5MY26rHFEQRhf,1579,411332,0,1671025110,1670978829,411332,inbound,445073af9be5f425321e7fa5d7472488810a1625e4c062e5b1997b2cf12bcfab
1744,bc1qum5d4tprsu5u3rcu3k2hnmh78nzryce747ku2x,1580,16721713,16721713,1674086454,1673151488,0,inbound,445073af9be5f425321e7fa5d7472488810a1625e4c062e5b1997b2cf12bcfab
1745,bc1qa5adxxl0wy79jf2ztfaknx7yh60yztpxsjsgru,1581,3444554,3444554,1671026015,1670604367,0,inbound,445073af9be5f425321e7fa5d7472488810a1625e4c062e5b1997b2cf12bcfab
1746,3MKPB1Jt5xvdnnU6wYvW1B2SuCXnaf1f9u,1582,12775338,12775338,1673897905,1642027176,0,inbound,445073af9be5f425321e7fa5d7472488810a1625e4c062e5b1997b2cf12bcfab
1747,1CfU1w7anKKHzDhMUB6fRzpVdygPb166vK,1583,62536,62536,1671052591,1671025110,0,inbound,445073af9be5f425321e7fa5d7472488810a1625e4c062e5b1997b2cf12bcfab
1748,bc1qgmhc9249hpn65079x3swf37qxjay4euq0d0r03,1584,1232368,1232368,1671027662,1671025088,0,inbound,445073af9be5f425321e7fa5d7472488810a1625e4c062e5b1997b2cf12bcfab
1749,bc1q0lz7hlxhkjzsm49tdeerfm0ttrqe33dqu72kh2,1585,34000,34000,1672569533,1671025099,0,inbound,445073af9be5f425321e7fa5d7472488810a1625e4c062e5b1997b2cf12bcfab
1750,1G3aDZ4TpZd1EbFhxbJ5JJwxJYXF3vJKig,1586,318910,318910,1671029894,1671025096,0,inbound,445073af9be5f425321e7fa5d7472488810a1625e4c062e5b1997b2cf12bcfab
1751,bc1qzu2xj4yv3award0jtuue3yjx54x95srqxy2lx9,1587,901099,901099,1671074187,1671025099,0,inbound,445073af9be5f425321e7fa5d7472488810a1625e4c062e5b1997b2cf12bcfab
1752,bc1qvsn6ga9a4jexlcsmq6mgkzufsk3f7lqe2x99n9,1588,426879,426879,1671557349,1671025088,0,inbound,445073af9be5f425321e7fa5d7472488810a1625e4c062e5b1997b2cf12bcfab
1753,bc1qsheqjz35ds5qaq4zpz2vpwty89t44l7kduzguc,1589,263043,263043,1671142775,1671025088,0,inbound,445073af9be5f425321e7fa5d7472488810a1625e4c062e5b1997b2cf12bcfab
1754,bc1ql78vc4xsv3xv5rm27uysf8l2d6v0qtg09r9thh,1590,589311919,589311919,1671028269,1671025088,0,inbound,445073af9be5f425321e7fa5d7472488810a1625e4c062e5b1997b2cf12bcfab
1755,bc1q2dvldrjvsf8q9gteyy9k2d6yr04nafu2h7glalcvdeyq8p3st2hqq22daz,1591,100098639,0,1670882688,1670881610,100098639,inbound,445073af9be5f425321e7fa5d7472488810a1625e4c062e5b1997b2cf12bcfab
1756,3NFpV7F98rYdbZUBNYUyvzBzwv73GbT2i2,1592,41734493,41734493,1680931196,1575381450,0,inbound,445073af9be5f425321e7fa5d7472488810a1625e4c062e5b1997b2cf12bcfab
1757,bc1qqmqs66jmjv9p5lskhhhcs05cwf8wrzsvfu2kx8,1593,180000,180000,1670882903,1670882688,0,inbound,445073af9be5f425321e7fa5d7472488810a1625e4c062e5b1997b2cf12bcfab
1758,3GGvXyvdWye3gSYmDhPruMAvNwCy777fY4,1594,4133000,4133000,1670887233,1670882688,0,inbound,445073af9be5f425321e7fa5d7472488810a1625e4c062e5b1997b2cf12bcfab
1759,bc1qdctq0hy6cdjmn49uvdtl9fuufkzu0waaltd2t7,1595,109192204,0,1670882688,1647524232,109192204,inbound,445073af9be5f425321e7fa5d7472488810a1625e4c062e5b1997b2cf12bcfab
1760,1FAC4qz3qbZjCc2rV4qrmjGwrscuhPwYHS,1596,261000,261000,1670899764,1670882688,0,inbound,445073af9be5f425321e7fa5d7472488810a1625e4c062e5b1997b2cf12bcfab
1761,bc1q6p2pdc6psvy5f9kea0nlgupnf3qm84gv7qapqu,1597,9345704,0,1670882688,1670882688,9345704,inbound,445073af9be5f425321e7fa5d7472488810a1625e4c062e5b1997b2cf12bcfab
1762,16PNgMKnZnH2AjL8VYZYEBP6YbqAKnGs8N,1598,6073252,0,1670882688,1670882688,6073252,inbound,445073af9be5f425321e7fa5d7472488810a1625e4c062e5b1997b2cf12bcfab
1763,bc1q045kfuajkrk6hhmk8quft62npt7ka3f66zt8gx,1599,547931,0,1670882688,1670882688,547931,inbound,445073af9be5f425321e7fa5d7472488810a1625e4c062e5b1997b2cf12bcfab
1764,bc1qzpud5gn4mnwahlxhlelhc8awpyytlx8w3sg0h5,1600,1324219,0,1670882688,1670882688,1324219,inbound,445073af9be5f425321e7fa5d7472488810a1625e4c062e5b1997b2cf12bcfab
1765,bc1qp635t24rq4lhc88r3ldpdsa42gua74u2nmytgx,1601,7891000,7891000,1678896721,1670882688,0,inbound,445073af9be5f425321e7fa5d7472488810a1625e4c062e5b1997b2cf12bcfab
1766,bc1q7wlng6cft6ycul23jk4smw3m6x3ny9xxmcytu5,1602,2529999,329999,1670882688,1631226241,2200000,inbound,445073af9be5f425321e7fa5d7472488810a1625e4c062e5b1997b2cf12bcfab
1767,bc1qy0sgjyk9vc7k5rm28dcpj3aqtuy2ttt9cmgw2a,1603,42678132,42678132,1673304641,1670558594,0,inbound,445073af9be5f425321e7fa5d7472488810a1625e4c062e5b1997b2cf12bcfab
1768,3AJ9QXShqhwycoCw6AqBAftNiyF3d9AcrT,1604,26274379,26274379,1672658629,1670108088,0,outbound,445073af9be5f425321e7fa5d7472488810a1625e4c062e5b1997b2cf12bcfab
1769,bc1q7k42u5tvvur0k9458wg5dt7pstzc0663mwg4yy,1605,72418362,0,1680464320,1656261908,72418362,inbound,445073af9be5f425321e7fa5d7472488810a1625e4c062e5b1997b2cf12bcfab
1770,bc1qdate3ny6ahhytqds47h3a3jm5dflpdysxwj840,1606,2899380,2899380,1675263149,1670882688,0,inbound,445073af9be5f425321e7fa5d7472488810a1625e4c062e5b1997b2cf12bcfab
1771,bc1qsylw6hshlyamz726vc733sl5e5mx755us56lfa,1607,4486807,4486807,1670884002,1670882688,0,inbound,445073af9be5f425321e7fa5d7472488810a1625e4c062e5b1997b2cf12bcfab
1772,bc1qvhj4vxh7rwua979jalcwhkhsppf0ktqpvhyzn6,1608,180000,0,1670882688,1670882688,180000,inbound,445073af9be5f425321e7fa5d7472488810a1625e4c062e5b1997b2cf12bcfab
1773,3DdD5qr6JCa6CUkPpgdxwH8EV82msnxyQx,1609,98000,98000,1670985900,1670882688,0,inbound,445073af9be5f425321e7fa5d7472488810a1625e4c062e5b1997b2cf12bcfab
1774,bc1qrwlfs8p2jfua5s0q4n8ecrlc7uh2uqz6gwjjvj,1610,4182535,4182535,1670884002,1670882688,0,inbound,445073af9be5f425321e7fa5d7472488810a1625e4c062e5b1997b2cf12bcfab
1775,bc1qass8hnypkvhazta3eavrdgf0zzf3ftrhqfecep,1611,2044568,2044568,1673690564,1670882688,0,inbound,445073af9be5f425321e7fa5d7472488810a1625e4c062e5b1997b2cf12bcfab
1776,17y8K1hARGvAuuWP1jxyZBrF2KHMhWLE7n,1612,305970,305970,1670882690,1670882688,0,inbound,445073af9be5f425321e7fa5d7472488810a1625e4c062e5b1997b2cf12bcfab
1777,1JkruwcgyQ5eyY8PQQypFMoT2Qo9P6ytmP,1613,939555,939555,1670883903,1670882688,0,inbound,445073af9be5f425321e7fa5d7472488810a1625e4c062e5b1997b2cf12bcfab
1778,3Ckpdbs3AXZLqsiDMfhci1xDKPpu85M8mE,1614,7754212990,7754212990,1677659606,1669885522,0,outbound,445073af9be5f425321e7fa5d7472488810a1625e4c062e5b1997b2cf12bcfab
1779,bc1qdr3klrmxf9ge4ttc2mznxtz3p7pt4xqexq6umh,1615,364435,364435,1675470082,1670882688,0,inbound,445073af9be5f425321e7fa5d7472488810a1625e4c062e5b1997b2cf12bcfab
1780,3E1xRydPKFx2XMurYKD8Lo21GUaboEBiy5,1616,19895468773,19895468773,1674266907,1671094487,0,inbound,445073af9be5f425321e7fa5d7472488810a1625e4c062e5b1997b2cf12bcfab
1781,3FaFYoCTHqEPuSbAw4svUrXtrZaHUR7FRW,1617,221980000,221980000,1680946240,1649964157,0,inbound,445073af9be5f425321e7fa5d7472488810a1625e4c062e5b1997b2cf12bcfab
1782,18rD89T7WKShpbE1fNngs5vc4BmhWFr5Rv,1618,128397,128397,1670883903,1670882688,0,inbound,445073af9be5f425321e7fa5d7472488810a1625e4c062e5b1997b2cf12bcfab
1783,bc1qc7jt85h8kr692wqy5zpfh0lmuqhtqemlh0xvdj,1619,2654100,2654100,1673085076,1670882688,0,inbound,445073af9be5f425321e7fa5d7472488810a1625e4c062e5b1997b2cf12bcfab
1784,bc1qsn36032r88s7v9g8hzp6wcsu3maa4s8l0fqw8d,1620,514601935036,514125441790,1681137523,1679089255,476493246,inbound,445073af9be5f425321e7fa5d7472488810a1625e4c062e5b1997b2cf12bcfab
1785,bc1q5a5tljpx3lkmhzh2axuh7qmeykgdyssxph90p9,1621,12017347,12013515,1673175117,1642195157,3832,inbound,445073af9be5f425321e7fa5d7472488810a1625e4c062e5b1997b2cf12bcfab
1786,3H7Zcst7VeiohB5cYErnWFqNr33jSmP3cN,1622,83854590,83854590,1680568245,1670882688,0,inbound,445073af9be5f425321e7fa5d7472488810a1625e4c062e5b1997b2cf12bcfab
1787,1BXQcU8vBXURFAGLAGD6zaBpy8DCtpxXFr,1623,9154742,0,1670882689,1670882689,9154742,inbound,445073af9be5f425321e7fa5d7472488810a1625e4c062e5b1997b2cf12bcfab
1788,35ifAGze86b9ZJwjZK74KrNnhdWqZXW6fG,1624,11454262,10832668,1681070678,1668392460,621594,inbound,445073af9be5f425321e7fa5d7472488810a1625e4c062e5b1997b2cf12bcfab
1789,1Hz3HDBW5xxig7YYkgfhoET3726QQ1zC5B,1625,25582443638018,25579098658018,1681144721,1680266201,3344980000,inbound,445073af9be5f425321e7fa5d7472488810a1625e4c062e5b1997b2cf12bcfab
1790,3H3ioT4aXGNE4sFWpEpefNhMsJKF6dedBX,1626,388000,388000,1670883843,1670882688,0,inbound,445073af9be5f425321e7fa5d7472488810a1625e4c062e5b1997b2cf12bcfab
1791,bc1qqz7yxu6ypjpu38evd4yzheh87sp3nc4jzghmvg,1627,35316111,35316111,1670884002,1670882688,0,inbound,445073af9be5f425321e7fa5d7472488810a1625e4c062e5b1997b2cf12bcfab
1792,bc1qkqw95ys34yxsytw6cwcjunzx2l5g6vuh0t6qkx,1628,2517952,0,1670882688,1670882688,2517952,inbound,445073af9be5f425321e7fa5d7472488810a1625e4c062e5b1997b2cf12bcfab
1793,bc1qq4ftse27nskaceshgm50elkxnnkudunez9wxfc,1629,177277,177277,1670894910,1670882688,0,inbound,445073af9be5f425321e7fa5d7472488810a1625e4c062e5b1997b2cf12bcfab
1794,bc1qgd6cjap2qhg9lluljellp5tnrmgwg4khjg6csg,1630,1345676,1291255,1674209577,1670882688,54421,inbound,445073af9be5f425321e7fa5d7472488810a1625e4c062e5b1997b2cf12bcfab
1795,bc1q0n244fu0a8fd5dcsquh55ysm7axlt4l5t2vc55,1631,19148262,0,1670882688,1670882688,19148262,inbound,445073af9be5f425321e7fa5d7472488810a1625e4c062e5b1997b2cf12bcfab
1796,1C9nGCoFkFMjJ2d9n84AkonESuALUEhwWk,1632,386505410,386505410,1675602560,1660962881,0,inbound,445073af9be5f425321e7fa5d7472488810a1625e4c062e5b1997b2cf12bcfab
1797,bc1qg9hf7qentddmdwmycsymfzwud5xv7gt5urjgd6,1633,76474337,76474337,1670970817,1670775406,0,inbound,445073af9be5f425321e7fa5d7472488810a1625e4c062e5b1997b2cf12bcfab
1798,31p1LVcRS1YmUPywr9vjnu562Y9kX6cQ7f,1634,1254000,1254000,1670882789,1670449726,0,inbound,445073af9be5f425321e7fa5d7472488810a1625e4c062e5b1997b2cf12bcfab
1799,38pgaqcvH9RWiK71YTWZD7NJ2VxzZJg7Ko,1635,22373674,0,1670882688,1670882688,22373674,inbound,445073af9be5f425321e7fa5d7472488810a1625e4c062e5b1997b2cf12bcfab
1800,bc1q7eydqqg8m25eckmg2twjs0lvsujl7vq06h43mm,1636,10533965,0,1670882688,1670882688,10533965,inbound,445073af9be5f425321e7fa5d7472488810a1625e4c062e5b1997b2cf12bcfab
1801,32JAhzswbyTfn44W6Z934whV8aA7yGYL4h,1637,2609835,2609835,1672317354,1670882688,0,inbound,445073af9be5f425321e7fa5d7472488810a1625e4c062e5b1997b2cf12bcfab
1802,1Aobv5kPDPLzcbj6NcB4g36kXX6VWBZvDj,1638,12063157,0,1670882688,1670882688,12063157,inbound,445073af9be5f425321e7fa5d7472488810a1625e4c062e5b1997b2cf12bcfab
1803,bc1q9h0zfevdwjyw2hpspucsje6mvjs7wzxxgxh6f4,1639,126269000,126269000,1670914720,1670625045,0,inbound,445073af9be5f425321e7fa5d7472488810a1625e4c062e5b1997b2cf12bcfab
1804,bc1q32akjwg25hw5d7mpwfksdpwcwp3vm2hjfxgqln,1640,550180000,550180000,1678107475,1670882448,0,inbound,445073af9be5f425321e7fa5d7472488810a1625e4c062e5b1997b2cf12bcfab
1805,bc1q4day9l40npwy6l28elj6kzsn5uh4cduzzf4yvn,1641,4869442,0,1670882688,1670882688,4869442,inbound,445073af9be5f425321e7fa5d7472488810a1625e4c062e5b1997b2cf12bcfab
1806,bc1qv7qc3cph4yv7t436w3paf4gsjumqyprjy75pnm,1642,2200000,2200000,1673726526,1670882688,0,inbound,445073af9be5f425321e7fa5d7472488810a1625e4c062e5b1997b2cf12bcfab
1807,bc1q0dga3xqvupzwr7spkm93ttz8gg3awthjlzjdpz,1643,82595000,82595000,1673734012,1670882688,0,inbound,445073af9be5f425321e7fa5d7472488810a1625e4c062e5b1997b2cf12bcfab
1808,33a41cSGNx2CaR89SswrZ8jP9xrHDf1Fpd,1644,39481818,39481818,1677377323,1663162384,0,outbound,445073af9be5f425321e7fa5d7472488810a1625e4c062e5b1997b2cf12bcfab
1809,3CMPZvFkko1VLKSUnysDt5tnnuogxzDsJb,1645,18913484,0,1676574440,1670444690,18913484,inbound,445073af9be5f425321e7fa5d7472488810a1625e4c062e5b1997b2cf12bcfab
1810,3QiWrp9EF8N8qSnqJ9ERiQMFoRngRQ6tmA,1646,300000,0,1670882688,1670882688,300000,inbound,445073af9be5f425321e7fa5d7472488810a1625e4c062e5b1997b2cf12bcfab
1811,bc1q7w27z7ss485c6l2zvmywaw4grvnpkhr60ewfux,1647,40719792,0,1670882688,1670870691,40719792,inbound,445073af9be5f425321e7fa5d7472488810a1625e4c062e5b1997b2cf12bcfab
1812,bc1q4mhqhqqqcudvgtlfj5596ftj4wjd5gg500huc4,1648,3032908,3032908,1677158669,1670882688,0,inbound,445073af9be5f425321e7fa5d7472488810a1625e4c062e5b1997b2cf12bcfab
1813,bc1q9rgch5p0vqj2sm8gqtcpfprqfnnwefps83c5zp,1649,108498626,0,1680682082,1669488047,108498626,inbound,445073af9be5f425321e7fa5d7472488810a1625e4c062e5b1997b2cf12bcfab
1814,bc1qq3kervcg3f3nxz5p4tepgtsqqud7skm4gjjclr,1650,560000,560000,1670883670,1670882688,0,inbound,445073af9be5f425321e7fa5d7472488810a1625e4c062e5b1997b2cf12bcfab
1815,bc1qp5rxrzkypsrrnrt83l72xu8tllcz3rux0qnk5k,1651,14053728,14053728,1671007544,1670831002,0,inbound,445073af9be5f425321e7fa5d7472488810a1625e4c062e5b1997b2cf12bcfab
1816,38XajkyRhgkwEyJk5qk2yDEf3jx3Lqi7Jp,1652,40730075,40730075,1676598517,1658730763,0,inbound,445073af9be5f425321e7fa5d7472488810a1625e4c062e5b1997b2cf12bcfab
